Source Port,Destination Port,NAT Source Port,NAT Destination Port,Bytes,Bytes Sent,Bytes Received,Packets,Elapsed Time (sec),pkts_sent,pkts_received,Action
17916,23,0,0,60,60,0,1,0,1,0,1
57874,26467,0,0,62,62,0,1,0,1,0,1
53159,443,33030,443,9711,3950,5761,38,28,22,16,0
58638,5900,0,0,62,62,0,1,0,1,0,1
53807,28630,23692,28630,70,70,0,1,4,1,0,0
5938,35070,0,0,60,60,0,1,90,1,0,0
64812,53,57206,53,347,91,256,4,56,2,2,0
1182,23,0,0,60,60,0,1,0,1,0,1
56553,53,20095,53,701,88,613,2,30,1,1,0
56082,53,15374,53,271,88,183,4,37,2,2,0
50524,445,0,0,70,70,0,1,0,1,0,2
64930,53,64696,53,186,95,91,2,31,1,1,0
52184,57262,17429,57262,66,66,0,1,5,1,0,0
37559,443,47158,443,9845,2815,7030,26,37,15,11,0
50514,445,0,0,70,70,0,1,0,1,0,2
58638,5900,0,0,62,62,0,1,0,1,0,1
63025,443,40805,443,304,86,218,2,30,1,1,0
18608,11392,0,0,62,62,0,1,0,1,0,1
48335,25174,0,0,62,62,0,1,0,1,0,1
57597,443,32556,443,12528,7238,5290,26,91,15,11,0
51578,44847,0,0,66,66,0,1,0,1,0,1
50186,443,57350,443,6363,1073,5290,18,38,10,8,0
8933,56205,0,0,62,62,0,1,0,1,0,1
54876,445,0,0,70,70,0,1,0,1,0,2
60066,80,60066,80,355862,9048,346814,358,163,116,242,0
50223,445,0,0,70,70,0,1,0,1,0,2
56600,80,32176,80,234,234,0,4,12,4,0,0
54877,53,59244,53,199,94,105,2,30,1,1,0
64356,445,0,0,66,66,0,1,0,1,0,2
443,28417,0,0,82,82,0,1,0,1,0,1
20961,35440,0,0,62,62,0,1,0,1,0,1
60427,61137,3652,61137,70,70,0,2,8,2,0,0
50148,445,0,0,66,66,0,1,0,1,0,2
55133,53,13417,53,168,86,82,2,30,1,1,0
45837,25174,0,0,146,146,0,1,0,1,0,1
61530,445,0,0,66,66,0,1,0,1,0,2
60725,445,0,0,70,70,0,1,0,1,0,2
49418,53,2882,53,165,86,79,2,30,1,1,0
51818,37965,0,0,66,66,0,1,0,1,0,1
41885,25174,0,0,62,62,0,1,0,1,0,1
53682,20884,39828,20884,70,70,0,2,7,2,0,0
57068,445,0,0,70,70,0,1,0,1,0,2
51619,445,0,0,66,66,0,1,0,1,0,2
58992,53,0,0,273,86,187,2,30,1,1,0
55782,53,22320,53,245,94,151,2,29,1,1,0
61494,443,60069,443,14558,2653,11905,33,27,18,15,0
1638,22114,0,0,62,62,0,1,0,1,0,1
28221,37965,0,0,62,62,0,1,0,1,0,1
49627,53,55437,53,760,97,663,2,30,1,1,0
3819,80,3819,80,9399,632,8767,15,15,7,8,0
37965,22343,64266,22343,1307,594,713,17,1657,10,7,0
52973,57470,0,0,74,74,0,1,0,1,0,1
57577,443,53525,443,4752,2561,2191,32,256,16,16,0
51820,53738,52497,53738,70,70,0,1,5,1,0,0
59840,445,0,0,66,66,0,1,0,1,0,2
63601,443,6476,443,26835,2611,24224,36,121,14,22,0
50621,80,31852,80,11975,10368,1607,27,52,16,11,0
49371,445,0,0,70,70,0,1,0,1,0,2
55014,443,4277,443,4962,1352,3610,19,135,9,10,0
60446,6882,2486,6882,70,70,0,2,8,2,0,0
56724,53,0,0,86,86,0,1,30,1,0,0
57172,3389,57172,3389,3347,1458,1889,15,18,8,7,0
46653,443,4259,443,4037,1058,2979,12,120,6,6,0
52776,443,19615,443,10091,2314,7777,33,17,18,15,0
51560,46783,0,0,66,66,0,1,0,1,0,1
54617,443,54617,443,3186,1836,1350,16,17,10,6,0
63044,443,58831,443,512,166,346,2,30,1,1,0
56968,445,0,0,66,66,0,1,0,1,0,2
14103,35440,0,0,62,62,0,1,0,1,0,1
51910,60443,42638,60443,66,66,0,1,5,1,0,0
65507,53,62722,53,177,94,83,2,30,1,1,0
57241,53,11880,53,760,97,663,2,31,1,1,0
52174,443,52174,443,55503,7279,48224,79,22,32,47,0
35888,443,35888,443,4481,1574,2907,19,26,11,8,0
57157,53,38785,53,173,94,79,2,30,1,1,0
50258,445,0,0,70,70,0,1,0,1,0,2
49473,53,57880,53,290,118,172,2,30,1,1,0
52897,80,31689,80,4292,1932,2360,32,118,17,15,0
58802,443,37884,443,8591,2275,6316,37,137,21,16,0
58638,5900,0,0,62,62,0,1,0,1,0,1
5588,5588,0,0,3354,1792,1562,46,193,23,23,0
21859,53,21859,53,242,98,144,2,30,1,1,0
47822,80,47822,80,1435,1293,142,5,15,3,2,0
57987,56125,0,0,90,90,0,1,0,1,0,1
53767,10004,19496,10004,70,70,0,1,4,1,0,0
56838,53,39774,53,177,94,83,2,30,1,1,0
52953,445,0,0,70,70,0,1,0,1,0,2
64837,53,23710,53,196,94,102,2,30,1,1,0
37965,32405,17637,32405,766,248,518,4,1200,2,2,0
52838,37965,0,0,66,66,0,1,0,1,0,1
49395,53,40831,53,390,111,279,4,53,2,2,0
55725,14704,64431,14704,70,70,0,1,5,1,0,0
52164,42271,30250,42271,70,70,0,2,8,2,0,0
63317,53,0,0,181,86,95,2,30,1,1,0
51620,56205,0,0,66,66,0,1,0,1,0,1
50369,50584,0,0,66,66,0,1,0,1,0,1
53053,443,10274,443,9303,2569,6734,39,106,20,19,0
37965,46405,21208,46405,1217,594,623,16,1764,10,6,0
55005,443,32809,443,134,60,74,3,11,2,1,0
39058,443,63912,443,8028,5439,2589,32,27,16,16,0
10000,10214,0,0,62,62,0,1,0,1,0,1
60746,40010,7294,40010,316,136,180,6,6,3,3,0
65229,53,65530,53,443,182,261,6,30,3,3,0
52206,445,0,0,70,70,0,1,0,1,0,2
63960,53,46740,53,228,110,118,2,29,1,1,0
50968,80,19228,80,109660,1992,107668,99,35,20,79,0
52097,443,1702,443,11181,7329,3852,39,53,20,19,0
55748,53,59262,53,188,96,92,2,31,1,1,0
58638,5900,0,0,62,62,0,1,0,1,0,1
44704,443,31142,443,7228,3478,3750,37,164,17,20,0
50378,53,9266,53,199,102,97,2,29,1,1,0
65472,53,63288,53,202,103,99,2,31,1,1,0
49446,445,0,0,70,70,0,1,0,1,0,2
55763,443,52551,443,48162,46496,1666,59,136,39,20,0
60141,62413,0,0,66,66,0,1,0,1,0,1
0,0,0,0,156,156,0,2,0,2,0,1
55605,53,59160,53,198,102,96,2,30,1,1,0
51923,22114,0,0,146,146,0,1,0,1,0,1
53800,445,0,0,70,70,0,1,0,1,0,2
55917,445,0,0,66,66,0,1,0,1,0,2
57298,53,55060,53,323,110,213,2,30,1,1,0
53781,445,0,0,70,70,0,1,0,1,0,2
23353,25174,0,0,146,146,0,1,0,1,0,1
50542,443,16831,443,5347,2537,2810,17,120,8,9,0
49771,80,10429,80,254,128,126,5,16,3,2,0
61431,445,0,0,70,70,0,1,0,1,0,2
51946,9407,10036,9407,70,70,0,2,7,2,0,0
11488,22114,0,0,66,66,0,1,0,1,0,1
63073,53,51318,53,304,86,218,2,30,1,1,0
55264,53,25192,53,177,94,83,2,30,1,1,0
44491,50584,0,0,62,62,0,1,0,1,0,1
51967,12110,53548,12110,70,70,0,1,4,1,0,0
51196,445,0,0,70,70,0,1,0,1,0,2
52095,443,5865,443,3023,2045,978,15,15,9,6,0
64497,53,35440,53,232,110,122,2,29,1,1,0
60181,445,0,0,66,66,0,1,0,1,0,2
55514,53,31515,53,747,93,654,2,30,1,1,0
60476,55100,21039,55100,70,70,0,2,8,2,0,0
59272,445,0,0,66,66,0,1,0,1,0,2
57878,445,0,0,70,70,0,1,0,1,0,2
64115,2767,0,0,66,66,0,1,0,1,0,1
60981,443,40562,443,22449,19500,2949,53,21,31,22,0
10532,26672,0,0,60,60,0,1,0,1,0,1
55704,53,57746,53,193,102,91,2,30,1,1,0
64586,50584,0,0,62,62,0,1,0,1,0,1
12531,22114,0,0,62,62,0,1,0,1,0,1
50063,443,44505,443,39888,5010,34878,60,104,32,28,0
65286,53,2453,53,369,102,267,2,30,1,1,0
52206,59077,23195,59077,316,136,180,6,9,3,3,0
55036,53,30063,53,733,93,640,2,31,1,1,0
58638,5900,0,0,62,62,0,1,0,1,0,1
32967,80,37431,80,21387,1482,19905,38,18,19,19,0
63868,445,0,0,70,70,0,1,0,1,0,2
55108,445,0,0,70,70,0,1,0,1,0,2
51348,7000,51348,7000,2163,676,1487,14,15,7,7,0
58326,50584,0,0,146,146,0,1,0,1,0,1
60471,19776,35509,19776,70,70,0,2,8,2,0,0
56318,445,0,0,70,70,0,1,0,1,0,2
42969,8146,0,0,62,62,0,1,0,1,0,1
60139,53,31222,53,218,78,140,2,30,1,1,0
36406,5228,24879,5228,17762,4403,13359,92,616,47,45,0
57527,445,0,0,70,70,0,1,0,1,0,2
55156,53,47566,53,256,87,169,4,37,2,2,0
64214,25174,0,0,66,66,0,1,0,1,0,1
62408,50584,0,0,66,66,0,1,0,1,0,1
42934,443,24809,443,232,172,60,3,5,2,1,0
44956,443,44956,443,5220,1973,3247,22,38,13,9,0
48553,443,14731,443,49428,2702,46726,70,136,30,40,0
49418,27015,42209,27015,234,71,163,2,31,1,1,0
1025,50584,0,0,62,62,0,1,0,1,0,1
48743,443,24308,443,26609,2444,24165,45,21,21,24,0
49650,443,63033,443,93063,2948,90115,107,80,30,77,0
27005,27016,42584,27016,1010,252,758,4,33,3,1,0
61959,445,0,0,66,66,0,1,0,1,0,2
56067,25174,0,0,146,146,0,1,0,1,0,1
52019,40689,48482,40689,70,70,0,2,8,2,0,0
57398,53,47898,53,232,110,122,2,30,1,1,0
41385,53,41385,53,244,98,146,2,34,1,1,0
9087,53,9087,53,215,80,135,2,33,1,1,0
61280,26467,0,0,62,62,0,1,0,1,0,1
57235,53,3428,53,212,102,110,2,30,1,1,0
10834,50584,0,0,66,66,0,1,0,1,0,1
64410,53,61695,53,196,102,94,2,30,1,1,0
57212,445,0,0,70,70,0,1,0,1,0,2
49900,7000,49900,7000,2958,1567,1391,15,15,8,7,0
13484,37965,0,0,66,66,0,1,0,1,0,1
58638,5900,0,0,62,62,0,1,0,1,0,1
64382,53,40543,53,278,102,176,2,30,1,1,0
19642,23,0,0,60,60,0,1,0,1,0,1
57132,445,0,0,70,70,0,1,0,1,0,2
65037,53,16035,53,210,110,100,2,29,1,1,0
55549,53,31074,53,202,103,99,2,31,1,1,0
55129,445,0,0,70,70,0,1,0,1,0,2
63708,25174,0,0,66,66,0,1,0,1,0,1
60193,53,20927,53,214,85,129,2,0,1,1,0
52453,443,8871,443,6650,950,5700,18,75,9,9,0
49663,53,4720,53,195,102,93,2,29,1,1,0
56349,53,28965,53,216,110,106,2,31,1,1,0
25363,22114,0,0,66,66,0,1,0,1,0,1
49533,80,42327,80,8220,849,7371,13,28,5,8,0
48290,443,64782,443,7920,2731,5189,27,82,15,12,0
53041,443,62358,443,2881,346,2535,12,120,5,7,0
37965,32305,6845,32305,1650,1650,0,26,1537,26,0,0
2475,6881,0,0,66,66,0,1,0,1,0,1
57747,80,27520,80,2754,1602,1152,17,22,9,8,0
18574,56205,0,0,62,62,0,1,0,1,0,1
55122,53,17738,53,173,94,79,2,30,1,1,0
63800,80,60637,80,314,192,122,6,15,4,2,0
64044,21989,15782,21989,816,508,308,12,27,7,5,0
56220,445,0,0,70,70,0,1,0,1,0,2
64566,53,26350,53,194,102,92,2,29,1,1,0
56004,53,42302,53,172,88,84,2,30,1,1,0
37247,443,37247,443,4401,1494,2907,19,25,11,8,0
65033,53,12694,53,214,94,120,2,30,1,1,0
53478,443,15802,443,7692,2183,5509,24,224,14,10,0
64098,10096,39565,10096,66,66,0,2,8,2,0,0
55976,445,0,0,70,70,0,1,0,1,0,2
60180,445,0,0,66,66,0,1,0,1,0,2
1537,22114,0,0,62,62,0,1,0,1,0,1
50925,445,0,0,66,66,0,1,0,1,0,2
57799,10387,0,0,145,145,0,1,0,1,0,1
49568,443,30225,443,6408,2531,3877,21,16,11,10,0
50482,443,60480,443,7653,1188,6465,21,15,12,9,0
443,38956,0,0,82,82,0,1,0,1,0,1
57585,51221,0,0,62,62,0,1,0,1,0,1
59219,80,51900,80,1658,1344,314,10,15,5,5,0
52041,80,18599,80,2901,1407,1494,15,38,9,6,0
55145,11392,0,0,66,66,0,1,0,1,0,1
53462,445,0,0,70,70,0,1,0,1,0,2
61495,37965,0,0,66,66,0,1,0,1,0,1
53171,443,32050,443,11080,4277,6803,23,42,10,13,0
65228,53,28840,53,200,102,98,2,30,1,1,0
42665,80,22230,80,7651,2046,5605,16,91,10,6,0
53127,443,41153,443,13914,7812,6102,52,69,28,24,0
65359,53,51803,53,731,91,640,2,30,1,1,0
3175,60038,0,0,66,66,0,1,91,1,0,0
30188,12494,61043,12494,502,150,352,2,1200,1,1,0
60856,443,12085,443,8201,2795,5406,43,18,26,17,0
53794,39607,26801,39607,70,70,0,1,5,1,0,0
48817,41768,48817,41768,511,152,359,2,1200,1,1,0
4793,50584,0,0,66,66,0,1,0,1,0,1
50584,49376,27285,49376,1320,300,1020,6,1200,3,3,0
65081,443,33904,443,5291,339,4952,11,120,5,6,0
50265,6881,13047,6881,491,150,341,2,1200,1,1,0
63517,445,0,0,66,66,0,1,0,1,0,2
49874,445,0,0,70,70,0,1,0,1,0,2
56133,445,0,0,70,70,0,1,0,1,0,2
30046,15503,0,0,62,62,0,1,0,1,0,1
55705,53,27815,53,281,101,180,4,59,2,2,0
54390,445,0,0,70,70,0,1,0,1,0,2
51584,445,0,0,70,70,0,1,0,1,0,2
61550,5529,0,0,145,145,0,1,0,1,0,1
51216,445,0,0,70,70,0,1,0,1,0,2
52788,64147,0,0,62,62,0,1,0,1,0,1
20939,60461,0,0,60,60,0,1,0,1,0,1
61804,51505,0,0,66,66,0,1,0,1,0,1
46477,443,29699,443,4900,904,3996,16,97,9,7,0
44147,64147,0,0,62,62,0,1,0,1,0,1
64048,53,43496,53,209,110,99,2,29,1,1,0
51959,42269,57888,42269,70,70,0,2,8,2,0,0
55470,53,12953,53,197,102,95,2,33,1,1,0
49842,7302,0,0,62,62,0,1,0,1,0,1
65085,445,0,0,66,66,0,1,0,1,0,2
56980,445,0,0,66,66,0,1,0,1,0,2
56672,80,18882,80,234,234,0,4,11,4,0,0
49629,26467,0,0,66,66,0,1,0,1,0,1
1030,35776,0,0,139,139,0,1,0,1,0,1
49733,443,55919,443,7673,1637,6036,31,23,16,15,0
51553,443,28429,443,6662,522,6140,15,16,5,10,0
59175,53,63239,53,168,78,90,2,30,1,1,0
58499,123,31733,123,184,94,90,2,30,1,1,0
55294,445,0,0,70,70,0,1,0,1,0,2
49655,80,40166,80,499,192,307,6,42,4,2,0
5617,64147,0,0,145,145,0,1,0,1,0,1
49317,443,8477,443,1486172,26246,1459926,1245,40,266,979,0
28135,34021,0,0,62,62,0,1,0,1,0,3
64092,14447,3904,14447,66,66,0,2,8,2,0,0
64582,53,64118,53,209,110,99,2,30,1,1,0
49942,53,42485,53,177,94,83,2,31,1,1,0
53856,445,0,0,70,70,0,1,0,1,0,2
51097,80,51452,80,3374,1914,1460,33,131,18,15,0
46093,32661,0,0,74,74,0,1,0,1,0,1
56621,50584,0,0,62,62,0,1,0,1,0,1
49334,53,34104,53,194,102,92,2,30,1,1,0
11775,25174,0,0,62,62,0,1,0,1,0,1
57389,53,9146,53,193,102,91,2,31,1,1,0
49659,445,0,0,66,66,0,1,0,1,0,2
10462,25174,0,0,62,62,0,1,0,1,0,1
60211,443,55686,443,126490514,2726981,123763533,123275,553,41466,81809,0
65426,53,23528,53,706,195,511,6,52,3,3,0
64159,445,0,0,70,70,0,1,0,1,0,2
52022,445,0,0,66,66,0,1,0,1,0,2
55696,64301,60133,64301,316,190,126,5,15,3,2,0
61566,44847,0,0,66,66,0,1,0,1,0,1
51961,443,43999,443,6913,1658,5255,22,17,12,10,0
53424,443,24039,443,9953,1605,8348,35,18,19,16,0
50887,80,30027,80,256649,11414,245235,280,141,111,169,0
56950,443,41087,443,5601,1203,4398,14,60,9,5,0
59949,80,40471,80,730296,15564,714732,723,57,218,505,0
57433,443,58515,443,11243,4236,7007,47,15,22,25,0
64432,445,0,0,70,70,0,1,0,1,0,2
55035,443,52274,443,13310,3162,10148,31,46,16,15,0
60142,445,0,0,70,70,0,1,0,1,0,2
54666,36237,0,0,66,66,0,1,0,1,0,1
57925,445,0,0,70,70,0,1,0,1,0,2
9222,443,6216,443,6676,1097,5579,21,26,11,10,0
56477,53,34733,53,198,101,97,2,31,1,1,0
60677,445,0,0,70,70,0,1,0,1,0,2
53549,40826,14418,40826,492,306,186,8,14,5,3,0
65418,445,0,0,70,70,0,1,0,1,0,2
52120,445,0,0,70,70,0,1,0,1,0,2
64199,53,4669,53,215,102,113,2,30,1,1,0
65115,50584,0,0,66,66,0,1,0,1,0,1
49168,53,14343,53,196,102,94,2,30,1,1,0
55658,443,55658,443,26504,10384,16120,58,48,37,21,0
443,64347,0,0,85,85,0,1,0,1,0,1
50644,5222,32859,5222,11661,4442,7219,87,71,41,46,0
64029,53,40003,53,180,94,86,2,30,1,1,0
58638,5900,0,0,62,62,0,1,0,1,0,1
4000,44847,0,0,66,66,0,1,0,1,0,1
57825,13014,0,0,74,74,0,1,0,1,0,1
43092,443,2375,443,7011,2541,4470,19,15,11,8,0
2527,53,2527,53,371,237,134,3,34,2,1,0
63964,53,22176,53,323,85,238,4,34,2,2,0
63987,445,0,0,70,70,0,1,0,1,0,2
57928,30188,0,0,62,62,0,1,0,1,0,1
42298,40009,62202,40009,148,86,62,2,30,1,1,0
25085,30188,0,0,62,62,0,1,0,1,0,1
7288,25174,0,0,66,66,0,1,0,1,0,1
55816,53,60578,53,214,110,104,2,31,1,1,0
50077,53,35101,53,787,110,677,2,30,1,1,0
58638,5900,0,0,62,62,0,1,0,1,0,1
46500,443,37783,443,494,280,214,8,29,5,3,0
49918,26296,0,0,146,146,0,1,0,1,0,1
53789,53,48550,53,168,78,90,2,30,1,1,0
59088,57470,0,0,62,62,0,1,0,1,0,1
14397,37965,0,0,62,62,0,1,0,1,0,1
55224,53,26209,53,711,87,624,2,31,1,1,0
59755,44512,0,0,66,66,0,1,0,1,0,1
60641,445,0,0,70,70,0,1,0,1,0,2
18173,25174,0,0,62,62,0,1,0,1,0,1
63069,445,0,0,70,70,0,1,0,1,0,2
50625,445,0,0,70,70,0,1,0,1,0,2
57986,445,0,0,70,70,0,1,0,1,0,2
39217,31573,0,0,146,146,0,1,0,1,0,1
52644,57209,0,0,66,66,0,1,0,1,0,1
48171,443,3704,443,10420,3506,6914,33,274,18,15,0
41473,443,44182,443,4987881,144889,4842992,5257,85,1888,3369,0
57385,80,37415,80,2546,1294,1252,17,138,9,8,0
62874,445,0,0,70,70,0,1,0,1,0,2
64538,53,8098,53,194,102,92,2,29,1,1,0
49455,445,0,0,66,66,0,1,0,1,0,2
44720,53,0,0,86,86,0,1,29,1,0,0
37552,443,42195,443,9959,2495,7464,27,37,15,12,0
53011,445,0,0,70,70,0,1,0,1,0,2
64840,445,0,0,70,70,0,1,0,1,0,2
56984,80,27269,80,214,140,74,4,35,3,1,0
56263,445,0,0,66,66,0,1,0,1,0,2
49982,53,15818,53,322,94,228,4,49,2,2,0
55179,53,63963,53,194,102,92,2,30,1,1,0
37965,30982,7359,30982,528,528,0,9,1199,9,0,0
55013,53,63318,53,728,102,626,2,29,1,1,0
22541,64147,0,0,66,66,0,1,0,1,0,1
49514,65504,0,0,162,162,0,1,0,1,0,1
48470,80,20195,80,959,544,415,11,315,6,5,0
55436,445,0,0,70,70,0,1,0,1,0,2
3478,61463,0,0,585,585,0,1,0,1,0,1
50840,443,34565,443,8057,1135,6922,19,139,9,10,0
62170,445,0,0,70,70,0,1,0,1,0,2
34158,443,8410,443,130,70,60,2,15,1,1,0
55703,13836,54739,13836,70,70,0,2,8,2,0,0
56245,53,14605,53,200,102,98,2,30,1,1,0
59404,53,59404,53,237,91,146,2,32,1,1,0
49693,53,49502,53,209,110,99,2,30,1,1,0
56660,53,3127,53,338,110,228,2,30,1,1,0
48655,80,39370,80,956,541,415,11,315,6,5,0
28013,443,29765,443,6130,1264,4866,18,75,9,9,0
54805,80,8562,80,448,78,370,6,24,1,5,0
55531,53,57594,53,370,126,244,2,30,1,1,0
56955,53,43873,53,183,94,89,2,30,1,1,0
56623,53,18777,53,771,101,670,2,30,1,1,0
56078,22,0,0,60,60,0,1,0,1,0,1
42252,33303,0,0,60,60,0,1,0,1,0,1
43568,443,63608,443,9445,6593,2852,43,96,25,18,0
62066,443,55561,443,11816,3175,8641,32,46,16,16,0
60742,443,40207,443,2258,559,1699,22,120,6,16,0
34756,443,27102,443,100090,8304,91786,135,127,50,85,0
53531,48908,42269,48908,70,70,0,1,4,1,0,0
34993,15503,0,0,62,62,0,1,0,1,0,1
56997,80,45711,80,214,140,74,4,35,3,1,0
51203,445,0,0,70,70,0,1,0,1,0,2
55021,443,43787,443,6724,3642,3082,18,133,10,8,0
23528,44847,0,0,62,62,0,1,0,1,0,1
49401,53,41126,53,258,102,156,2,30,1,1,0
63786,25174,0,0,66,66,0,1,0,1,0,1
13285,29892,0,0,145,145,0,1,0,1,0,1
48742,443,35072,443,5378,1423,3955,19,49,11,8,0
65281,53,27234,53,216,94,122,2,30,1,1,0
55710,445,0,0,70,70,0,1,0,1,0,2
64695,445,0,0,70,70,0,1,0,1,0,2
58638,5900,0,0,62,62,0,1,0,1,0,1
56759,445,0,0,66,66,0,1,0,1,0,2
58633,445,0,0,70,70,0,1,0,1,0,2
55310,53,40255,53,168,78,90,2,29,1,1,0
53987,57470,0,0,66,66,0,1,0,1,0,1
49201,443,23062,443,13738,6378,7360,70,981,33,37,0
57802,445,0,0,70,70,0,1,0,1,0,2
37586,443,60521,443,499,425,74,4,0,3,1,0
37574,123,51434,123,184,94,90,2,30,1,1,0
56704,53,19637,53,188,96,92,2,31,1,1,0
64884,53,2199,53,190,97,93,2,31,1,1,0
55172,80,55172,80,268230,8528,259702,292,231,106,186,0
56938,53,56411,53,199,102,97,2,31,1,1,0
25237,57470,0,0,62,62,0,1,0,1,0,1
54275,445,0,0,70,70,0,1,0,1,0,2
5588,5588,0,0,3498,1872,1626,48,195,24,24,0
63134,80,1605,80,18032,904,17128,22,15,7,15,0
56288,53,49732,53,183,94,89,2,31,1,1,0
53121,443,47087,443,36181,3264,32917,51,62,24,27,0
41440,443,30380,443,4370,1148,3222,17,25,9,8,0
51921,80,46796,80,35092,3319,31773,48,31,21,27,0
55029,443,11495,443,7682,3198,4484,27,17,16,11,0
49885,443,30250,443,4626083,113708,4512375,4382,213,1198,3184,0
5588,5588,0,0,3354,1792,1562,46,192,23,23,0
49601,53,32118,53,178,94,84,2,30,1,1,0
58401,445,0,0,70,70,0,1,0,1,0,2
61078,445,0,0,70,70,0,1,0,1,0,2
9434,443,11212,443,5693,499,5194,14,15,7,7,0
5222,32859,0,0,66,66,0,1,0,1,0,1
54563,443,54563,443,109880,24958,84922,154,20,83,71,0
42044,60043,0,0,66,66,0,1,0,1,0,1
56001,445,0,0,70,70,0,1,0,1,0,2
3996,57470,0,0,62,62,0,1,0,1,0,1
49628,443,14591,443,12843,3808,9035,26,81,13,13,0
57424,53,65254,53,177,94,83,2,30,1,1,0
60638,53,31002,53,337,86,251,2,29,1,1,0
48753,80,48753,80,19937,2162,17775,36,24,19,17,0
56369,53,3077,53,193,102,91,2,31,1,1,0
60166,443,38227,443,8198,2252,5946,29,318,14,15,0
53071,25174,0,0,66,66,0,1,0,1,0,1
22856,22114,0,0,66,66,0,1,0,1,0,1
52346,445,0,0,70,70,0,1,0,1,0,2
65258,53,21767,53,178,94,84,2,30,1,1,0
57470,15870,28583,15870,149,149,0,2,1199,2,0,0
57298,8765,45553,8765,2466,1350,1116,37,569,19,18,0
63787,445,0,0,66,66,0,1,0,1,0,2
58638,5900,0,0,62,62,0,1,0,1,0,1
55620,53,6956,53,178,94,84,2,31,1,1,0
49696,53,9591,53,178,94,84,2,30,1,1,0
56951,53,9479,53,199,102,97,2,30,1,1,0
47832,443,4961,443,130090,7064,123026,184,200,92,92,0
46792,443,1807,443,7298,2661,4637,21,18,11,10,0
55714,53,64632,53,173,94,79,2,30,1,1,0
62371,445,0,0,70,70,0,1,0,1,0,2
5462,21247,0,0,62,62,0,1,0,1,0,1
65353,53,60832,53,170,87,83,2,30,1,1,0
57206,53,29989,53,292,85,207,4,50,2,2,0
53721,62413,0,0,62,62,0,1,0,1,0,1
21365,23718,0,0,62,62,0,1,0,1,0,1
50082,53,51299,53,199,94,105,2,30,1,1,0
55820,60038,0,0,66,66,0,1,91,1,0,0
65216,35440,0,0,66,66,0,1,0,1,0,1
56357,443,45710,443,3674,1750,1924,23,203,12,11,0
56081,53,27644,53,186,102,84,2,29,1,1,0
21674,28189,0,0,60,60,0,1,0,1,0,1
62991,51221,0,0,66,66,0,1,0,1,0,1
42433,443,64701,443,6381,3801,2580,19,135,10,9,0
54028,37965,0,0,62,62,0,1,0,1,0,1
59373,22,59373,22,295,126,169,4,1,2,2,1
64679,53,2951,53,178,94,84,2,30,1,1,0
44847,31105,50353,31105,324,150,174,2,1200,1,1,0
56751,53,35800,53,177,94,83,2,30,1,1,0
51806,445,0,0,70,70,0,1,0,1,0,2
6886,45378,0,0,139,139,0,1,0,1,0,1
55786,53,64576,53,193,102,91,2,29,1,1,0
51784,8245,58196,8245,280,214,66,2,31,1,1,0
50283,443,2548,443,49752,4187,45565,87,100,45,42,0
55675,53,21127,53,198,102,96,2,30,1,1,0
57884,443,2033,443,3981,1811,2170,26,177,14,12,0
55726,32463,13679,32463,70,70,0,2,8,2,0,0
65016,53,63384,53,215,94,121,2,29,1,1,0
50863,80,47507,80,5874,744,5130,14,131,7,7,0
43708,53,62627,53,168,78,90,2,30,1,1,0
56630,443,6016,443,7941,1952,5989,20,15,11,9,0
58767,53,1096,53,168,78,90,2,29,1,1,0
53163,445,0,0,66,66,0,1,0,1,0,2
54302,445,0,0,70,70,0,1,0,1,0,2
55702,80,56730,80,70,70,0,2,8,2,0,0
45964,2225,0,0,60,60,0,1,0,1,0,1
2695,48817,0,0,62,62,0,1,0,1,0,1
64605,445,0,0,70,70,0,1,0,1,0,2
56387,445,0,0,70,70,0,1,0,1,0,2
61236,445,0,0,70,70,0,1,0,1,0,2
50366,445,0,0,70,70,0,1,0,1,0,2
56765,53,52447,53,194,102,92,2,30,1,1,0
53465,57470,0,0,62,62,0,1,0,1,0,1
6881,6881,0,0,146,146,0,1,0,1,0,1
55063,445,0,0,70,70,0,1,0,1,0,2
30188,63236,11932,63236,11247,4773,6474,66,1454,32,34,0
35408,56205,0,0,62,62,0,1,0,1,0,1
51088,443,60075,443,14025,7301,6724,38,171,22,16,0
51940,80,37296,80,366,240,126,7,27,5,2,0
63972,53,23173,53,186,95,91,2,30,1,1,0
59528,445,0,0,66,66,0,1,0,1,0,2
64393,53,49935,53,182,93,89,2,31,1,1,0
57996,80,13904,80,5411,3618,1793,27,75,14,13,0
3478,61463,0,0,1275,1275,0,1,0,1,0,1
49450,443,1753,443,2319947,69322,2250625,2464,70,870,1594,0
49591,53,7578,53,168,86,82,2,32,1,1,0
52070,443,55434,443,8971,4228,4743,20,95,12,8,0
55641,443,52887,443,6133,1655,4478,12,119,5,7,0
55411,53,60848,53,182,93,89,2,31,1,1,0
55010,53,38368,53,190,97,93,2,31,1,1,0
57394,53,39709,53,193,102,91,2,31,1,1,0
55290,445,0,0,70,70,0,1,0,1,0,2
50214,53,34671,53,789,110,679,2,31,1,1,0
49756,53,1585,53,264,89,175,4,48,2,2,0
55679,445,0,0,70,70,0,1,0,1,0,2
64854,53,42024,53,172,88,84,2,30,1,1,0
59494,443,39878,443,448,78,370,6,25,1,5,0
52315,443,14653,443,24304,2974,21330,57,34,31,26,0
55917,53,58501,53,371,109,262,4,59,2,2,0
64969,27044,17492,27044,741,462,279,2,30,1,1,0
23843,26467,0,0,62,62,0,1,0,1,0,1
16387,56995,0,0,60,60,0,1,0,1,0,1
58638,5900,0,0,62,62,0,1,0,1,0,1
48576,443,26108,443,476,410,66,4,0,3,1,0
56388,53,34689,53,275,95,180,4,49,2,2,0
65323,53,20486,53,193,102,91,2,30,1,1,0
50563,445,0,0,70,70,0,1,0,1,0,2
52983,445,0,0,66,66,0,1,0,1,0,2
65271,445,0,0,66,66,0,1,0,1,0,2
55560,53,7666,53,166,86,80,2,30,1,1,0
62075,445,0,0,70,70,0,1,0,1,0,2
56561,53,63189,53,167,86,81,2,30,1,1,0
56019,53,13898,53,194,102,92,2,30,1,1,0
39208,5900,39208,5900,152,66,86,2,10,1,1,0
60249,445,0,0,66,66,0,1,0,1,0,2
54450,445,0,0,70,70,0,1,0,1,0,2
64172,445,0,0,66,66,0,1,0,1,0,2
54902,445,0,0,66,66,0,1,0,1,0,2
63460,445,0,0,70,70,0,1,0,1,0,2
42847,443,14614,443,162,102,60,2,4,1,1,0
57514,53,51498,53,168,78,90,2,30,1,1,0
54346,44847,0,0,62,62,0,1,0,1,0,1
50382,443,9728,443,10423,2542,7881,48,20,24,24,0
53531,445,0,0,70,70,0,1,0,1,0,2
60332,53,8836,53,419,111,308,2,31,1,1,0
64160,445,0,0,70,70,0,1,0,1,0,2
14435,443,15912,443,2569,1470,1099,17,15,8,9,0
51286,445,0,0,70,70,0,1,0,1,0,2
52891,445,0,0,70,70,0,1,0,1,0,2
54437,80,15743,80,95298,61941,33357,182,929,95,87,0
62251,445,0,0,70,70,0,1,0,1,0,2
61237,445,0,0,70,70,0,1,0,1,0,2
49507,443,28948,443,9536,2399,7137,32,270,17,15,0
50598,80,63854,80,17837,3830,14007,27,24,12,15,0
61740,443,6060,443,92202,65396,26806,193,3454,68,125,0
50355,443,1395,443,1786,172,1614,7,120,3,4,0
58795,445,0,0,70,70,0,1,0,1,0,2
56492,53,1811,53,94,94,0,1,30,1,0,0
61233,443,12202,443,1775,169,1606,7,120,3,4,0
50575,53,5901,53,766,102,664,2,30,1,1,0
52978,445,0,0,70,70,0,1,0,1,0,2
42137,443,46635,443,9173,2080,7093,22,18,13,9,0
53768,443,3588,443,499,425,74,4,0,3,1,0
50285,443,10190,443,18009,7378,10631,58,62,33,25,0
56557,53,31623,53,212,108,104,2,31,1,1,0
56560,53,48488,53,198,102,96,2,30,1,1,0
35460,35440,0,0,62,62,0,1,0,1,0,1
47595,33441,0,0,106,106,0,1,60,1,0,0
50130,53,12691,53,183,94,89,2,29,1,1,0
50931,443,19777,443,4178,2310,1868,39,30,23,16,0
57340,3333,57340,3333,24544,10921,13623,171,1095,89,82,0
49918,53,24031,53,196,100,96,2,31,1,1,0
60208,80,42230,80,1313,738,575,10,152,6,4,0
49846,443,59260,443,278883,9002,269881,313,72,115,198,0
3117,37965,0,0,62,62,0,1,0,1,0,1
21133,54508,26359,54508,323,150,173,2,1199,1,1,0
9404,443,30760,443,5693,499,5194,14,15,7,7,0
2837,25174,0,0,66,66,0,1,0,1,0,1
46592,53,27919,53,168,78,90,2,30,1,1,0
51639,445,0,0,66,66,0,1,0,1,0,2
5588,5588,0,0,3354,1792,1562,46,194,23,23,0
64194,445,0,0,70,70,0,1,0,1,0,2
58568,445,0,0,70,70,0,1,0,1,0,2
64982,53,35426,53,195,102,93,2,30,1,1,0
37609,15503,0,0,146,146,0,1,0,1,0,1
5588,5588,0,0,3354,1792,1562,46,195,23,23,0
49795,53,15978,53,209,110,99,2,30,1,1,0
58373,443,64061,443,78832,12408,66424,109,162,46,63,0
57555,443,43596,443,25519,7061,18458,37,16,20,17,0
52327,445,0,0,70,70,0,1,0,1,0,2
65326,445,0,0,66,66,0,1,0,1,0,2
57572,445,0,0,70,70,0,1,0,1,0,2
53598,40326,59380,40326,70,70,0,1,4,1,0,0
59897,443,39118,443,9919,4495,5424,53,118,30,23,0
50183,445,0,0,70,70,0,1,0,1,0,2
50414,443,29700,443,1346,918,428,10,25,6,4,0
49966,53,5626,53,168,78,90,2,30,1,1,0
54389,28543,0,0,66,66,0,1,0,1,0,1
58259,53,21594,53,578,286,292,9,15,5,4,0
57470,34590,16143,34590,527,166,361,2,1200,1,1,0
11324,443,11324,443,6981,948,6033,17,28,10,7,0
57396,443,32290,443,152,78,74,2,4,1,1,0
50265,21544,58613,21544,390,266,124,6,1200,4,2,0
60130,443,10266,443,16291,9102,7189,94,508,42,52,0
44559,443,29969,443,6903,1185,5718,26,255,12,14,0
64603,53,6564,53,258,102,156,2,30,1,1,0
59043,35440,0,0,66,66,0,1,0,1,0,1
3478,61463,0,0,68,68,0,1,0,1,0,1
49367,53,52320,53,718,94,624,2,30,1,1,0
37682,5228,19029,5228,5554,755,4799,14,3600,8,6,0
57007,5333,59200,5333,7194101,1949033,5245068,50585,1008,24913,25672,0
49319,53,9038,53,199,102,97,2,30,1,1,0
57514,445,0,0,70,70,0,1,0,1,0,2
63690,445,0,0,70,70,0,1,0,1,0,2
34306,37965,0,0,62,62,0,1,0,1,0,1
54321,445,0,0,70,70,0,1,0,1,0,2
64657,53,35491,53,370,96,274,4,39,2,2,0
64768,53,30874,53,78,78,0,1,30,1,0,0
49308,53,4514,53,195,102,93,2,30,1,1,0
43475,443,10490,443,5578,1646,3932,23,16,13,10,0
49918,53,41805,53,198,102,96,2,30,1,1,0
57470,45340,41159,45340,527,166,361,2,1200,1,1,0
56713,53,30137,53,226,110,116,2,30,1,1,0
55117,445,0,0,70,70,0,1,0,1,0,2
58830,28678,13686,28678,1806,1806,0,22,224,22,0,0
60798,40010,54476,40010,316,136,180,6,6,3,3,0
39165,23,0,0,60,60,0,1,0,1,0,1
49634,443,60698,443,20860,1618,19242,35,122,15,20,0
31619,51221,0,0,62,62,0,1,0,1,0,1
47039,443,29901,443,2809,1884,925,19,25,11,8,0
1049,54369,0,0,62,62,0,1,0,1,0,1
57066,53,30352,53,197,94,103,2,30,1,1,0
58228,53733,0,0,66,66,0,1,0,1,0,1
49438,443,56148,443,180,60,120,4,15,2,2,0
65112,53,30397,53,202,103,99,2,31,1,1,0
49326,443,59214,443,5514,3341,2173,31,75,15,16,0
64347,53,36083,53,186,95,91,2,30,1,1,0
50759,53,62224,53,578,286,292,9,16,5,4,0
65235,53,39902,53,216,94,122,2,30,1,1,0
38019,443,55149,443,884,464,420,13,28,7,6,0
64266,53,27142,53,168,86,82,2,30,1,1,0
57603,445,0,0,66,66,0,1,0,1,0,2
53191,80,63359,80,1871,712,1159,10,15,5,5,0
50821,445,0,0,70,70,0,1,0,1,0,2
62682,445,0,0,66,66,0,1,0,1,0,2
55107,445,0,0,70,70,0,1,0,1,0,2
46771,80,6345,80,2066,1369,697,13,84,7,6,0
2267,53,43002,53,204,118,86,2,30,1,1,0
54111,62609,0,0,148,148,0,1,0,1,0,1
36361,80,36361,80,514,246,268,9,76,5,4,0
37902,23718,0,0,146,146,0,1,0,1,0,1
38640,80,6468,80,1013,504,509,10,15,6,4,0
5926,25174,0,0,62,62,0,1,0,1,0,1
52280,44847,0,0,66,66,0,1,0,1,0,1
64531,53,46731,53,182,93,89,2,30,1,1,0
57836,443,52669,443,15844,1691,14153,18,138,5,13,0
55689,37965,0,0,66,66,0,1,0,1,0,1
56293,53,53120,53,164,84,80,2,31,1,1,0
52044,445,0,0,70,70,0,1,0,1,0,2
33028,80,50046,80,130,70,60,2,15,1,1,0
51852,445,0,0,70,70,0,1,0,1,0,2
64907,53,25739,53,168,86,82,2,30,1,1,0
9334,443,58101,443,674,128,546,12,46,3,9,0
37621,80,10654,80,350,210,140,6,15,4,2,0
65189,27015,46211,27015,267,78,189,2,30,1,1,0
49524,445,0,0,70,70,0,1,0,1,0,2
50582,443,54824,443,7453,1467,5986,19,25,10,9,0
39313,37965,0,0,62,62,0,1,0,1,0,1
58638,5900,0,0,62,62,0,1,0,1,0,1
55302,445,0,0,70,70,0,1,0,1,0,2
55614,445,0,0,70,70,0,1,0,1,0,2
49765,53,24395,53,194,102,92,2,31,1,1,0
13262,53,13262,53,208,94,114,2,31,1,1,0
50964,445,0,0,70,70,0,1,0,1,0,2
49417,38558,0,0,66,66,0,1,0,1,0,1
54759,445,0,0,66,66,0,1,0,1,0,2
50838,53,8440,53,70,70,0,1,30,1,0,0
60384,80,50302,80,1420,715,705,12,16,7,5,0
51071,445,0,0,70,70,0,1,0,1,0,2
60362,445,0,0,70,70,0,1,0,1,0,2
49622,53,45379,53,185,102,83,2,30,1,1,0
53838,36829,0,0,66,66,0,1,0,1,0,1
53829,445,0,0,66,66,0,1,0,1,0,2
55375,445,0,0,70,70,0,1,0,1,0,2
55206,443,55206,443,18965,2061,16904,35,17,18,17,0
45205,443,55089,443,7221,3151,4070,20,162,9,11,0
55064,443,12029,443,12611,3681,8930,26,61,15,11,0
2691,64147,0,0,62,62,0,1,0,1,0,1
59772,62413,0,0,66,66,0,1,0,1,0,1
64913,53,34114,53,211,102,109,2,30,1,1,0
64078,54561,14823,54561,70,70,0,1,4,1,0,0
50618,443,50618,443,4351,1444,2907,19,28,11,8,0
52831,3389,52831,3389,4145,1976,2169,22,18,13,9,0
58638,5900,0,0,62,62,0,1,0,1,0,1
63798,16357,31313,16357,70,70,0,1,4,1,0,0
53908,443,36300,443,499,425,74,4,0,3,1,0
43260,41615,0,0,145,145,0,1,0,1,0,1
52934,26467,0,0,66,66,0,1,0,1,0,1
60899,445,0,0,70,70,0,1,0,1,0,2
37267,443,16640,443,3296,1636,1660,17,255,9,8,0
51457,443,1251,443,334,70,264,5,17,1,4,0
50255,445,0,0,66,66,0,1,0,1,0,2
51790,80,59266,80,1936,1085,851,9,15,5,4,0
50589,53,31342,53,177,94,83,2,29,1,1,0
60848,53,46740,53,168,78,90,2,30,1,1,0
52309,80,52309,80,450,246,204,8,29,5,3,0
11295,40033,3453,40033,213,89,124,4,32,2,2,0
64227,53,63621,53,302,92,210,4,30,2,2,0
53790,445,0,0,66,66,0,1,0,1,0,2
57470,1337,44694,1337,594,594,0,10,1199,10,0,0
60046,445,0,0,66,66,0,1,0,1,0,2
56654,443,29055,443,18544,4402,14142,31,191,14,17,0
64750,53,24687,53,193,102,91,2,29,1,1,0
49506,53,23058,53,200,102,98,2,30,1,1,0
51413,32480,0,0,72,72,0,1,0,1,0,1
59575,445,0,0,70,70,0,1,0,1,0,2
60796,53,60796,53,248,106,142,2,30,1,1,0
55669,53,15322,53,94,94,0,1,29,1,0,0
59393,443,45183,443,1664,914,750,15,275,7,8,0
53504,445,0,0,70,70,0,1,0,1,0,2
64573,53,37433,53,757,102,655,2,30,1,1,0
51010,445,0,0,70,70,0,1,0,1,0,2
8933,56205,0,0,62,62,0,1,0,1,0,1
64145,53,5953,53,504,105,399,4,35,2,2,0
48105,53,48105,53,262,106,156,2,33,1,1,0
61053,44847,0,0,66,66,0,1,0,1,0,1
50150,80,7592,80,73454,5461,67993,74,79,22,52,0
52793,443,27629,443,1942,1281,661,22,228,16,6,0
64743,445,0,0,70,70,0,1,0,1,0,2
65252,53,49878,53,249,102,147,2,30,1,1,0
64731,53,27701,53,403,142,261,2,30,1,1,0
60412,443,58640,443,7353,1573,5780,21,78,11,10,0
41295,443,40323,443,7661,1115,6546,19,35,10,9,0
59734,443,48585,443,1312,651,661,13,184,7,6,0
64585,80,64585,80,405673,21057,384616,519,26,252,267,0
55411,53,47570,53,183,94,89,2,30,1,1,0
6057,51221,0,0,78,78,0,1,0,1,0,1
44794,443,36304,443,11158,3338,7820,27,16,16,11,0
10039,443,49424,443,12579,1722,10857,29,171,12,17,0
55258,53,48782,53,177,94,83,2,30,1,1,0
54429,445,0,0,70,70,0,1,0,1,0,2
64576,53,33878,53,188,96,92,2,31,1,1,0
7871,3389,7871,3389,4166,2141,2025,18,18,9,9,0
64305,53,21382,53,598,196,402,6,71,3,3,0
49546,53,57576,53,208,106,102,2,31,1,1,0
34758,5228,2453,5228,10206,2218,7988,36,4265,18,18,0
55591,53,58697,53,190,97,93,2,31,1,1,0
53126,445,0,0,70,70,0,1,0,1,0,2
46849,36237,0,0,66,66,0,1,0,1,0,1
46859,50584,0,0,62,62,0,1,0,1,0,1
64366,445,0,0,66,66,0,1,0,1,0,2
53981,29500,46111,29500,320,140,180,6,7,3,3,0
55582,53,5858,53,177,94,83,2,30,1,1,0
53834,445,0,0,70,70,0,1,0,1,0,2
64606,445,0,0,70,70,0,1,0,1,0,2
48808,443,13852,443,8192,2071,6121,23,361,10,13,0
50566,22114,0,0,62,62,0,1,0,1,0,1
27005,27015,15666,27015,876,126,750,2,30,1,1,0
61701,15503,0,0,66,66,0,1,0,1,0,1
64561,53,25485,53,270,94,176,2,30,1,1,0
25031,25174,0,0,146,146,0,1,0,1,0,1
64324,37807,0,0,146,146,0,1,0,1,0,1
64940,26467,0,0,62,62,0,1,0,1,0,1
65350,53,48602,53,168,86,82,2,31,1,1,0
59936,443,17847,443,34167,3638,30529,50,200,23,27,0
42520,443,59710,443,6795,2090,4705,27,21,15,12,0
64274,445,0,0,70,70,0,1,0,1,0,2
443,20995,0,0,83,83,0,1,0,1,0,1
16387,64075,0,0,60,60,0,1,0,1,0,1
53872,443,4533,443,11541,4181,7360,62,283,27,35,0
55458,445,0,0,70,70,0,1,0,1,0,2
64913,53,33116,53,194,102,92,2,30,1,1,0
55628,13343,19881,13343,634,388,246,10,18,6,4,0
49717,443,52321,443,4876,855,4021,16,52,7,9,0
55470,53,60625,53,310,94,216,2,30,1,1,0
57131,31061,0,0,145,145,0,1,0,1,0,1
54187,445,0,0,70,70,0,1,0,1,0,2
27446,30188,0,0,66,66,0,1,0,1,0,1
65231,445,0,0,70,70,0,1,0,1,0,2
52986,445,0,0,66,66,0,1,0,1,0,2
65306,445,0,0,66,66,0,1,0,1,0,2
50216,443,60442,443,6320,1382,4938,24,167,13,11,0
64739,53,37126,53,193,102,91,2,30,1,1,0
59955,80,59955,80,16324,808,15516,25,59,11,14,0
51660,80,21356,80,52002,2984,49018,77,35,35,42,0
26889,50265,0,0,62,62,0,1,0,1,0,1
54237,443,5337,443,499,425,74,4,0,3,1,0
45871,443,58048,443,275011,235921,39090,651,350,363,288,0
68,67,0,0,594,594,0,1,0,1,0,1
64324,37807,0,0,62,62,0,1,0,1,0,1
49993,37965,0,0,66,66,0,1,0,1,0,1
19473,6881,30849,6881,491,150,341,2,1200,1,1,0
63423,445,0,0,66,66,0,1,0,1,0,2
53743,23915,44968,23915,70,70,0,1,4,1,0,0
61697,443,10867,443,9963,2631,7332,37,48,20,17,0
50038,53,5932,53,170,87,83,2,31,1,1,0
53017,80,53017,80,184725,5028,179697,217,25,75,142,0
50504,443,62477,443,6051,1149,4902,16,25,9,7,0
55358,53,28706,53,183,94,89,2,31,1,1,0
53373,64147,0,0,66,66,0,1,0,1,0,1
52829,443,52829,443,4613,1706,2907,19,30,11,8,0
56127,37965,0,0,62,62,0,1,0,1,0,1
58638,5900,0,0,62,62,0,1,0,1,0,1
35163,30188,0,0,66,66,0,1,0,1,0,1
57409,53,7230,53,168,86,82,2,30,1,1,0
28040,64147,0,0,62,62,0,1,0,1,0,1
57730,445,0,0,66,66,0,1,0,1,0,2
57409,53,32069,53,168,86,82,2,31,1,1,0
52703,443,1986,443,7843,2397,5446,23,256,12,11,0
55655,63670,50631,63670,70,70,0,1,5,1,0,0
10462,25174,0,0,146,146,0,1,0,1,0,1
55156,53,28197,53,256,87,169,4,36,2,2,0
28424,35440,0,0,66,66,0,1,0,1,0,1
60113,443,5252,443,704,280,424,11,19,5,6,0
1078,30975,0,0,143,143,0,1,0,1,0,1
50562,53,50562,53,216,82,134,2,32,1,1,0
57202,53,47171,53,184,94,90,2,30,1,1,0
49639,443,59144,443,13604,1980,11624,33,46,18,15,0
63289,445,0,0,70,70,0,1,0,1,0,2
55790,53,27986,53,177,94,83,2,30,1,1,0
64076,53,18119,53,353,118,235,2,30,1,1,0
50891,80,64394,80,136656,9764,126892,162,140,70,92,0
59206,445,0,0,70,70,0,1,0,1,0,2
46360,443,51396,443,1053,566,487,10,16,6,4,0
64885,53,64870,53,753,93,660,2,31,1,1,0
62731,443,62731,443,9938,3644,6294,31,18,18,13,0
50336,443,6025,443,8814,1579,7235,24,41,12,12,0
35849,30188,0,0,146,146,0,1,0,1,0,1
56368,443,23641,443,3734,1750,1984,24,203,12,12,0
53458,443,20818,443,7584,7094,490,14,123,7,7,0
57455,443,26313,443,9124,5296,3828,54,120,29,25,0
37990,49152,47344,49152,156,156,0,3,7,3,0,0
53488,445,0,0,70,70,0,1,0,1,0,2
34910,443,46197,443,16227,7159,9068,40,524,21,19,0
52447,43890,0,0,66,66,0,1,0,1,0,1
56901,445,0,0,70,70,0,1,0,1,0,2
49073,443,18222,443,8960,2497,6463,35,32,19,16,0
14333,51050,0,0,62,62,0,1,0,1,0,1
34014,80,56105,80,1951,731,1220,11,150,6,5,0
56824,55829,39772,55829,70,70,0,1,5,1,0,0
52791,80,25328,80,82430,3774,78656,108,67,49,59,0
58866,443,52755,443,2353,1453,900,16,15,8,8,0
65270,3855,0,0,78,78,0,1,0,1,0,1
32520,47993,0,0,62,62,0,1,0,1,0,1
0,0,0,0,60,60,0,1,0,1,0,1
57591,53,13897,53,165,78,87,2,31,1,1,0
27038,51505,0,0,62,62,0,1,0,1,0,1
62820,445,0,0,70,70,0,1,0,1,0,2
34366,53,0,0,82,82,0,1,31,1,0,0
62747,445,0,0,66,66,0,1,0,1,0,2
61913,445,0,0,70,70,0,1,0,1,0,2
65263,445,0,0,66,66,0,1,0,1,0,2
1441,51221,0,0,62,62,0,1,0,1,0,1
12338,64147,0,0,66,66,0,1,0,1,0,1
52506,445,0,0,70,70,0,1,0,1,0,2
51789,80,62386,80,28433,1668,26765,39,20,18,21,0
63493,445,0,0,70,70,0,1,0,1,0,2
50482,445,0,0,66,66,0,1,0,1,0,2
31136,50584,0,0,146,146,0,1,0,1,0,1
49305,53,42044,53,177,94,83,2,30,1,1,0
50235,5900,0,0,60,60,0,1,0,1,0,1
56909,53,4449,53,260,86,174,2,30,1,1,0
54819,443,59534,443,3429,1188,2241,13,134,6,7,0
51510,7000,51510,7000,3490,1923,1567,14,16,7,7,0
64886,53,49173,53,199,102,97,2,29,1,1,0
64204,53,3889,53,186,95,91,2,31,1,1,0
64899,53,12836,53,199,102,97,2,29,1,1,0
56461,53,50926,53,760,96,664,2,31,1,1,0
43457,31573,0,0,146,146,0,1,0,1,0,1
55252,53,15058,53,212,102,110,2,30,1,1,0
55332,53,34862,53,211,110,101,2,30,1,1,0
56395,53,7674,53,177,94,83,2,30,1,1,0
56576,443,12093,443,6971,1510,5461,21,80,11,10,0
64095,1976,59947,1976,66,66,0,2,8,2,0,0
53713,443,33766,443,9555,4200,5355,25,86,15,10,0
58993,443,55872,443,416,210,206,7,26,4,3,0
55377,445,0,0,70,70,0,1,0,1,0,2
45032,53,45032,53,216,82,134,2,33,1,1,0
50039,7000,50039,7000,3050,1659,1391,16,15,9,7,0
64989,53,60666,53,214,102,112,2,30,1,1,0
49567,443,55321,443,6408,2531,3877,21,15,11,10,0
49413,443,7382,443,44505,6962,37543,64,48,21,43,0
9659,81,0,0,60,60,0,1,0,1,0,1
63943,445,0,0,70,70,0,1,0,1,0,2
34165,443,24288,443,14923,1978,12945,32,49,17,15,0
59883,17637,0,0,66,66,0,1,0,1,0,1
51272,12210,15332,12210,70,70,0,1,5,1,0,0
16824,11119,0,0,148,148,0,1,0,1,0,1
6881,57470,0,0,146,146,0,1,0,1,0,1
54956,53,56541,53,194,102,92,2,30,1,1,0
54144,443,45159,443,5736,1990,3746,25,16,14,11,0
50407,80,54250,80,1388,917,471,11,26,6,5,0
54907,445,0,0,70,70,0,1,0,1,0,2
53532,445,0,0,70,70,0,1,0,1,0,2
60366,443,31619,443,14484,7411,7073,26,60,15,11,0
41581,443,9229,443,6816,1197,5619,24,269,12,12,0
51996,57470,0,0,66,66,0,1,0,1,0,1
54898,443,54771,443,78537,4022,74515,120,386,55,65,0
56336,53,12124,53,196,102,94,2,30,1,1,0
57470,26944,61791,26944,480,149,331,2,1200,1,1,0
25469,57470,0,0,62,62,0,1,0,1,0,1
60159,22114,0,0,66,66,0,1,0,1,0,1
65122,53,25897,53,410,110,300,2,30,1,1,0
27321,25174,0,0,62,62,0,1,0,1,0,1
59565,445,0,0,70,70,0,1,0,1,0,2
64607,443,37548,443,3182,1568,1614,8,120,4,4,0
64543,53,58923,53,761,100,661,2,31,1,1,0
41577,53,41577,53,265,111,154,2,0,1,1,0
55275,53,41187,53,770,101,669,2,30,1,1,0
52718,53,15399,53,164,78,86,2,30,1,1,0
57033,445,0,0,66,66,0,1,0,1,0,2
60238,80,26979,80,1176,701,475,9,150,6,3,0
63194,50265,0,0,66,66,0,1,0,1,0,1
9171,80,16073,80,318,192,126,6,29,4,2,0
9523,443,27776,443,7199,1410,5789,22,33,11,11,0
59452,445,0,0,66,66,0,1,0,1,0,2
52056,80,64858,80,4562,3936,626,11,28,6,5,0
44277,443,64665,443,36026,28458,7568,70,407,30,40,0
58108,445,0,0,70,70,0,1,0,1,0,2
53765,443,33408,443,499,425,74,4,0,3,1,0
64569,53,2461,53,214,102,112,2,31,1,1,0
25565,58771,0,0,60,60,0,1,0,1,0,1
50068,53,50068,53,240,96,144,2,30,1,1,0
54811,443,21381,443,3392,2305,1087,22,80,11,11,0
59932,443,1750,443,333535,35190,298345,555,285,257,298,0
55907,53,18391,53,184,94,90,2,31,1,1,0
18061,25174,0,0,62,62,0,1,0,1,0,1
0,0,0,0,98,98,0,1,0,1,0,1
61146,443,19937,443,8580941,269463,8311478,9202,122,3016,6186,0
28306,25604,0,0,62,62,0,1,0,1,0,1
52096,445,0,0,70,70,0,1,0,1,0,2
65228,53,0,0,88,88,0,1,0,1,0,1
53584,62974,25990,62974,70,70,0,2,8,2,0,0
58869,57470,0,0,145,145,0,1,0,1,0,1
58701,445,0,0,66,66,0,1,0,1,0,2
35811,443,26946,443,13562,3104,10458,38,201,22,16,0
64853,53,19289,53,198,101,97,2,31,1,1,0
33421,443,28800,443,9917,3184,6733,30,91,12,18,0
56521,53,59104,53,310,126,184,2,30,1,1,0
48817,16156,48817,16156,513,152,361,2,1200,1,1,0
57470,51413,16094,51413,700,275,425,4,1200,2,2,0
56652,80,38597,80,234,234,0,4,12,4,0,0
63984,25174,0,0,62,62,0,1,0,1,0,1
55630,53,24833,53,197,102,95,2,30,1,1,0
41744,37965,0,0,62,62,0,1,0,1,0,1
51584,443,13301,443,12641,5741,6900,26,362,12,14,0
49678,80,44529,80,1977,921,1056,9,15,5,4,0
6975,26543,0,0,139,139,0,1,0,1,0,1
63802,445,0,0,66,66,0,1,0,1,0,2
6666,27017,0,0,60,60,0,1,0,1,0,1
53220,80,25607,80,17976,840,17136,21,16,6,15,0
50912,80,58684,80,9578491,119422,9459069,8079,137,1689,6390,0
56467,445,0,0,70,70,0,1,0,1,0,2
56119,46824,0,0,62,62,0,1,0,1,0,1
11136,19910,0,0,62,62,0,1,0,1,0,1
65495,443,43238,443,418463,12360,406103,430,16,151,279,0
62912,26467,0,0,62,62,0,1,0,1,0,1
38731,443,59272,443,13181,5856,7325,23,135,11,12,0
56889,53,34075,53,177,94,83,2,30,1,1,0
33107,443,39338,443,35031,3490,31541,60,363,28,32,0
42520,53,41857,53,168,78,90,2,30,1,1,0
11136,17500,0,0,62,62,0,1,0,1,0,1
7561,43890,0,0,66,66,0,1,0,1,0,1
51852,18636,28064,18636,136,136,0,3,13,3,0,0
63970,53,14367,53,200,94,106,2,30,1,1,0
49349,53,14349,53,183,94,89,2,30,1,1,0
51840,80,51840,80,525257,17273,507984,531,26,183,348,0
57266,53,22077,53,209,102,107,2,30,1,1,0
54833,443,54833,443,306802,26705,280097,395,21,190,205,0
57470,6881,22501,6881,353,166,187,2,1199,1,1,0
50072,53,48106,53,172,94,78,2,30,1,1,0
49717,57470,0,0,62,62,0,1,0,1,0,1
52560,445,0,0,70,70,0,1,0,1,0,2
43634,80,30485,80,1151,711,440,10,15,5,5,0
54140,445,0,0,66,66,0,1,0,1,0,2
55293,445,0,0,66,66,0,1,0,1,0,2
64664,53,45386,53,250,86,164,4,33,2,2,0
57794,53,57794,53,825,99,726,2,30,1,1,0
57247,445,0,0,66,66,0,1,0,1,0,2
49919,445,0,0,70,70,0,1,0,1,0,2
55879,53,59038,53,184,94,90,2,30,1,1,0
58092,445,0,0,70,70,0,1,0,1,0,2
53022,443,29069,443,15099,7828,7271,45,92,24,21,0
60362,445,0,0,70,70,0,1,0,1,0,2
63643,445,0,0,70,70,0,1,0,1,0,2
56841,29753,13885,29753,70,70,0,1,5,1,0,0
58771,445,0,0,70,70,0,1,0,1,0,2
62171,445,0,0,66,66,0,1,0,1,0,2
55436,53,43899,53,774,101,673,2,30,1,1,0
46762,443,18994,443,565251,13665,551586,542,30,173,369,0
50927,80,64147,80,876,519,357,10,75,6,4,0
27005,27013,23327,27013,869,126,743,2,30,1,1,0
56499,445,0,0,66,66,0,1,0,1,0,2
49861,445,0,0,70,70,0,1,0,1,0,2
55267,445,0,0,70,70,0,1,0,1,0,2
10003,64147,0,0,62,62,0,1,0,1,0,1
61183,445,0,0,70,70,0,1,0,1,0,2
49914,443,44270,443,5895,728,5167,16,27,8,8,0
58239,80,32964,80,2444,2444,0,3,191,3,0,0
55935,53,44322,53,196,102,94,2,30,1,1,0
56799,443,31346,443,6496,1340,5156,31,506,10,21,0
46982,443,35062,443,3847,2650,1197,22,35,13,9,0
65503,443,44158,443,429890,12640,417250,442,16,155,287,0
62455,443,9859,443,8302,2895,5407,22,25,11,11,0
58376,445,0,0,66,66,0,1,0,1,0,2
53651,47758,11315,47758,70,70,0,1,5,1,0,0
60945,445,0,0,70,70,0,1,0,1,0,2
49193,443,41261,443,11773,2390,9383,29,19,15,14,0
57470,51413,17602,51413,330,330,0,6,1199,6,0,0
49993,53,48809,53,212,102,110,2,30,1,1,0
49786,25174,0,0,66,66,0,1,0,1,0,1
19858,38211,0,0,145,145,0,1,0,1,0,1
65126,445,0,0,70,70,0,1,0,1,0,2
55670,31056,27603,31056,70,70,0,1,5,1,0,0
50319,53,7471,53,194,102,92,2,30,1,1,0
5179,50265,0,0,62,62,0,1,0,1,0,1
47063,15503,0,0,146,146,0,1,0,1,0,1
61085,37965,0,0,62,62,0,1,0,1,0,1
55566,443,9542,443,8426,4752,3674,37,122,18,19,0
58638,5900,0,0,62,62,0,1,0,1,0,1
43715,443,63901,443,81803,3159,78644,93,20,33,60,0
65155,53,9340,53,613,200,413,6,59,3,3,0
49160,63766,0,0,146,146,0,1,0,1,0,1
50336,80,50336,80,2143,676,1467,12,25,7,5,0
11136,19910,0,0,62,62,0,1,0,1,0,1
9459,443,54316,443,5695,505,5190,14,15,7,7,0
55828,445,0,0,70,70,0,1,0,1,0,2
64174,53,11186,53,180,94,86,2,31,1,1,0
26881,25174,0,0,66,66,0,1,0,1,0,1
60435,443,42755,443,38888447,473172,38415275,31568,128,5708,25860,0
65132,53,29079,53,167,86,81,2,30,1,1,0
62929,445,0,0,66,66,0,1,0,1,0,2
59627,443,59627,443,4401,1494,2907,19,29,11,8,0
60936,445,0,0,70,70,0,1,0,1,0,2
38999,443,34634,443,12742,1983,10759,47,123,14,33,0
61527,51050,0,0,66,66,0,1,0,1,0,1
11651,64147,0,0,145,145,0,1,0,1,0,1
51962,445,0,0,66,66,0,1,0,1,0,2
51880,18468,1087,18468,70,70,0,2,8,2,0,0
60619,445,0,0,70,70,0,1,0,1,0,2
41039,443,10141,443,1053,566,487,10,31,6,4,0
51079,80,14506,80,19699,2094,17605,32,229,14,18,0
13160,53,13160,53,198,89,109,2,31,1,1,0
1790,48817,0,0,66,66,0,1,0,1,0,1
2437,23117,0,0,146,146,0,1,0,1,0,1
64032,445,0,0,70,70,0,1,0,1,0,2
45057,443,53651,443,1394,733,661,14,80,8,6,0
49363,53,19246,53,212,110,102,2,29,1,1,0
0,0,0,0,480,244,236,4,0,2,2,0
35156,8635,35156,8635,138,78,60,2,5,1,1,0
9605,57470,0,0,62,62,0,1,0,1,0,1
57761,30317,0,0,66,66,0,1,0,1,0,1
50286,445,0,0,66,66,0,1,0,1,0,2
63951,53,13752,53,186,95,91,2,31,1,1,0
52778,445,0,0,70,70,0,1,0,1,0,2
50584,28020,62483,28020,1302,300,1002,6,1200,3,3,0
53759,443,57982,443,499,425,74,4,0,3,1,0
55951,53,13243,53,197,102,95,2,31,1,1,0
49634,53,43147,53,344,126,218,2,30,1,1,0
53204,445,0,0,70,70,0,1,0,1,0,2
53092,443,13048,443,97276,2756,94520,96,96,21,75,0
56623,443,24976,443,8963,2190,6773,18,138,8,10,0
54432,445,0,0,66,66,0,1,0,1,0,2
51990,42127,13506,42127,70,70,0,2,8,2,0,0
58785,443,24870,443,11873,7787,4086,32,16,17,15,0
49825,53,18724,53,168,86,82,2,29,1,1,0
60900,445,0,0,66,66,0,1,0,1,0,2
60403,22114,0,0,66,66,0,1,0,1,0,1
27898,52700,0,0,62,62,0,1,0,1,0,1
56041,53,5205,53,183,94,89,2,30,1,1,0
50813,445,0,0,70,70,0,1,0,1,0,2
15503,56331,21797,56331,481,150,331,2,1200,1,1,0
57470,1024,34451,1024,132,132,0,3,1200,3,0,0
62792,53,0,0,88,88,0,1,0,1,0,1
57005,445,0,0,70,70,0,1,0,1,0,2
64190,445,0,0,70,70,0,1,0,1,0,2
57073,57470,0,0,62,62,0,1,0,1,0,1
59502,445,0,0,70,70,0,1,0,1,0,2
64715,53,60812,53,202,103,99,2,31,1,1,0
50041,443,48278,443,7924,1798,6126,26,15,14,12,0
51957,445,0,0,66,66,0,1,0,1,0,2
52053,445,0,0,70,70,0,1,0,1,0,2
21542,57470,0,0,74,74,0,1,0,1,0,1
61226,443,29248,443,3135,1603,1532,22,632,7,15,0
50191,53,41237,53,182,102,80,2,29,1,1,0
56246,53,65270,53,202,103,99,2,30,1,1,0
37759,53,22729,53,164,78,86,2,30,1,1,0
19882,22114,0,0,146,146,0,1,0,1,0,1
50340,53,41286,53,181,94,87,2,29,1,1,0
49631,445,0,0,70,70,0,1,0,1,0,2
58981,50584,0,0,146,146,0,1,0,1,0,1
49767,80,33888,80,70,70,0,2,8,2,0,0
39809,23,0,0,60,60,0,1,0,1,0,1
57354,53,55769,53,767,102,665,2,30,1,1,0
63194,50265,0,0,62,62,0,1,0,1,0,1
12471,31573,0,0,62,62,0,1,0,1,0,1
56632,443,17597,443,13148,2310,10838,29,80,16,13,0
32971,443,32971,443,18895,2061,16834,34,17,18,16,0
50877,80,27709,80,186520,11545,174975,222,141,96,126,0
48840,50584,0,0,62,62,0,1,0,1,0,1
50489,443,43121,443,8389,1077,7312,24,140,12,12,0
53816,42459,30480,42459,552,306,246,9,16,5,4,0
37308,43890,0,0,62,62,0,1,0,1,0,1
50288,443,59061,443,8207,2558,5649,41,80,23,18,0
51221,6889,53258,6889,481,150,331,2,1200,1,1,0
35265,80,15083,80,3524,2698,826,14,16,8,6,0
46901,26672,0,0,60,60,0,1,0,1,0,1
12965,37965,0,0,66,66,0,1,0,1,0,1
65229,53,46914,53,193,102,91,2,30,1,1,0
19944,22114,0,0,66,66,0,1,0,1,0,1
50605,80,50605,80,2909,1798,1111,14,23,8,6,0
48817,6884,48817,6884,328,152,176,2,1200,1,1,0
64261,53,48738,53,295,110,185,2,30,1,1,0
55411,445,0,0,70,70,0,1,0,1,0,2
993,54634,0,0,66,66,0,1,90,1,0,0
61942,3389,61942,3389,3347,1458,1889,15,18,8,7,0
54051,28793,0,0,66,66,0,1,0,1,0,1
56236,80,56236,80,44755,823,43932,45,15,12,33,0
64658,53,30936,53,785,110,675,2,30,1,1,0
49937,445,0,0,70,70,0,1,0,1,0,2
56331,445,0,0,70,70,0,1,0,1,0,2
56079,53,1064,53,199,102,97,2,31,1,1,0
65180,53,26372,53,165,86,79,2,30,1,1,0
52041,48103,59658,48103,70,70,0,1,5,1,0,0
49418,27056,31810,27056,269,78,191,2,30,1,1,0
49609,80,50781,80,318,192,126,6,41,4,2,0
54559,445,0,0,66,66,0,1,0,1,0,2
58110,53,0,0,178,79,99,2,30,1,1,0
9743,23,0,0,60,60,0,1,0,1,0,1
22904,56205,0,0,62,62,0,1,0,1,0,1
50353,445,0,0,66,66,0,1,0,1,0,2
63751,445,0,0,70,70,0,1,0,1,0,2
53283,445,0,0,70,70,0,1,0,1,0,2
48071,25174,0,0,146,146,0,1,0,1,0,1
27005,27111,16900,27111,913,126,787,2,31,1,1,0
60479,25174,0,0,62,62,0,1,0,1,0,1
54991,443,1653,443,20604,3530,17074,40,19,21,19,0
57662,445,0,0,70,70,0,1,0,1,0,2
64032,12343,46737,12343,630,508,122,9,15,7,2,0
54031,53,23447,53,168,78,90,2,30,1,1,0
55330,53,4334,53,216,102,114,2,30,1,1,0
41269,443,34077,443,234,234,0,4,12,4,0,0
34076,53,22329,53,168,78,90,2,30,1,1,0
15605,50265,0,0,62,62,0,1,0,1,0,1
50252,53,45062,53,173,94,79,2,30,1,1,0
42319,443,8708,443,6664,1570,5094,23,18,13,10,0
50340,445,0,0,70,70,0,1,0,1,0,2
45452,443,54388,443,16362,3716,12646,79,601,38,41,0
57321,53,34343,53,762,98,664,2,30,1,1,0
42465,57470,0,0,60,60,0,1,0,1,0,1
51100,443,10929,443,9429,1978,7451,27,46,14,13,0
60377,443,48988,443,8588,2020,6568,20,76,10,10,0
6057,51221,0,0,78,78,0,1,0,1,0,1
10380,5223,0,0,148,148,0,1,0,1,0,1
65038,445,0,0,70,70,0,1,0,1,0,2
57829,443,7967,443,981499,39775,941724,1109,291,439,670,0
63230,445,0,0,66,66,0,1,0,1,0,2
49554,445,0,0,70,70,0,1,0,1,0,2
57030,53,42325,53,283,101,182,4,37,2,2,0
42298,40018,26921,40018,148,86,62,2,30,1,1,0
55573,445,0,0,66,66,0,1,0,1,0,2
64357,445,0,0,66,66,0,1,0,1,0,2
60179,445,0,0,66,66,0,1,0,1,0,2
52418,46314,0,0,66,66,0,1,0,1,0,1
53546,443,23696,443,7268,3166,4102,19,136,10,9,0
55243,53,43461,53,356,118,238,2,30,1,1,0
53647,80,49783,80,1962,1287,675,13,27,7,6,0
49275,7000,49275,7000,2163,676,1487,14,15,7,7,0
49205,443,49232,443,512444,20822,491622,555,159,191,364,0
53872,24710,13948,24710,70,70,0,1,5,1,0,0
49588,443,55419,443,5879,870,5009,18,53,9,9,0
50493,80,1565,80,318,192,126,6,25,4,2,0
35268,81,0,0,60,60,0,1,0,1,0,1
57298,443,20012,443,8313,2850,5463,42,15,24,18,0
38832,443,4622,443,23292,17154,6138,141,522,79,62,0
37183,443,43656,443,9631,4184,5447,33,271,17,16,0
54043,36237,0,0,66,66,0,1,0,1,0,1
15176,62413,0,0,62,62,0,1,0,1,0,1
58542,445,0,0,70,70,0,1,0,1,0,2
44498,53,11053,53,168,78,90,2,30,1,1,0
55305,53,21908,53,94,94,0,1,30,1,0,0
35408,56205,0,0,66,66,0,1,0,1,0,1
53930,443,55523,443,33489,2768,30721,44,121,17,27,0
0,0,0,0,600,306,294,6,0,3,3,0
44690,443,54599,443,1648,813,835,17,185,9,8,0
27005,27016,2145,27016,883,126,757,2,30,1,1,0
32955,80,30230,80,14961,937,14024,25,16,11,14,0
63917,57826,39527,57826,70,70,0,1,5,1,0,0
26961,443,26961,443,1251,722,529,11,147,6,5,0
21173,37965,0,0,62,62,0,1,0,1,0,1
64919,53,63713,53,822,102,720,2,29,1,1,0
45060,37965,0,0,62,62,0,1,0,1,0,1
56111,53,49193,53,179,94,85,2,31,1,1,0
52197,19845,30024,19845,70,70,0,2,7,2,0,0
58638,5900,0,0,62,62,0,1,0,1,0,1
65441,445,0,0,70,70,0,1,0,1,0,2
0,0,0,0,156,156,0,2,0,2,0,1
58638,5900,0,0,62,62,0,1,0,1,0,1
56847,443,59529,443,35160,6404,28756,82,196,31,51,0
50594,25174,0,0,66,66,0,1,0,1,0,1
53855,443,61273,443,134631,7253,127378,176,171,79,97,0
57332,443,64135,443,2687,1728,959,23,15,12,11,0
56973,53,12553,53,186,95,91,2,31,1,1,0
26881,25174,0,0,62,62,0,1,0,1,0,1
65492,53,43623,53,199,102,97,2,30,1,1,0
42598,443,46015,443,3134,1983,1151,15,15,8,7,0
55401,445,0,0,66,66,0,1,0,1,0,2
53021,445,0,0,70,70,0,1,0,1,0,2
34964,80,34964,80,2889,1482,1407,10,15,6,4,0
55888,445,0,0,70,70,0,1,0,1,0,2
36858,443,39662,443,3789,2373,1416,24,26,14,10,0
56775,53,64956,53,177,94,83,2,29,1,1,0
35670,443,58907,443,295458,11828,283630,339,185,137,202,0
27988,40012,43574,40012,253,190,63,2,30,1,1,0
64772,64147,0,0,66,66,0,1,0,1,0,1
56804,445,0,0,70,70,0,1,0,1,0,2
47785,443,12110,443,9224,2055,7169,37,41,19,18,0
36037,53,7009,53,198,93,105,2,30,1,1,0
64257,53,54453,53,168,86,82,2,31,1,1,0
57634,445,0,0,66,66,0,1,0,1,0,2
55957,53,35891,53,178,94,84,2,29,1,1,0
58196,53,55117,53,578,286,292,9,16,5,4,0
55903,53,48648,53,177,94,83,2,30,1,1,0
60505,443,23004,443,1061,727,334,9,26,4,5,0
46663,53,46663,53,209,83,126,2,30,1,1,0
58638,5900,0,0,62,62,0,1,0,1,0,1
65020,53,14135,53,184,94,90,2,31,1,1,0
55146,53,34694,53,181,94,87,2,30,1,1,0
6832,51505,0,0,66,66,0,1,0,1,0,1
57555,35440,0,0,66,66,0,1,0,1,0,1
53115,445,0,0,70,70,0,1,0,1,0,2
51330,445,0,0,70,70,0,1,0,1,0,2
64681,443,43290,443,2924,653,2271,13,135,6,7,0
47886,80,46758,80,1767,751,1016,10,15,6,4,0
56005,445,0,0,70,70,0,1,0,1,0,2
52080,9554,2824,9554,70,70,0,2,7,2,0,0
50717,9571,0,0,62,62,0,1,0,1,0,1
53030,56205,0,0,66,66,0,1,0,1,0,1
54540,445,0,0,66,66,0,1,0,1,0,2
55722,53,10365,53,229,110,119,2,30,1,1,0
58715,64097,0,0,62,62,0,1,0,1,0,1
30542,25174,0,0,62,62,0,1,0,1,0,1
64311,53,39516,53,199,102,97,2,30,1,1,0
50549,43890,0,0,66,66,0,1,0,1,0,1
55878,53,54979,53,760,97,663,2,31,1,1,0
26795,443,14434,443,21804,16558,5246,43,21,24,19,0
64560,53,36010,53,184,94,90,2,29,1,1,0
41520,53,0,0,82,82,0,1,30,1,0,0
58749,443,22893,443,6246,4267,1979,21,16,11,10,0
64268,53,55887,53,679,179,500,6,69,3,3,0
53758,445,0,0,70,70,0,1,0,1,0,2
51418,443,51418,443,4742,1835,2907,19,30,11,8,0
65270,3855,0,0,78,78,0,1,0,1,0,1
64633,53,4250,53,762,98,664,2,30,1,1,0
13179,57866,0,0,62,62,0,1,0,1,0,1
54682,445,0,0,70,70,0,1,0,1,0,2
50643,443,60929,443,1512,844,668,16,64,9,7,0
60796,53,56563,53,296,94,202,2,29,1,1,0
53140,51221,0,0,74,74,0,1,0,1,0,1
49901,53,35015,53,186,95,91,2,31,1,1,0
48533,443,47218,443,160,69,91,2,121,1,1,0
57401,53,41706,53,174,89,85,2,31,1,1,0
62145,445,0,0,70,70,0,1,0,1,0,2
56041,53,23370,53,183,94,89,2,30,1,1,0
54639,445,0,0,70,70,0,1,0,1,0,2
50658,445,0,0,70,70,0,1,0,1,0,2
59347,445,0,0,70,70,0,1,0,1,0,2
64674,53,13295,53,183,94,89,2,29,1,1,0
49234,53,38404,53,170,87,83,2,30,1,1,0
57000,53,37935,53,193,94,99,2,30,1,1,0
56306,1,0,0,146,146,0,1,0,1,0,1
11295,40033,39520,40033,213,89,124,4,49,2,2,0
53128,29593,52824,29593,70,70,0,1,4,1,0,0
38281,37807,0,0,62,62,0,1,0,1,0,1
26900,27017,43852,27017,422,164,258,6,29,3,3,0
53785,33324,8660,33324,70,70,0,1,4,1,0,0
58969,443,56637,443,2768,1593,1175,22,21,11,11,0
57284,53,51341,53,214,110,104,2,30,1,1,0
12645,22114,0,0,146,146,0,1,0,1,0,1
64668,53,32390,53,772,103,669,2,31,1,1,0
9687,35440,0,0,66,66,0,1,0,1,0,1
41170,443,30807,443,8837,1938,6899,21,17,12,9,0
63827,445,0,0,66,66,0,1,0,1,0,2
49773,53,17034,53,199,94,105,2,30,1,1,0
65121,53,39585,53,440,94,346,4,37,2,2,0
55117,443,14752,443,1350,689,661,14,18,8,6,0
62273,50584,0,0,62,62,0,1,0,1,0,1
58791,25174,0,0,62,62,0,1,0,1,0,1
57007,53,5847,53,183,94,89,2,30,1,1,0
49567,53,35834,53,168,86,82,2,30,1,1,0
50693,80,54649,80,4465,3390,1075,14,30,8,6,0
19875,30170,0,0,145,145,0,1,0,1,0,1
50857,26467,0,0,66,66,0,1,0,1,0,1
5790,43890,0,0,62,62,0,1,0,1,0,1
60941,25174,0,0,62,62,0,1,0,1,0,1
62917,993,58803,993,9056,4223,4833,82,35,42,40,0
54817,47993,0,0,66,66,0,1,0,1,0,1
52341,80,52341,80,1928,1339,589,12,48,6,6,0
49767,445,0,0,66,66,0,1,0,1,0,2
53689,445,0,0,70,70,0,1,0,1,0,2
51760,443,1508,443,1569,1044,525,14,94,9,5,0
10914,35974,0,0,60,60,0,1,0,1,0,1
14185,48637,0,0,60,60,0,1,0,1,0,1
56561,53,15305,53,216,110,106,2,30,1,1,0
50876,445,0,0,70,70,0,1,0,1,0,2
57196,53,50893,53,182,93,89,2,30,1,1,0
49741,53,17465,53,177,94,83,2,30,1,1,0
55068,53,54785,53,196,102,94,2,30,1,1,0
50470,61463,0,0,86,86,0,1,0,1,0,1
53236,443,39010,443,41247,1363,39884,51,37,13,38,0
53109,80,20052,80,8176,1443,6733,20,15,10,10,0
59711,445,0,0,70,70,0,1,0,1,0,2
60272,443,24375,443,1853,1214,639,18,87,11,7,0
48362,443,23544,443,8075,1766,6309,22,78,13,9,0
62776,62413,0,0,62,62,0,1,0,1,0,1
52614,44847,0,0,66,66,0,1,0,1,0,1
36227,23,0,0,60,60,0,1,0,1,0,1
58977,37965,0,0,66,66,0,1,0,1,0,1
60771,445,0,0,70,70,0,1,0,1,0,2
48165,53,17622,53,199,94,105,2,30,1,1,0
47910,7454,0,0,60,60,0,1,0,1,0,1
40226,443,40694,443,13853,4638,9215,42,387,21,21,0
57654,35440,0,0,66,66,0,1,0,1,0,1
49551,445,0,0,70,70,0,1,0,1,0,2
65244,53,58540,53,378,99,279,4,45,2,2,0
55556,53,62239,53,183,94,89,2,29,1,1,0
48913,443,1076,443,6922,1618,5304,23,35,12,11,0
61355,445,0,0,66,66,0,1,0,1,0,2
51096,63710,0,0,66,66,0,1,0,1,0,1
37672,5223,1351,5223,110,110,0,1,5,1,0,0
59735,443,59735,443,4730,1823,2907,19,28,11,8,0
12614,22,0,0,60,60,0,1,0,1,0,1
64890,51180,0,0,62,62,0,1,0,1,0,1
10965,22114,0,0,62,62,0,1,0,1,0,1
50646,445,0,0,70,70,0,1,0,1,0,2
52563,17235,0,0,70,70,0,1,0,1,0,1
63914,32805,13245,32805,70,70,0,1,4,1,0,0
64716,53,33097,53,385,134,251,2,30,1,1,0
53727,443,53687,443,499,425,74,4,0,3,1,0
56362,53,52775,53,453,186,267,6,30,3,3,0
55520,445,0,0,70,70,0,1,0,1,0,2
17561,52700,0,0,62,62,0,1,0,1,0,1
6999,11119,0,0,143,143,0,1,0,1,0,1
60025,445,0,0,70,70,0,1,0,1,0,2
62865,443,23097,443,21313,7245,14068,48,128,22,26,0
63057,445,0,0,66,66,0,1,0,1,0,2
55596,53,19558,53,177,94,83,2,30,1,1,0
9432,443,6777,443,6094,771,5323,17,26,9,8,0
9303,443,49206,443,3616,429,3187,11,16,6,5,0
33161,80,27979,80,604,530,74,7,15,6,1,0
63094,53,39482,53,384,166,218,2,30,1,1,0
6882,50239,19851,50239,296,150,146,2,1200,1,1,0
57293,25174,0,0,146,146,0,1,0,1,0,1
57470,22070,58715,22070,559,198,361,5,1200,4,1,0
65472,53,43093,53,209,110,99,2,30,1,1,0
64567,53,19362,53,199,102,97,2,30,1,1,0
49588,445,0,0,66,66,0,1,0,1,0,2
64339,18375,0,0,66,66,0,1,0,1,0,1
50396,62413,0,0,66,66,0,1,0,1,0,1
55704,53,24414,53,170,87,83,2,30,1,1,0
57470,60080,37928,60080,12668,8506,4162,117,3745,74,43,0
64805,53,48699,53,278,102,176,2,31,1,1,0
56766,41605,18996,41605,1639,460,1179,8,30,4,4,0
54391,445,0,0,70,70,0,1,0,1,0,2
57162,445,0,0,70,70,0,1,0,1,0,2
47561,26467,0,0,62,62,0,1,0,1,0,1
62728,445,0,0,66,66,0,1,0,1,0,2
65236,53,36812,53,215,102,113,2,30,1,1,0
56956,443,35896,443,4359,924,3435,15,59,9,6,0
50974,11392,0,0,66,66,0,1,0,1,0,1
38476,161,0,0,3304,1560,1744,18,30,9,9,0
47092,15000,12405,15000,138,78,60,2,5,1,1,0
59845,15503,0,0,66,66,0,1,0,1,0,1
49767,53,48677,53,200,102,98,2,30,1,1,0
50824,443,63186,443,337727,11283,326444,367,208,126,241,0
55687,53,12551,53,193,102,91,2,29,1,1,0
64475,53,56794,53,184,94,90,2,31,1,1,0
56186,57470,0,0,62,62,0,1,0,1,0,1
63409,445,0,0,70,70,0,1,0,1,0,2
59709,445,0,0,66,66,0,1,0,1,0,2
2075,19473,0,0,66,66,0,1,0,1,0,1
34365,443,34038,443,223826,45909,177917,356,44,176,180,0
35921,443,62122,443,9667,4709,4958,27,88,14,13,0
14185,48637,0,0,60,60,0,1,0,1,0,1
15005,32480,0,0,145,145,0,1,0,1,0,1
22636,30188,0,0,66,66,0,1,0,1,0,1
58250,35440,0,0,62,62,0,1,0,1,0,1
52109,445,0,0,70,70,0,1,0,1,0,2
42386,443,40078,443,10424,3393,7031,31,274,16,15,0
60731,445,0,0,66,66,0,1,0,1,0,2
49469,443,43348,443,8779,3672,5107,17,119,8,9,0
51123,443,33422,443,6625,1673,4952,20,20,10,10,0
49418,37579,44074,37579,239,71,168,2,30,1,1,0
64071,53,55557,53,194,102,92,2,31,1,1,0
49874,443,49241,443,15358,8278,7080,47,19,24,23,0
51353,46314,0,0,145,145,0,1,0,1,0,1
24144,57470,0,0,62,62,0,1,0,1,0,1
61362,443,33042,443,8167,2671,5496,22,69,11,11,0
45766,35440,0,0,62,62,0,1,0,1,0,1
63965,53,11899,53,180,94,86,2,30,1,1,0
58210,443,60868,443,14898,12644,2254,32,316,18,14,0
8890,443,57332,443,4367,1108,3259,37,426,11,26,0
55375,53,46240,53,711,87,624,2,31,1,1,0
30015,36237,0,0,66,66,0,1,0,1,0,1
56031,53,65070,53,177,94,83,2,30,1,1,0
34553,48637,0,0,60,60,0,1,0,1,0,1
49964,64147,0,0,66,66,0,1,0,1,0,1
53186,443,23298,443,10332,2735,7597,36,21,17,19,0
14084,43890,0,0,62,62,0,1,0,1,0,1
52059,47363,55015,47363,70,70,0,1,5,1,0,0
35164,443,44026,443,5505,995,4510,20,255,11,9,0
58638,5900,0,0,62,62,0,1,0,1,0,1
3410,17372,0,0,62,62,0,1,0,1,0,1
1027,44847,0,0,62,62,0,1,0,1,0,1
52215,16937,53036,16937,136,136,0,3,12,3,0,0
52716,443,35091,443,69951,4941,65010,95,351,45,50,0
59498,445,0,0,70,70,0,1,0,1,0,2
55004,443,35617,443,27629,9041,18588,88,271,46,42,0
52152,58114,40189,58114,70,70,0,2,8,2,0,0
63242,50584,0,0,66,66,0,1,0,1,0,1
53164,443,44686,443,38442,16213,22229,67,46,30,37,0
59884,443,34275,443,1401,864,537,12,28,6,6,0
57417,53,7685,53,199,102,97,2,30,1,1,0
46286,21247,0,0,62,62,0,1,0,1,0,1
80,54605,0,0,66,66,0,1,0,1,0,1
64890,445,0,0,70,70,0,1,0,1,0,2
59653,80,58858,80,1139,609,530,10,34,6,4,0
52894,443,46843,443,5424,1445,3979,29,117,14,15,0
59303,445,0,0,66,66,0,1,0,1,0,2
56603,53,32862,53,168,86,82,2,30,1,1,0
10381,22114,0,0,62,62,0,1,0,1,0,1
51689,443,47234,443,8488,2174,6314,23,255,12,11,0
64001,13051,4222,13051,70,70,0,1,4,1,0,0
52335,443,49316,443,5670,2739,2931,18,129,9,9,0
54305,35440,0,0,62,62,0,1,0,1,0,1
38610,443,57889,443,19092095,654744,18437351,24079,407,8531,15548,0
56609,3389,56609,3389,3327,1438,1889,15,16,8,7,0
42298,40001,24361,40001,140,78,62,2,31,1,1,0
58638,5900,0,0,62,62,0,1,0,1,0,1
55232,53,4973,53,177,94,83,2,30,1,1,0
49772,80,38817,80,70,70,0,1,5,1,0,0
56771,43648,21453,43648,70,70,0,1,5,1,0,0
14885,53,14885,53,220,100,120,2,30,1,1,0
54836,445,0,0,70,70,0,1,0,1,0,2
58645,445,0,0,70,70,0,1,0,1,0,2
48186,443,28155,443,1947,688,1259,18,82,8,10,0
58574,21247,0,0,66,66,0,1,0,1,0,1
49418,27017,11133,27017,247,78,169,2,30,1,1,0
55325,53,53505,53,199,102,97,2,30,1,1,0
55244,53,24318,53,184,102,82,2,30,1,1,0
56721,443,14378,443,7889,1900,5989,20,15,11,9,0
64546,57470,0,0,66,66,0,1,0,1,0,1
62109,44847,0,0,62,62,0,1,0,1,0,1
43700,30188,0,0,62,62,0,1,0,1,0,1
49727,445,0,0,70,70,0,1,0,1,0,2
56328,53,20002,53,214,102,112,2,31,1,1,0
9605,57470,0,0,62,62,0,1,0,1,0,1
52240,52893,59916,52893,70,70,0,2,6,2,0,0
49762,53,16917,53,184,94,90,2,30,1,1,0
55443,445,0,0,70,70,0,1,0,1,0,2
51102,443,49198,443,3402,1258,2144,13,135,6,7,0
58881,445,0,0,70,70,0,1,0,1,0,2
1030,64147,0,0,62,62,0,1,0,1,0,1
56817,445,0,0,66,66,0,1,0,1,0,2
49788,443,22621,443,74171,1888,72283,72,126,18,54,0
51539,443,4046,443,6359,1559,4800,24,19,13,11,0
53750,443,4212,443,499,425,74,4,0,3,1,0
61846,445,0,0,66,66,0,1,0,1,0,2
57166,53,13391,53,177,94,83,2,30,1,1,0
49965,53,5956,53,257,110,147,2,30,1,1,0
6881,6881,0,0,62,62,0,1,0,1,0,1
49446,443,57880,443,1280822,27768,1253054,1241,40,365,876,0
56622,53,54285,53,214,110,104,2,30,1,1,0
38608,443,19892,443,17473899,604274,16869625,22165,408,7731,14434,0
52321,26467,0,0,62,62,0,1,0,1,0,1
63255,445,0,0,66,66,0,1,0,1,0,2
60609,445,0,0,70,70,0,1,0,1,0,2
35350,443,47252,443,13168,2505,10663,21,121,9,12,0
57252,53,46137,53,182,93,89,2,31,1,1,0
56527,53,0,0,206,83,123,2,31,1,1,0
13020,26467,0,0,62,62,0,1,0,1,0,1
55015,443,8354,443,1786,172,1614,7,120,3,4,0
3478,61463,0,0,1290,1290,0,1,0,1,0,1
723,3389,0,0,74,74,0,1,0,1,0,1
65340,53,38317,53,313,110,203,4,33,2,2,0
43568,80,8531,80,2277,1521,756,16,16,10,6,0
56666,443,31326,443,1299,730,569,13,25,7,6,0
58247,57866,0,0,66,66,0,1,0,1,0,1
37613,443,61713,443,10042,3117,6925,28,47,16,12,0
10167,80,10167,80,450,246,204,8,25,5,3,0
54031,443,8430,443,350,210,140,6,25,4,2,0
64721,443,45723,443,5552,927,4625,16,15,10,6,0
50550,445,0,0,70,70,0,1,0,1,0,2
50350,445,0,0,66,66,0,1,0,1,0,2
56415,53,58262,53,174,89,85,2,31,1,1,0
54144,445,0,0,70,70,0,1,0,1,0,2
59683,443,22150,443,13310,4422,8888,47,136,27,20,0
51685,57470,0,0,66,66,0,1,0,1,0,1
10775,35440,0,0,62,62,0,1,0,1,0,1
53704,15000,63052,15000,70,70,0,1,4,1,0,0
27471,53,27471,53,237,91,146,2,32,1,1,0
59759,445,0,0,70,70,0,1,0,1,0,2
48335,25174,0,0,62,62,0,1,0,1,0,1
54770,445,0,0,70,70,0,1,0,1,0,2
58673,443,8091,443,3330,737,2593,10,121,5,5,0
58478,53,13215,53,332,102,230,2,29,1,1,0
65473,443,51323,443,91831,4379,87452,101,15,37,64,0
45855,25174,0,0,62,62,0,1,0,1,0,1
33684,443,39270,443,6829,1261,5568,21,197,11,10,0
31619,51221,0,0,62,62,0,1,0,1,0,1
63980,4804,28040,4804,66,66,0,2,8,2,0,0
5240,36828,56682,36828,166456,128,166328,270,35,3,267,0
58902,445,0,0,70,70,0,1,0,1,0,2
64413,445,0,0,70,70,0,1,0,1,0,2
36943,443,59404,443,15329,7087,8242,108,310,61,47,0
52094,22114,0,0,146,146,0,1,0,1,0,1
54010,445,0,0,66,66,0,1,0,1,0,2
50868,80,40174,80,12388,742,11646,18,130,7,11,0
64814,53,26949,53,165,86,79,2,31,1,1,0
65520,56330,49409,56330,558,318,240,9,143,5,4,0
63916,56318,63492,56318,70,70,0,1,4,1,0,0
61460,445,0,0,70,70,0,1,0,1,0,2
49658,53,43401,53,211,102,109,2,30,1,1,0
57419,443,3080,443,9224,2381,6843,29,19,14,15,0
42574,443,64198,443,130,70,60,3,5,2,1,0
47111,80,20951,80,162355,7124,155231,207,27,96,111,0
50584,40420,46560,40420,868,150,718,4,1200,2,2,0
44907,5900,44907,5900,130,66,64,2,4,1,1,0
56634,80,24022,80,234,234,0,4,12,4,0,0
53735,58869,2598,58869,70,70,0,2,7,2,0,0
59790,443,41784,443,238429,14932,223497,314,48,159,155,0
63952,53,14655,53,211,110,101,2,30,1,1,0
63136,25174,0,0,62,62,0,1,0,1,0,1
42881,443,29777,443,134,60,74,3,4,2,1,0
48817,47005,48817,47005,158,158,0,1,1200,1,0,0
27005,27015,51372,27015,884,126,758,2,30,1,1,0
51961,40373,22472,40373,70,70,0,1,5,1,0,0
65063,445,0,0,66,66,0,1,0,1,0,2
53373,53,58629,53,242,78,164,2,29,1,1,0
63943,53,16297,53,258,90,168,4,56,2,2,0
63320,445,0,0,66,66,0,1,0,1,0,2
41107,53,24186,53,168,78,90,2,30,1,1,0
49228,443,49228,443,32952,11546,21406,60,71,36,24,0
37011,25174,0,0,62,62,0,1,0,1,0,1
21544,41599,31043,41599,70,70,0,1,5,1,0,0
48676,53395,0,0,60,60,0,1,0,1,0,1
49976,53,44388,53,245,110,135,2,30,1,1,0
49207,58751,38431,58751,70,70,0,1,5,1,0,0
2359,443,2359,443,8209,1695,6514,21,23,13,8,0
55649,5228,61882,5228,5378,2359,3019,35,3786,16,19,0
60714,50584,0,0,66,66,0,1,0,1,0,1
51569,445,0,0,70,70,0,1,0,1,0,2
51413,10387,0,0,139,139,0,1,0,1,0,1
57207,53,1251,53,195,102,93,2,30,1,1,0
64429,445,0,0,70,70,0,1,0,1,0,2
25620,50432,0,0,146,146,0,1,0,1,0,1
1026,64147,0,0,62,62,0,1,0,1,0,1
27691,53,27691,53,235,90,145,2,32,1,1,0
56360,443,15487,443,3734,1750,1984,24,203,12,12,0
59902,443,47216,443,6196,746,5450,17,28,8,9,0
53973,445,0,0,70,70,0,1,0,1,0,2
55072,53,7801,53,177,94,83,2,30,1,1,0
37048,53,15129,53,168,78,90,2,29,1,1,0
1024,57470,0,0,72,72,0,1,0,1,0,1
63975,53,64486,53,316,94,222,2,30,1,1,0
56495,53,46439,53,199,102,97,2,30,1,1,0
56725,53,48111,53,180,94,86,2,31,1,1,0
19037,53,19037,53,227,89,138,2,31,1,1,0
65507,53,53628,53,199,102,97,2,30,1,1,0
48617,443,54481,443,10802,2841,7961,29,21,14,15,0
53438,443,53438,443,2511,1465,1046,21,102,10,11,0
53764,6881,51389,6881,1463,821,642,15,15,8,7,0
58927,443,34485,443,5168,700,4468,16,15,7,9,0
47632,25174,0,0,62,62,0,1,0,1,0,1
65209,57866,0,0,66,66,0,1,0,1,0,1
56560,53,15895,53,164,86,78,2,29,1,1,0
59195,445,0,0,66,66,0,1,0,1,0,2
49607,25174,0,0,62,62,0,1,0,1,0,1
56297,53,12569,53,168,86,82,2,30,1,1,0
36823,80,35585,80,3335,2735,600,12,30,7,5,0
55840,53,28820,53,177,94,83,2,30,1,1,0
53525,34759,11727,34759,70,70,0,1,5,1,0,0
65222,53,38822,53,197,94,103,2,29,1,1,0
56719,53,59269,53,185,102,83,2,30,1,1,0
64818,445,0,0,70,70,0,1,0,1,0,2
52696,21247,0,0,66,66,0,1,0,1,0,1
50917,80,57551,80,11626518,135099,11491419,9627,134,1907,7720,0
55732,53,56337,53,280,126,154,2,30,1,1,0
55874,445,0,0,70,70,0,1,0,1,0,2
15793,64147,0,0,66,66,0,1,0,1,0,1
33000,53,0,0,82,82,0,1,31,1,0,0
53933,20801,58007,20801,70,70,0,2,7,2,0,0
63419,53,63419,53,216,90,126,2,30,1,1,0
65006,53,44331,53,763,102,661,2,30,1,1,0
64788,43890,0,0,62,62,0,1,0,1,0,1
30188,53,30188,53,238,95,143,2,30,1,1,0
52396,443,30033,443,1253628,61672,1191956,1875,220,939,936,0
62637,42873,0,0,66,66,0,1,0,1,0,1
47046,80,21371,80,1114,534,580,12,15,7,5,0
53241,443,45177,443,1950,1176,774,18,103,11,7,0
49845,80,64041,80,31466,852,30614,32,89,9,23,0
51573,53,28199,53,212,86,126,2,30,1,1,0
65051,445,0,0,70,70,0,1,0,1,0,2
58421,30188,0,0,66,66,0,1,0,1,0,1
49324,64147,0,0,66,66,0,1,0,1,0,1
64292,53,46657,53,199,94,105,2,30,1,1,0
60373,443,19425,443,3875761,85491,3790270,3838,89,1315,2523,0
64064,53,52675,53,257,94,163,2,30,1,1,0
49399,53,15486,53,775,102,673,2,30,1,1,0
53827,5889,21032,5889,70,70,0,2,7,2,0,0
64381,53,26257,53,198,102,96,2,30,1,1,0
59940,50584,0,0,66,66,0,1,0,1,0,1
65411,53,34611,53,354,102,252,2,30,1,1,0
39474,443,60202,443,9766,2050,7716,23,15,12,11,0
49505,445,0,0,70,70,0,1,0,1,0,2
50605,443,56643,443,1766,975,791,15,71,9,6,0
28668,8696,0,0,60,60,0,1,0,1,0,1
42128,80,52556,80,1139,506,633,10,15,6,4,0
63865,48610,9039,48610,66,66,0,1,5,1,0,0
60501,40829,11084,40829,70,70,0,2,8,2,0,0
24376,50584,0,0,66,66,0,1,0,1,0,1
54521,445,0,0,66,66,0,1,0,1,0,2
42231,57470,0,0,78,78,0,1,0,1,0,1
59068,49813,0,0,74,74,0,1,0,1,0,1
32927,443,31722,443,867883,29498,838385,922,58,328,594,0
49926,53,15614,53,180,94,86,2,30,1,1,0
58638,5900,58638,5900,130,66,64,2,4,1,1,0
57246,8525,57246,8525,138,78,60,2,5,1,1,0
8536,37965,0,0,62,62,0,1,0,1,0,1
47266,25174,0,0,146,146,0,1,0,1,0,1
63513,53,63513,53,236,94,142,2,30,1,1,0
50027,21247,0,0,66,66,0,1,0,1,0,1
57305,53,33562,53,177,94,83,2,30,1,1,0
54048,25174,0,0,66,66,0,1,0,1,0,1
65200,53,5141,53,214,110,104,2,30,1,1,0
64012,40642,36772,40642,66,66,0,2,8,2,0,0
61908,7000,61908,7000,4131,1750,2381,17,15,9,8,0
38275,443,49031,443,448,78,370,6,25,1,5,0
55918,445,0,0,70,70,0,1,0,1,0,2
15933,64147,0,0,62,62,0,1,0,1,0,1
64729,445,0,0,70,70,0,1,0,1,0,2
41619,443,17467,443,188529,10173,178356,248,256,93,155,0
57496,445,0,0,70,70,0,1,0,1,0,2
45964,2666,0,0,60,60,0,1,0,1,0,1
54136,443,41489,443,10109,1394,8715,22,75,13,9,0
64164,53,32232,53,229,102,127,2,30,1,1,0
53471,161,0,0,5907,2302,3605,22,30,11,11,0
55877,56148,26245,56148,481,150,331,2,1200,1,1,0
63979,49547,9568,49547,312,132,180,6,6,3,3,0
38637,443,8499,443,12339,2392,9947,36,287,15,21,0
55340,53,63068,53,184,94,90,2,31,1,1,0
50473,80,6625,80,1658,1247,411,8,15,5,3,0
63210,445,0,0,70,70,0,1,0,1,0,2
64287,53,53632,53,181,94,87,2,30,1,1,0
61057,25174,0,0,62,62,0,1,0,1,0,1
36674,443,40100,443,11882,3450,8432,39,120,19,20,0
19875,30170,0,0,145,145,0,1,0,1,0,1
56911,53,36658,53,177,94,83,2,31,1,1,0
53111,445,0,0,66,66,0,1,0,1,0,2
45783,22114,0,0,62,62,0,1,0,1,0,1
36586,80,45063,80,1114,534,580,12,15,7,5,0
60959,445,0,0,70,70,0,1,0,1,0,2
56309,22114,0,0,146,146,0,1,0,1,0,1
64572,37965,0,0,66,66,0,1,0,1,0,1
52741,24211,0,0,66,66,0,1,0,1,0,1
55250,443,44147,443,1271,918,353,9,15,6,3,0
30598,37965,0,0,62,62,0,1,0,1,0,1
50584,45270,4666,45270,1377,300,1077,6,1200,3,3,0
56866,53,6471,53,194,102,92,2,30,1,1,0
56847,53,25632,53,225,86,139,2,30,1,1,0
33044,443,11890,443,9695,5259,4436,24,35,12,12,0
62026,445,0,0,66,66,0,1,0,1,0,2
55593,53,39878,53,288,288,0,4,47,4,0,0
36500,3142,36500,3142,138,78,60,2,6,1,1,0
61230,53,16263,53,177,94,83,2,29,1,1,0
60328,445,0,0,70,70,0,1,0,1,0,2
37565,443,55641,443,4898,1119,3779,17,30,9,8,0
60516,445,0,0,70,70,0,1,0,1,0,2
32679,37965,0,0,62,62,0,1,0,1,0,1
57157,53,8214,53,165,86,79,2,30,1,1,0
57093,80,11310,80,130,70,60,2,15,1,1,0
49358,443,12762,443,137147,82203,54944,174,105,103,71,0
10126,57470,0,0,62,62,0,1,0,1,0,1
40464,80,50769,80,15535,2173,13362,30,21,17,13,0
62422,443,30175,443,16258,11067,5191,37,45,21,16,0
49852,53,8412,53,94,94,0,1,29,1,0,0
11136,57587,0,0,145,145,0,1,0,1,0,1
48350,57470,0,0,74,74,0,1,0,1,0,1
32215,22114,0,0,62,62,0,1,0,1,0,1
60241,445,0,0,70,70,0,1,0,1,0,2
62194,50584,0,0,66,66,0,1,0,1,0,1
53184,443,16399,443,13515,3057,10458,40,21,20,20,0
51921,37744,34923,37744,70,70,0,1,5,1,0,0
38644,443,44476,443,8165,1664,6501,30,62,14,16,0
55833,445,0,0,70,70,0,1,0,1,0,2
42587,53,63043,53,199,94,105,2,30,1,1,0
57871,443,42705,443,7716,3991,3725,50,125,25,25,0
55608,17425,43686,17425,320,140,180,6,7,3,3,0
49752,50584,0,0,62,62,0,1,0,1,0,1
27005,33086,33799,33086,877,126,751,2,30,1,1,0
65516,53,41111,53,290,94,196,4,40,2,2,0
53065,445,0,0,66,66,0,1,0,1,0,2
61665,443,16320,443,6279,1859,4420,25,16,14,11,0
65176,53,39241,53,193,102,91,2,30,1,1,0
62431,445,0,0,66,66,0,1,0,1,0,2
55706,443,29687,443,5259,1203,4056,19,41,10,9,0
51458,445,0,0,70,70,0,1,0,1,0,2
62051,11392,0,0,66,66,0,1,0,1,0,1
53476,5900,0,0,60,60,0,1,0,1,0,1
56757,53,3651,53,783,96,687,2,31,1,1,0
57113,53,7922,53,215,102,113,2,30,1,1,0
5222,48709,0,0,66,66,0,1,0,1,0,1
52057,80,6987,80,422,240,182,8,25,5,3,0
55477,53,62006,53,183,94,89,2,30,1,1,0
50460,443,50460,443,1159,668,491,11,31,6,5,0
4323,64147,0,0,66,66,0,1,0,1,0,1
26940,53,26940,53,197,90,107,2,30,1,1,0
31404,12082,0,0,100,100,0,1,0,1,0,1
64934,53,51307,53,197,102,95,2,33,1,1,0
64913,53,27503,53,183,94,89,2,30,1,1,0
56794,445,0,0,70,70,0,1,0,1,0,2
49248,445,0,0,66,66,0,1,0,1,0,2
64956,53,29274,53,196,102,94,2,30,1,1,0
50316,37965,0,0,66,66,0,1,0,1,0,1
57241,445,0,0,70,70,0,1,0,1,0,2
47832,80,56253,80,1151,711,440,10,15,5,5,0
52020,28704,61808,28704,70,70,0,1,5,1,0,0
49293,53,34843,53,382,95,287,4,48,2,2,0
65460,53,1825,53,177,94,83,2,30,1,1,0
50780,445,0,0,70,70,0,1,0,1,0,2
58114,11119,0,0,148,148,0,1,0,1,0,1
56740,443,11618,443,456259,379546,76713,1179,364,656,523,0
56355,443,33571,443,3734,1750,1984,24,203,12,12,0
55288,445,0,0,66,66,0,1,0,1,0,2
63732,40642,31051,40642,66,66,0,2,7,2,0,0
49534,53,40703,53,193,102,91,2,29,1,1,0
47905,443,5382,443,172,172,0,2,5,2,0,0
62549,64147,0,0,62,62,0,1,0,1,0,1
1384,44847,0,0,66,66,0,1,0,1,0,1
18091,23,0,0,60,60,0,1,0,1,0,1
63043,445,0,0,70,70,0,1,0,1,0,2
64811,53,2888,53,186,95,91,2,30,1,1,0
59896,445,0,0,70,70,0,1,0,1,0,2
64943,53,17729,53,341,110,231,2,29,1,1,0
54981,445,0,0,70,70,0,1,0,1,0,2
63239,445,0,0,70,70,0,1,0,1,0,2
59139,445,0,0,70,70,0,1,0,1,0,2
64787,53,4166,53,174,89,85,2,31,1,1,0
51813,63933,44889,63933,66,66,0,1,5,1,0,0
58808,443,58470,443,5167,700,4467,16,15,7,9,0
55949,443,10704,443,21852,2269,19583,48,95,23,25,0
49976,53,5693,53,393,110,283,2,30,1,1,0
38363,5900,0,0,60,60,0,1,0,1,0,1
44569,3389,0,0,60,60,0,1,0,1,0,1
57188,53,28885,53,193,102,91,2,29,1,1,0
60094,445,0,0,70,70,0,1,0,1,0,2
7210,22114,0,0,66,66,0,1,0,1,0,1
62348,57470,0,0,109,109,0,1,0,1,0,1
64068,53,56393,53,168,86,82,2,31,1,1,0
58288,443,25819,443,6438,2646,3792,18,37,11,7,0
49954,80,59970,80,10841,821,10020,19,15,9,10,0
53789,47191,44143,47191,70,70,0,2,8,2,0,0
51033,443,39133,443,14697,3801,10896,52,120,24,28,0
37837,37965,0,0,62,62,0,1,0,1,0,1
58725,7302,0,0,66,66,0,1,0,1,0,1
39098,51505,0,0,62,62,0,1,0,1,0,1
52029,52093,64487,52093,70,70,0,1,5,1,0,0
55942,445,0,0,70,70,0,1,0,1,0,2
49611,53,60181,53,170,87,83,2,31,1,1,0
59692,57470,0,0,78,78,0,1,0,1,0,1
64169,53,31527,53,209,110,99,2,30,1,1,0
49459,443,42939,443,2572,330,2242,12,135,5,7,0
49911,80,3385,80,1519,787,732,10,110,6,4,0
51613,443,47721,443,5052,2873,2179,26,15,14,12,0
61406,445,0,0,70,70,0,1,0,1,0,2
53753,443,14141,443,6973,2166,4807,20,15,11,9,0
52454,80,19961,80,2425,529,1896,11,75,6,5,0
44885,443,54078,443,1849,1130,719,17,38,9,8,0
50744,443,51827,443,6811,1923,4888,21,15,11,10,0
60756,40010,4489,40010,316,136,180,6,6,3,3,0
49867,445,0,0,70,70,0,1,0,1,0,2
55284,443,12539,443,2895,726,2169,10,121,5,5,0
37663,80,36231,80,974,481,493,8,15,5,3,0
55377,53,41334,53,195,102,93,2,30,1,1,0
65453,53,50552,53,242,94,148,2,30,1,1,0
0,0,0,0,124,64,60,2,0,1,1,0
57736,443,25293,443,3345,823,2522,12,120,6,6,0
34166,22114,0,0,62,62,0,1,0,1,0,1
64483,445,0,0,70,70,0,1,0,1,0,2
55680,53,53324,53,198,94,104,2,30,1,1,0
49908,445,0,0,66,66,0,1,0,1,0,2
58638,5900,0,0,62,62,0,1,0,1,0,1
53918,443,16862,443,499,425,74,4,0,3,1,0
56803,53,52529,53,183,94,89,2,30,1,1,0
26900,27017,31467,27017,422,164,258,6,30,3,3,0
50436,443,10408,443,18959,3307,15652,33,19,16,17,0
56641,443,17125,443,7942,1953,5989,20,15,11,9,0
65501,26467,0,0,62,62,0,1,0,1,0,1
2598,23718,0,0,66,66,0,1,0,1,0,1
26458,44847,0,0,146,146,0,1,0,1,0,1
3103,50584,0,0,62,62,0,1,0,1,0,1
64336,443,26343,443,10099,4296,5803,30,124,13,17,0
49261,53,20112,53,453,186,267,6,30,3,3,0
49904,445,0,0,70,70,0,1,0,1,0,2
49751,80,48363,80,1876,998,878,12,15,7,5,0
60022,10387,0,0,159,159,0,1,0,1,0,1
59644,445,0,0,66,66,0,1,0,1,0,2
25222,37965,0,0,62,62,0,1,0,1,0,1
57921,445,0,0,70,70,0,1,0,1,0,2
59477,443,16193,443,7825,4076,3749,19,121,10,9,0
49548,53,2066,53,263,102,161,2,29,1,1,0
53269,443,51596,443,5766,1925,3841,22,17,14,8,0
54280,3398,0,0,60,60,0,1,0,1,0,1
63729,6969,55353,6969,66,66,0,2,8,2,0,0
49730,443,62541,443,400810,14719,386091,506,39,164,342,0
62408,50584,0,0,62,62,0,1,0,1,0,1
21975,3389,21975,3389,3910,1805,2105,20,19,12,8,0
42891,53,42891,53,224,88,136,2,30,1,1,0
58638,5900,0,0,62,62,0,1,0,1,0,1
53512,23280,49318,23280,1950,957,993,17,17,10,7,0
10312,23117,0,0,62,62,0,1,0,1,0,1
54889,445,0,0,66,66,0,1,0,1,0,2
49296,443,32357,443,50454,5259,45195,52,105,17,35,0
61782,445,0,0,66,66,0,1,0,1,0,2
56639,53,13077,53,168,86,82,2,31,1,1,0
57266,445,0,0,70,70,0,1,0,1,0,2
55140,445,0,0,70,70,0,1,0,1,0,2
51918,445,0,0,66,66,0,1,0,1,0,2
60290,80,20522,80,1366,785,581,11,145,6,5,0
53035,80,53035,80,373926,8227,365699,379,143,130,249,0
1024,6881,0,0,146,146,0,1,0,1,0,1
57275,53,57643,53,199,102,97,2,30,1,1,0
55317,53,59583,53,244,94,150,2,31,1,1,0
44925,443,50958,443,153,93,60,2,5,1,1,0
64244,53,64721,53,199,102,97,2,29,1,1,0
63928,53,2140,53,376,126,250,2,30,1,1,0
53044,36237,0,0,66,66,0,1,0,1,0,1
10019,443,53412,443,1497912,26236,1471676,1321,121,299,1022,0
49727,443,58320,443,4116,972,3144,15,50,8,7,0
52103,53733,0,0,62,62,0,1,0,1,0,1
58054,80,39200,80,3561,3028,533,14,31,8,6,0
52920,445,0,0,66,66,0,1,0,1,0,2
52966,80,53251,80,2974,1352,1622,28,113,15,13,0
57352,53,35059,53,816,102,714,2,30,1,1,0
53377,443,17654,443,4814,1207,3607,17,75,10,7,0
54447,443,59840,443,9818,2008,7810,23,317,12,11,0
58921,443,47044,443,10782,7193,3589,30,16,17,13,0
51958,51322,52514,51322,70,70,0,2,7,2,0,0
18767,35440,0,0,146,146,0,1,0,1,0,1
1262,23,0,0,60,60,0,1,0,1,0,1
54475,445,0,0,66,66,0,1,0,1,0,2
59297,445,0,0,70,70,0,1,0,1,0,2
56702,445,0,0,70,70,0,1,0,1,0,2
59859,443,59054,443,27510,4470,23040,67,122,34,33,0
46987,443,53868,443,8688,3211,5477,24,343,11,13,0
30960,45751,20805,45751,66,66,0,1,3600,1,0,0
53552,8999,43016,8999,70,70,0,1,4,1,0,0
56616,445,0,0,66,66,0,1,0,1,0,2
57562,445,0,0,70,70,0,1,0,1,0,2
27739,7000,27739,7000,2163,676,1487,14,15,7,7,0
43674,80,54012,80,3714,1646,2068,18,186,9,9,0
56594,53,29488,53,167,86,81,2,30,1,1,0
49935,53,2977,53,370,94,276,2,30,1,1,0
56352,53,18136,53,177,94,83,2,30,1,1,0
65264,53,54273,53,88,88,0,1,30,1,0,0
61767,25174,0,0,62,62,0,1,0,1,0,1
64821,445,0,0,70,70,0,1,0,1,0,2
57239,161,0,0,85,85,0,1,0,1,0,1
46719,443,39379,443,7261,3272,3989,22,45,13,9,0
46090,50584,0,0,66,66,0,1,0,1,0,1
65322,53,59723,53,235,94,141,2,30,1,1,0
65384,443,21164,443,8613,1465,7148,22,15,13,9,0
62799,25174,0,0,62,62,0,1,0,1,0,1
26900,27017,14698,27017,422,164,258,6,29,3,3,0
56683,445,0,0,70,70,0,1,0,1,0,2
55480,53,36431,53,378,97,281,4,33,2,2,0
16857,53,16857,53,832,106,726,2,30,1,1,0
56925,80,48459,80,214,140,74,4,25,3,1,0
61822,53,61822,53,237,91,146,2,33,1,1,0
52225,31985,35881,31985,66,66,0,1,5,1,0,0
39677,443,47798,443,7123,1331,5792,22,81,11,11,0
443,63113,0,0,100,100,0,1,0,1,0,1
19933,35440,0,0,62,62,0,1,0,1,0,1
50635,445,0,0,70,70,0,1,0,1,0,2
35940,47808,0,0,60,60,0,1,0,1,0,1
59342,445,0,0,70,70,0,1,0,1,0,2
68,67,0,0,346,346,0,1,0,1,0,1
64810,53,57933,53,199,102,97,2,30,1,1,0
60668,445,0,0,70,70,0,1,0,1,0,2
60399,80,36861,80,1168,815,353,10,122,6,4,0
53607,51631,46867,51631,70,70,0,1,4,1,0,0
17781,50265,0,0,62,62,0,1,0,1,0,1
56597,443,58985,443,8700,2196,6504,21,16,12,9,0
56604,17372,0,0,66,66,0,1,0,1,0,1
49690,53,62022,53,322,110,212,4,30,2,2,0
55222,53,4063,53,181,94,87,2,30,1,1,0
56876,11392,0,0,66,66,0,1,0,1,0,1
48575,123,43562,123,184,94,90,2,30,1,1,0
54666,443,61385,443,3648,1080,2568,18,135,8,10,0
56654,443,1981,443,8007,1987,6020,20,15,11,9,0
57151,445,0,0,66,66,0,1,0,1,0,2
54251,445,0,0,70,70,0,1,0,1,0,2
16387,63752,0,0,60,60,0,1,0,1,0,1
64357,53,56985,53,183,94,89,2,30,1,1,0
35051,53,35051,53,194,87,107,2,31,1,1,0
50644,80,26132,80,314,192,122,6,25,4,2,0
51870,40490,10666,40490,70,70,0,2,8,2,0,0
65446,53,2812,53,184,102,82,2,30,1,1,0
41813,443,58792,443,33072,3479,29593,71,98,38,33,0
55300,53,49492,53,308,94,214,2,30,1,1,0
64540,53,29410,53,94,94,0,1,30,1,0,0
52010,80,6411,80,1327,822,505,11,21,7,4,0
50418,443,31085,443,4507,744,3763,17,29,7,10,0
65040,53,10817,53,180,94,86,2,31,1,1,0
58040,445,0,0,70,70,0,1,0,1,0,2
52582,445,0,0,66,66,0,1,0,1,0,2
44158,443,51060,443,232,172,60,3,5,2,1,0
27005,27202,9481,27202,872,126,746,2,29,1,1,0
56519,445,0,0,70,70,0,1,0,1,0,2
65143,53,8081,53,199,102,97,2,30,1,1,0
45214,443,34615,443,6641,4617,2024,34,80,18,16,0
63672,53,63672,53,198,90,108,2,30,1,1,0
63165,445,0,0,70,70,0,1,0,1,0,2
56878,53,29099,53,94,94,0,1,30,1,0,0
55022,443,12848,443,14634,1801,12833,28,46,14,14,0
52394,445,0,0,70,70,0,1,0,1,0,2
55842,64147,0,0,66,66,0,1,0,1,0,1
49236,53,51973,53,377,94,283,2,30,1,1,0
60055,445,0,0,70,70,0,1,0,1,0,2
51315,445,0,0,70,70,0,1,0,1,0,2
53525,34759,57554,34759,70,70,0,2,8,2,0,0
17226,35440,0,0,62,62,0,1,0,1,0,1
57020,445,0,0,66,66,0,1,0,1,0,2
57802,443,19538,443,37181,32491,4690,93,81,54,39,0
57408,53,37720,53,195,102,93,2,30,1,1,0
39611,443,2531,443,78,78,0,1,5,1,0,0
58991,443,64156,443,972647,20727,951920,916,263,245,671,0
51769,80,52683,80,74039,4367,69672,91,19,40,51,0
63932,63241,5696,63241,436,254,182,7,15,4,3,0
34484,53,27104,53,86,86,0,1,30,1,0,0
57924,445,0,0,66,66,0,1,0,1,0,2
57410,37965,0,0,66,66,0,1,0,1,0,1
57249,445,0,0,70,70,0,1,0,1,0,2
49246,53,51289,53,164,86,78,2,31,1,1,0
39715,35440,0,0,146,146,0,1,0,1,0,1
54202,445,0,0,66,66,0,1,0,1,0,2
53328,443,21893,443,4670,2814,1856,33,81,15,18,0
53275,21247,0,0,66,66,0,1,0,1,0,1
48015,443,45822,443,19394,2961,16433,51,196,24,27,0
40030,443,25382,443,2651,1331,1320,18,17,10,8,0
45822,443,11470,443,4201,2089,2112,11,120,6,5,0
57268,53,42841,53,205,94,111,2,30,1,1,0
55803,53,42450,53,261,89,172,4,38,2,2,0
44258,25,0,0,74,74,0,1,0,1,0,1
55176,53,57165,53,195,102,93,2,30,1,1,0
53466,443,35377,443,7866,2625,5241,25,120,11,14,0
58638,5900,0,0,62,62,0,1,0,1,0,1
60412,12965,23315,12965,70,70,0,2,8,2,0,0
52378,445,0,0,70,70,0,1,0,1,0,2
63652,445,0,0,70,70,0,1,0,1,0,2
64493,53,45305,53,198,101,97,2,30,1,1,0
18415,37965,0,0,62,62,0,1,0,1,0,1
49045,80,27391,80,1105,624,481,13,316,7,6,0
60414,52559,64596,52559,70,70,0,2,8,2,0,0
58984,443,13660,443,4874459,114404,4760055,4469,188,1112,3357,0
63932,53,16188,53,179,94,85,2,31,1,1,0
55907,445,0,0,70,70,0,1,0,1,0,2
53163,443,16194,443,7432,1694,5738,23,27,12,11,0
57194,445,0,0,70,70,0,1,0,1,0,2
49936,53,28353,53,211,102,109,2,31,1,1,0
17428,3389,17428,3389,4695,2520,2175,22,19,13,9,0
49820,53,29495,53,193,102,91,2,31,1,1,0
8889,47679,0,0,60,60,0,1,0,1,0,1
55668,445,0,0,70,70,0,1,0,1,0,2
57095,53,10011,53,177,94,83,2,30,1,1,0
34298,53,58428,53,199,94,105,2,30,1,1,0
42955,80,63046,80,72023,4897,67126,97,115,46,51,0
56738,443,56738,443,48740,2961,45779,73,46,33,40,0
51997,14398,23393,14398,130,70,60,2,4,1,1,0
27005,27999,8243,27999,913,126,787,2,31,1,1,0
64369,445,0,0,66,66,0,1,0,1,0,2
50089,53,56216,53,718,94,624,2,30,1,1,0
49921,53,38148,53,212,108,104,2,31,1,1,0
55836,443,63316,443,320,140,180,6,15,3,3,0
52765,443,7289,443,10359,1566,8793,27,150,13,14,0
56739,443,41966,443,7914,1925,5989,20,15,11,9,0
54471,36237,0,0,66,66,0,1,0,1,0,1
38948,53,19233,53,242,78,164,2,29,1,1,0
63554,445,0,0,70,70,0,1,0,1,0,2
47636,53,0,0,86,86,0,1,29,1,0,0
57161,445,0,0,70,70,0,1,0,1,0,2
64941,445,0,0,66,66,0,1,0,1,0,2
48906,80,50980,80,2544,1681,863,12,185,7,5,0
56752,44847,0,0,66,66,0,1,0,1,0,1
6881,6881,13981,6881,150,150,0,1,1200,1,0,0
49695,53,29724,53,240,102,138,2,30,1,1,0
37594,443,15585,443,60339,4689,55650,79,47,35,44,0
26287,56205,0,0,66,66,0,1,0,1,0,1
49513,53,20128,53,391,102,289,4,31,2,2,0
65325,445,0,0,66,66,0,1,0,1,0,2
50014,445,0,0,70,70,0,1,0,1,0,2
28378,56205,0,0,62,62,0,1,0,1,0,1
50043,445,0,0,66,66,0,1,0,1,0,2
62341,26467,0,0,66,66,0,1,0,1,0,1
59395,443,39581,443,5817,1995,3822,19,16,10,9,0
59967,445,0,0,70,70,0,1,0,1,0,2
49483,80,60356,80,318,192,126,6,40,4,2,0
56639,80,24086,80,234,234,0,4,12,4,0,0
39639,80,40156,80,1143,401,742,9,360,5,4,0
58468,57587,0,0,66,66,0,1,0,1,0,1
59355,51505,0,0,66,66,0,1,0,1,0,1
11478,51221,0,0,66,66,0,1,0,1,0,1
57767,445,0,0,70,70,0,1,0,1,0,2
10462,25174,0,0,62,62,0,1,0,1,0,1
41059,443,46382,443,1248874,30382,1218492,1261,111,425,836,0
53500,443,64344,443,558,210,348,9,29,4,5,0
58163,445,0,0,70,70,0,1,0,1,0,2
9473,26467,0,0,66,66,0,1,0,1,0,1
64595,53,56897,53,183,94,89,2,29,1,1,0
45461,25174,0,0,146,146,0,1,0,1,0,1
49213,443,9169,443,157994,4952,153042,186,255,68,118,0
49838,53,8093,53,182,93,89,2,31,1,1,0
57386,53,39494,53,193,102,91,2,30,1,1,0
53374,445,0,0,70,70,0,1,0,1,0,2
56884,53,27069,53,177,94,83,2,30,1,1,0
65002,445,0,0,70,70,0,1,0,1,0,2
56947,445,0,0,66,66,0,1,0,1,0,2
49615,53,30558,53,413,170,243,6,31,3,3,0
50522,445,0,0,70,70,0,1,0,1,0,2
65110,445,0,0,70,70,0,1,0,1,0,2
65176,53,35365,53,182,93,89,2,30,1,1,0
49666,80,7693,80,2356,499,1857,10,125,6,4,0
54530,445,0,0,70,70,0,1,0,1,0,2
46478,64147,0,0,145,145,0,1,0,1,0,1
60531,80,48244,80,2122,1559,563,13,16,7,6,0
59142,445,0,0,66,66,0,1,0,1,0,2
51313,64147,0,0,62,62,0,1,0,1,0,1
52901,443,37617,443,87558,4155,83403,115,117,41,74,0
56938,53,31467,53,452,101,351,4,36,2,2,0
50178,53,23159,53,758,96,662,2,31,1,1,0
51724,445,0,0,70,70,0,1,0,1,0,2
65331,53,63156,53,816,102,714,2,30,1,1,0
51876,443,3089,443,1852,1103,749,16,32,9,7,0
50584,9301,1872,9301,498,150,348,4,2396,2,2,0
37395,443,29125,443,16590,1630,14960,33,199,15,18,0
28192,50584,0,0,66,66,0,1,0,1,0,1
6828,64322,0,0,60,60,0,1,0,1,0,1
33260,443,40517,443,4051,2618,1433,21,23,13,8,0
43827,443,38851,443,677212,30094,647118,785,136,282,503,0
53544,21247,0,0,66,66,0,1,0,1,0,1
34896,53,34896,53,231,90,141,2,30,1,1,0
63152,445,0,0,70,70,0,1,0,1,0,2
63569,62413,0,0,66,66,0,1,0,1,0,1
65219,443,28202,443,4748,2193,2555,14,135,7,7,0
53628,50514,20883,50514,70,70,0,2,7,2,0,0
58002,445,0,0,70,70,0,1,0,1,0,2
62337,44847,0,0,66,66,0,1,0,1,0,1
54970,445,0,0,66,66,0,1,0,1,0,2
56675,445,0,0,70,70,0,1,0,1,0,2
64455,445,0,0,70,70,0,1,0,1,0,2
64669,445,0,0,70,70,0,1,0,1,0,2
49611,53,44019,53,177,94,83,2,30,1,1,0
49865,443,25068,443,6177,1038,5139,22,56,11,11,0
57598,80,57598,80,1810,821,989,10,20,6,4,0
52060,80,41226,80,366,240,126,7,25,5,2,0
9464,443,61543,443,9340,5582,3758,36,38,21,15,0
41101,443,39031,443,7067,2430,4637,18,17,8,10,0
54210,64097,0,0,66,66,0,1,0,1,0,1
52089,16543,15795,16543,70,70,0,1,5,1,0,0
60614,445,0,0,66,66,0,1,0,1,0,2
56907,53,11065,53,193,102,91,2,31,1,1,0
64344,53,48570,53,286,102,184,4,46,2,2,0
50042,53,35274,53,738,86,652,2,29,1,1,0
58867,443,37875,443,16230,11127,5103,69,330,34,35,0
56494,50432,0,0,146,146,0,1,0,1,0,1
28306,25604,0,0,62,62,0,1,0,1,0,1
7444,57470,0,0,66,66,0,1,0,1,0,1
55450,445,0,0,70,70,0,1,0,1,0,2
55525,53,23543,53,212,108,104,2,31,1,1,0
55598,53,46757,53,186,102,84,2,30,1,1,0
26940,443,35054,443,7599,2842,4757,27,22,15,12,0
49657,53,23289,53,198,94,104,2,30,1,1,0
3875,25174,0,0,62,62,0,1,0,1,0,1
56629,443,11922,443,23887293,546911,23340382,23137,108,7700,15437,0
65196,53,58386,53,177,94,83,2,30,1,1,0
33538,80,33538,80,424,198,226,7,141,4,3,0
3478,61463,0,0,1262,1262,0,1,0,1,0,1
5200,6643,0,0,145,145,0,1,0,1,0,1
55194,53,9824,53,195,102,93,2,31,1,1,0
63380,23,0,0,60,60,0,1,0,1,0,1
58438,445,0,0,70,70,0,1,0,1,0,2
7364,50584,0,0,66,66,0,1,0,1,0,1
63988,50584,0,0,66,66,0,1,0,1,0,1
62905,443,5789,443,8426,2893,5533,27,16,15,12,0
28229,51505,0,0,146,146,0,1,0,1,0,1
58286,37965,0,0,66,66,0,1,0,1,0,1
52116,80,18216,80,422,240,182,8,26,5,3,0
59051,27520,0,0,62,62,0,1,0,1,0,1
55056,44512,0,0,62,62,0,1,0,1,0,1
49456,53,39013,53,198,101,97,2,31,1,1,0
24227,48817,0,0,160,160,0,1,0,1,0,1
57011,53,6103,53,770,101,669,2,30,1,1,0
64037,18592,23660,18592,66,66,0,2,7,2,0,0
58638,5900,0,0,62,62,0,1,0,1,0,1
44695,53,44695,53,198,89,109,2,30,1,1,0
49712,445,0,0,70,70,0,1,0,1,0,2
58475,11392,0,0,66,66,0,1,0,1,0,1
51496,443,41580,443,1177,624,553,12,16,7,5,0
64005,53,33305,53,226,102,124,2,30,1,1,0
50218,53,36162,53,165,86,79,2,31,1,1,0
65001,53,27011,53,200,78,122,2,30,1,1,0
18203,23,0,0,60,60,0,1,0,1,0,1
55853,53,55965,53,197,102,95,2,30,1,1,0
56535,445,0,0,70,70,0,1,0,1,0,2
38701,443,3001,443,4478,1133,3345,13,27,8,5,0
57816,445,0,0,70,70,0,1,0,1,0,2
49597,53,40368,53,86,86,0,1,30,1,0,0
50450,53,51972,53,209,110,99,2,30,1,1,0
51326,443,48019,443,6250,1422,4828,20,17,10,10,0
52952,443,15638,443,9381,3074,6307,47,114,24,23,0
51424,80,51424,80,4995,3443,1552,23,26,13,10,0
52604,25174,0,0,62,62,0,1,0,1,0,1
56381,53,46735,53,196,102,94,2,31,1,1,0
58638,5900,0,0,62,62,0,1,0,1,0,1
60355,445,0,0,66,66,0,1,0,1,0,2
21187,53,21187,53,208,94,114,2,30,1,1,0
37597,50584,0,0,66,66,0,1,0,1,0,1
50945,445,0,0,66,66,0,1,0,1,0,2
56070,53,23575,53,193,102,91,2,30,1,1,0
51656,445,0,0,70,70,0,1,0,1,0,2
45886,80,22615,80,6959,2024,4935,14,148,8,6,0
54979,53,64417,53,183,94,89,2,30,1,1,0
61043,57470,0,0,78,78,0,1,0,1,0,1
50592,445,0,0,66,66,0,1,0,1,0,2
32967,443,43142,443,5327,963,4364,19,15,11,8,0
54066,443,63244,443,307208,13249,293959,367,202,153,214,0
49253,53,20812,53,198,101,97,2,30,1,1,0
52217,80,27362,80,1074,565,509,11,16,6,5,0
55148,445,0,0,70,70,0,1,0,1,0,2
63965,11785,30846,11785,66,66,0,1,5,1,0,0
57603,80,57603,80,4373,2985,1388,21,37,11,10,0
5938,22455,0,0,60,60,0,1,90,1,0,0
63808,40608,41042,40608,504,382,122,8,15,6,2,0
48841,51221,0,0,62,62,0,1,0,1,0,1
51350,445,0,0,70,70,0,1,0,1,0,2
51880,8001,48278,8001,86,86,0,1,29,1,0,0
28378,56205,0,0,146,146,0,1,0,1,0,1
64723,443,61032,443,7978900,79979,7898921,6464,210,644,5820,0
52968,80,9235,80,4004,1347,2657,29,114,15,14,0
56050,53,45848,53,172,88,84,2,30,1,1,0
62064,22114,0,0,66,66,0,1,0,1,0,1
58638,5900,0,0,62,62,0,1,0,1,0,1
56427,53,25251,53,178,94,84,2,29,1,1,0
38702,443,49260,443,1117339,17881,1099458,1006,16,256,750,0
58638,5900,0,0,62,62,0,1,0,1,0,1
53625,64147,0,0,66,66,0,1,0,1,0,1
57221,53,53360,53,184,102,82,2,30,1,1,0
27005,27017,13207,27017,890,126,764,2,30,1,1,0
50664,445,0,0,70,70,0,1,0,1,0,2
50312,445,0,0,70,70,0,1,0,1,0,2
50022,53,39220,53,174,89,85,2,30,1,1,0
56728,53,16534,53,166,86,80,2,30,1,1,0
49429,53,36318,53,210,110,100,2,30,1,1,0
52192,443,41129,443,13948,1150,12798,29,15,14,15,0
6355,25174,0,0,146,146,0,1,0,1,0,1
43164,443,24293,443,10030,3002,7028,24,16,13,11,0
65251,53,42946,53,199,102,97,2,30,1,1,0
50565,53,50708,53,707,94,613,2,30,1,1,0
65373,53,10645,53,197,102,95,2,29,1,1,0
63929,445,0,0,70,70,0,1,0,1,0,2
52807,443,39495,443,67984,17257,50727,121,148,50,71,0
49384,53,48199,53,193,102,91,2,31,1,1,0
51916,24596,60319,24596,70,70,0,1,5,1,0,0
50564,445,0,0,66,66,0,1,0,1,0,2
49998,443,24613,443,24410,6698,17712,32,16,13,19,0
63929,48477,13540,48477,70,70,0,1,5,1,0,0
60504,445,0,0,66,66,0,1,0,1,0,2
46660,443,53403,443,13699,2575,11124,30,135,15,15,0
61216,445,0,0,70,70,0,1,0,1,0,2
63743,445,0,0,70,70,0,1,0,1,0,2
64406,50584,0,0,62,62,0,1,0,1,0,1
56751,445,0,0,70,70,0,1,0,1,0,2
9017,6881,0,0,66,66,0,1,0,1,0,1
54127,443,25652,443,148422,10568,137854,223,115,114,109,0
59394,443,52019,443,5993,1987,4006,17,26,9,8,0
49168,443,13015,443,17765,1565,16200,29,16,12,17,0
443,44138,0,0,60,60,0,1,0,1,0,1
42308,443,54120,443,433261,34730,398531,604,279,258,346,0
26048,21,0,0,60,60,0,1,0,1,0,1
62804,37965,0,0,62,62,0,1,0,1,0,1
63786,50091,30767,50091,66,66,0,2,7,2,0,0
61594,445,0,0,70,70,0,1,0,1,0,2
65160,53,39178,53,198,94,104,2,30,1,1,0
49856,443,10855,443,5512,978,4534,20,60,10,10,0
60982,445,0,0,66,66,0,1,0,1,0,2
61190,21247,0,0,66,66,0,1,0,1,0,1
65287,53,9876,53,176,90,86,2,31,1,1,0
64898,445,0,0,70,70,0,1,0,1,0,2
57015,25174,0,0,66,66,0,1,0,1,0,1
57393,48983,0,0,146,146,0,1,0,1,0,1
17177,64147,0,0,62,62,0,1,0,1,0,1
6881,6881,0,0,146,146,0,1,0,1,0,1
52170,80,60754,80,362,240,122,7,17,5,2,0
65363,53,10698,53,181,94,87,2,30,1,1,0
45554,443,45554,443,4617,1710,2907,19,26,11,8,0
51723,10622,43836,10622,70,70,0,2,8,2,0,0
64679,53,17226,53,211,102,109,2,31,1,1,0
42542,25174,0,0,146,146,0,1,0,1,0,1
56491,445,0,0,70,70,0,1,0,1,0,2
40772,15503,0,0,74,74,0,1,0,1,0,1
64802,445,0,0,70,70,0,1,0,1,0,2
55868,53,11909,53,198,110,88,2,29,1,1,0
56993,53,24692,53,184,102,82,2,29,1,1,0
56940,80,57845,80,606,70,536,10,278,2,8,0
52266,445,0,0,70,70,0,1,0,1,0,2
63326,445,0,0,70,70,0,1,0,1,0,2
62800,80,25172,80,1437,659,778,11,45,6,5,0
20726,2767,0,0,66,66,0,1,0,1,0,1
64843,443,36183,443,13583,4157,9426,26,120,11,15,0
1730,37965,0,0,145,145,0,1,0,1,0,1
55508,53,1825,53,814,110,704,2,30,1,1,0
37649,443,13055,443,32391,21443,10948,69,47,41,28,0
60163,445,0,0,70,70,0,1,0,1,0,2
57131,35776,0,0,145,145,0,1,0,1,0,1
57750,445,0,0,66,66,0,1,0,1,0,2
52657,445,0,0,66,66,0,1,0,1,0,2
51443,445,0,0,66,66,0,1,0,1,0,2
35955,5228,64424,5228,6776,1542,5234,21,3600,12,9,0
65060,35440,0,0,62,62,0,1,0,1,0,1
15819,3389,0,0,60,60,0,1,0,1,0,1
63809,45193,55077,45193,66,66,0,1,5,1,0,0
51946,443,31314,443,2666,1542,1124,17,17,9,8,0
39161,17,0,0,60,60,0,1,0,1,0,1
57150,53,24486,53,170,87,83,2,30,1,1,0
64001,13051,20049,13051,66,66,0,2,7,2,0,0
61810,443,52096,443,3109,812,2297,13,136,6,7,0
49238,8080,49238,8080,378,180,198,7,53,4,3,0
60962,64147,0,0,66,66,0,1,0,1,0,1
5790,43890,0,0,62,62,0,1,0,1,0,1
1537,22114,0,0,146,146,0,1,0,1,0,1
57144,53,3454,53,172,88,84,2,31,1,1,0
58888,23718,0,0,66,66,0,1,0,1,0,1
57095,53,1337,53,211,110,101,2,29,1,1,0
50558,445,0,0,70,70,0,1,0,1,0,2
50308,445,0,0,70,70,0,1,0,1,0,2
49415,53,16500,53,194,102,92,2,30,1,1,0
53453,2767,0,0,62,62,0,1,0,1,0,1
56738,53,38791,53,821,102,719,2,30,1,1,0
38659,443,10582,443,11202,2200,9002,39,131,20,19,0
55209,445,0,0,70,70,0,1,0,1,0,2
50820,57470,0,0,66,66,0,1,0,1,0,1
59592,37965,0,0,62,62,0,1,0,1,0,1
56866,53,52471,53,194,102,92,2,30,1,1,0
63480,445,0,0,70,70,0,1,0,1,0,2
30114,65151,0,0,60,60,0,1,0,1,0,1
36278,7000,36278,7000,3578,1967,1611,16,16,8,8,0
60504,445,0,0,70,70,0,1,0,1,0,2
57224,445,0,0,66,66,0,1,0,1,0,2
5826,26467,0,0,62,62,0,1,0,1,0,1
52038,80,51825,80,70,70,0,1,5,1,0,0
49982,53,52781,53,206,105,101,2,31,1,1,0
64879,53,48255,53,356,118,238,2,30,1,1,0
51898,443,2125,443,7866,1549,6317,21,321,10,11,0
33017,443,34545,443,130,70,60,3,4,2,1,0
58638,5900,0,0,62,62,0,1,0,1,0,1
63965,53,30693,53,192,90,102,2,31,1,1,0
25565,44521,0,0,60,60,0,1,0,1,0,1
49481,7000,49481,7000,3066,1675,1391,16,14,9,7,0
59524,25174,0,0,66,66,0,1,0,1,0,1
65516,53,21286,53,209,110,99,2,30,1,1,0
50638,443,62460,443,14401,2712,11689,52,19,23,29,0
56350,53,30997,53,287,102,185,2,30,1,1,0
31845,55777,0,0,62,62,0,1,0,1,0,1
49828,53,44800,53,733,86,647,2,29,1,1,0
64608,53,13914,53,208,106,102,2,31,1,1,0
57603,80,12542,80,886,886,0,1,120,1,0,0
60416,37965,0,0,66,66,0,1,0,1,0,1
58638,5900,0,0,62,62,0,1,0,1,0,1
52934,443,64385,443,5584,1390,4194,19,14,9,10,0
49958,36829,0,0,66,66,0,1,0,1,0,1
56896,445,0,0,66,66,0,1,0,1,0,2
49851,53,28608,53,164,84,80,2,30,1,1,0
58338,3369,0,0,60,60,0,1,0,1,0,1
38115,80,9146,80,6442,1404,5038,23,30,12,11,0
38706,443,10577,443,90545,3481,87064,96,16,31,65,0
49263,445,0,0,66,66,0,1,0,1,0,2
50479,443,28335,443,1654,1011,643,16,82,9,7,0
56643,443,54840,443,7914,1925,5989,20,15,11,9,0
64890,51180,0,0,66,66,0,1,0,1,0,1
443,14315,0,0,158,158,0,1,0,1,0,1
55077,53,49404,53,394,94,300,2,30,1,1,0
49461,53,60884,53,314,102,212,2,30,1,1,0
52955,445,0,0,70,70,0,1,0,1,0,2
40322,23,0,0,60,60,0,1,0,1,0,1
53799,6881,10719,6881,70,70,0,1,4,1,0,0
56865,445,0,0,66,66,0,1,0,1,0,2
54699,53,18510,53,236,86,150,2,30,1,1,0
49522,445,0,0,66,66,0,1,0,1,0,2
27005,1308,10914,1308,855,126,729,2,29,1,1,0
1790,48817,0,0,66,66,0,1,0,1,0,1
58829,445,0,0,66,66,0,1,0,1,0,2
49570,53,16357,53,196,94,102,2,29,1,1,0
25778,53,25778,53,235,90,145,2,33,1,1,0
43931,53,36161,53,168,78,90,2,31,1,1,0
58192,443,58192,443,4381,1474,2907,19,29,11,8,0
63948,53,52448,53,366,102,264,4,60,2,2,0
49777,53,59395,53,164,84,80,2,31,1,1,0
55618,53,59211,53,255,102,153,2,30,1,1,0
51267,38070,5566,38070,210,140,70,4,14,3,1,0
51315,445,0,0,66,66,0,1,0,1,0,2
6889,48817,0,0,143,143,0,1,0,1,0,1
51590,445,0,0,66,66,0,1,0,1,0,2
49293,22,0,0,60,60,0,1,0,1,0,1
55766,36237,0,0,62,62,0,1,0,1,0,1
50692,443,32817,443,180,60,120,4,15,2,2,0
55033,445,0,0,66,66,0,1,0,1,0,2
56496,53,41605,53,193,102,91,2,30,1,1,0
45701,80,26870,80,1579,1217,362,8,15,5,3,0
55912,53,45004,53,199,102,97,2,29,1,1,0
58513,445,0,0,70,70,0,1,0,1,0,2
54206,25174,0,0,62,62,0,1,0,1,0,1
62150,445,0,0,70,70,0,1,0,1,0,2
57470,64919,63117,64919,594,594,0,10,1199,10,0,0
57498,445,0,0,70,70,0,1,0,1,0,2
59680,80,46564,80,5762500,128192,5634308,5613,134,1854,3759,0
43480,443,57887,443,58423,25600,32823,86,138,40,46,0
60012,443,29771,443,6438,2599,3839,21,144,10,11,0
58445,17500,0,0,66,66,0,1,0,1,0,1
63035,443,64744,443,1864,250,1614,8,120,4,4,0
56709,445,0,0,66,66,0,1,0,1,0,2
60394,11136,28099,11136,7512,2276,5236,39,94,21,18,0
36011,25174,0,0,66,66,0,1,0,1,0,1
60882,443,27723,443,4485,794,3691,17,25,9,8,0
65274,53,29709,53,295,101,194,4,31,2,2,0
2267,53,13716,53,204,118,86,2,30,1,1,0
63873,445,0,0,70,70,0,1,0,1,0,2
65206,443,20256,443,7525,3267,4258,36,120,17,19,0
50617,80,45162,80,1658,1247,411,8,14,5,3,0
49001,55108,0,0,160,160,0,1,0,1,0,1
53406,44847,0,0,66,66,0,1,0,1,0,1
50812,445,0,0,70,70,0,1,0,1,0,2
11136,17500,0,0,62,62,0,1,0,1,0,1
57170,53,64269,53,200,102,98,2,31,1,1,0
65396,445,0,0,70,70,0,1,0,1,0,2
47342,20541,0,0,66,66,0,1,0,1,0,1
7482,57470,0,0,66,66,0,1,0,1,0,1
61382,25174,0,0,66,66,0,1,0,1,0,1
56728,53,8699,53,166,86,80,2,31,1,1,0
49573,443,16183,443,7332,2197,5135,18,135,8,10,0
27005,32025,48806,32025,887,126,761,2,31,1,1,0
59772,80,1176,80,5558,3386,2172,29,36,15,14,0
63150,443,63150,443,6792,1521,5271,18,28,11,7,0
46776,443,41505,443,7389,1786,5603,26,211,14,12,0
34215,443,33625,443,5341,1386,3955,19,649,11,8,0
55600,22,0,0,60,60,0,1,0,1,0,1
50542,443,2915,443,6787,1846,4941,24,361,11,13,0
58638,5900,0,0,62,62,0,1,0,1,0,1
55199,53,62068,53,152,78,74,2,30,1,1,0
54138,443,3905,443,5702,1212,4490,19,139,10,9,0
49891,53,62229,53,822,102,720,2,30,1,1,0
49784,443,6049,443,7805,1949,5856,22,126,12,10,0
55448,53,34800,53,184,94,90,2,29,1,1,0
56663,443,26937,443,1299,730,569,13,25,7,6,0
52848,443,15385,443,6218,1239,4979,14,133,7,7,0
62922,445,0,0,66,66,0,1,0,1,0,2
58876,57470,0,0,66,66,0,1,0,1,0,1
49968,445,0,0,66,66,0,1,0,1,0,2
55620,53,36114,53,178,94,84,2,31,1,1,0
35428,443,14497,443,9592,2361,7231,25,15,14,11,0
54873,443,62397,443,9238,3472,5766,43,75,24,19,0
64299,53,64359,53,166,86,80,2,30,1,1,0
55620,30188,0,0,66,66,0,1,0,1,0,1
49490,443,58298,443,1627,884,743,12,27,6,6,0
49340,53,43709,53,94,94,0,1,30,1,0,0
65367,443,29972,443,5666,4417,1249,23,86,12,11,0
50018,80,3941,80,825,685,140,6,33,4,2,0
10000,10214,0,0,62,62,0,1,0,1,0,1
32511,23,0,0,60,60,0,1,0,1,0,1
50561,445,0,0,66,66,0,1,0,1,0,2
39318,443,24928,443,6933,2226,4707,33,140,18,15,0
50337,443,21907,443,9653,1740,7913,23,81,12,11,0
52013,443,52013,443,43964,6675,37289,60,49,25,35,0
56758,40000,32207,40000,70,70,0,2,8,2,0,0
43688,22114,0,0,62,62,0,1,0,1,0,1
64677,53,12416,53,172,88,84,2,31,1,1,0
63130,55860,38620,55860,1426,964,462,7,15,4,3,0
60033,443,2482,443,4223,2828,1395,23,28,13,10,0
15641,26467,0,0,62,62,0,1,0,1,0,1
18091,32480,0,0,66,66,0,1,0,1,0,1
56663,53,10723,53,181,94,87,2,33,1,1,0
49805,64147,0,0,66,66,0,1,0,1,0,1
46899,443,24525,443,70,70,0,1,5,1,0,0
27366,5222,55342,5222,3833,1007,2826,27,68,11,16,0
52189,445,0,0,70,70,0,1,0,1,0,2
59759,443,40820,443,13342,1221,12121,33,41,15,18,0
51911,443,51829,443,4456,2972,1484,38,211,20,18,0
26865,443,22998,443,21239,16302,4937,35,20,20,15,0
63135,443,47015,443,7127,1737,5390,18,16,10,8,0
57394,53,17167,53,193,102,91,2,31,1,1,0
50865,443,45042,443,6883,1378,5505,19,131,9,10,0
17176,443,17176,443,6311,1229,5082,18,16,8,10,0
52152,443,39969,443,433460,26631,406829,595,147,224,371,0
61734,443,59784,443,231110,14545,216565,307,18,154,153,0
49701,53,61542,53,197,102,95,2,30,1,1,0
37611,53,57023,53,199,94,105,2,30,1,1,0
64797,53,45567,53,216,102,114,2,30,1,1,0
35579,443,65088,443,13136,3596,9540,40,26,21,19,0
58736,53,58736,53,235,90,145,2,32,1,1,0
12348,50265,0,0,62,62,0,1,0,1,0,1
42298,40029,57945,40029,652,83,569,4,31,2,2,0
2522,64147,0,0,62,62,0,1,0,1,0,1
49283,445,0,0,70,70,0,1,0,1,0,2
49420,443,13090,443,5241,1194,4047,19,40,9,10,0
56678,53,49059,53,240,110,130,2,30,1,1,0
27005,27017,42794,27017,880,126,754,2,30,1,1,0
17781,50265,0,0,145,145,0,1,0,1,0,1
61583,80,61583,80,12301,1642,10659,20,20,9,11,0
55373,445,0,0,70,70,0,1,0,1,0,2
56415,53,18388,53,179,94,85,2,29,1,1,0
56645,443,46847,443,7914,1925,5989,20,15,11,9,0
51830,443,51830,443,17899,5015,12884,33,36,14,19,0
52475,445,0,0,66,66,0,1,0,1,0,2
48994,443,64205,443,46452,6817,39635,103,299,45,58,0
53888,39204,51033,39204,70,70,0,1,5,1,0,0
3578,51505,0,0,66,66,0,1,0,1,0,1
54262,443,59350,443,11356,5509,5847,84,544,44,40,0
62646,445,0,0,66,66,0,1,0,1,0,2
14487,38303,0,0,146,146,0,1,0,1,0,1
58563,53,4425,53,312,78,234,2,29,1,1,0
45964,3111,0,0,60,60,0,1,0,1,0,1
50438,80,13874,80,314,192,122,6,26,4,2,0
6649,80,6649,80,103631,2766,100865,110,39,38,72,0
5588,5588,0,0,3354,1792,1562,46,193,23,23,0
63750,445,0,0,70,70,0,1,0,1,0,2
58374,445,0,0,70,70,0,1,0,1,0,2
49476,445,0,0,66,66,0,1,0,1,0,2
49747,53,22028,53,278,94,184,2,30,1,1,0
56277,445,0,0,66,66,0,1,0,1,0,2
62122,445,0,0,66,66,0,1,0,1,0,2
51696,14370,13279,14370,70,70,0,1,5,1,0,0
59739,35253,0,0,62,62,0,1,0,1,0,1
59956,443,50575,443,2162,1113,1049,18,16,10,8,0
65114,443,65114,443,4480,1573,2907,19,30,11,8,0
64030,445,0,0,70,70,0,1,0,1,0,2
49668,443,64842,443,1288,754,534,13,50,5,8,0
50584,49533,38774,49533,161,161,0,1,1200,1,0,0
39328,80,62636,80,234,234,0,4,12,4,0,0
64448,53,46885,53,353,92,261,4,38,2,2,0
59732,443,44274,443,34866,3347,31519,55,54,22,33,0
64071,53,28084,53,424,104,320,4,31,2,2,0
57804,445,0,0,70,70,0,1,0,1,0,2
37633,44847,0,0,62,62,0,1,0,1,0,1
59115,445,0,0,70,70,0,1,0,1,0,2
26500,80,26500,80,57276,6978,50298,77,30,34,43,0
64797,80,54604,80,378,192,186,7,71,4,3,0
49199,53,25125,53,193,102,91,2,30,1,1,0
65336,53,9283,53,200,102,98,2,29,1,1,0
28306,25604,0,0,62,62,0,1,0,1,0,1
52157,23002,50044,23002,70,70,0,1,5,1,0,0
58638,5900,0,0,62,62,0,1,0,1,0,1
46288,443,54873,443,28173,21385,6788,100,41,51,49,0
56362,53,49796,53,190,97,93,2,31,1,1,0
53783,443,19626,443,499,425,74,4,0,3,1,0
43916,21,0,0,60,60,0,1,0,1,0,1
55000,53,31472,53,193,102,91,2,29,1,1,0
6881,32056,50769,32056,509,150,359,2,1199,1,1,0
31974,51505,0,0,66,66,0,1,0,1,0,1
65025,53,23591,53,347,94,253,2,30,1,1,0
54062,31573,0,0,66,66,0,1,0,1,0,1
50055,445,0,0,66,66,0,1,0,1,0,2
61252,445,0,0,70,70,0,1,0,1,0,2
51427,80,51427,80,22364,4125,18239,41,26,19,22,0
9230,443,20303,443,6020,792,5228,18,25,9,9,0
65447,445,0,0,66,66,0,1,0,1,0,2
59965,36237,0,0,66,66,0,1,0,1,0,1
59965,80,33685,80,1638,1324,314,10,15,5,5,0
53178,445,0,0,70,70,0,1,0,1,0,2
64125,53,18557,53,199,102,97,2,30,1,1,0
10151,19083,54566,19083,489,149,340,2,1200,1,1,0
53258,443,7093,443,5124,979,4145,19,54,10,9,0
55607,17820,29778,17820,504,318,186,8,16,5,3,0
43071,80,63845,80,808,480,328,13,158,9,4,0
23900,64147,0,0,62,62,0,1,0,1,0,1
52220,22,52220,22,8248,3445,4803,57,38,26,31,0
64790,53,41786,53,183,94,89,2,30,1,1,0
11880,36829,0,0,146,146,0,1,0,1,0,1
63768,55755,28718,55755,66,66,0,2,7,2,0,0
21478,53,21478,53,625,79,546,2,30,1,1,0
64554,445,0,0,66,66,0,1,0,1,0,2
54280,3396,54280,3396,60,60,0,1,5,1,0,0
53551,60444,1391,60444,492,306,186,8,15,5,3,0
56432,53,34927,53,458,188,270,6,30,3,3,0
27005,27054,8800,27054,921,126,795,2,31,1,1,0
64860,445,0,0,66,66,0,1,0,1,0,2
5357,32468,0,0,62,62,0,1,0,1,0,1
53425,443,1934,443,7208,2237,4971,26,32,16,10,0
37738,443,1957,443,6470,1931,4539,27,32,14,13,0
48676,53389,0,0,60,60,0,1,0,1,0,1
56285,53,7225,53,751,95,656,2,31,1,1,0
52996,443,47538,443,22513,15188,7325,69,517,31,38,0
56176,443,9976,443,1312,651,661,13,185,7,6,0
53125,443,2099,443,7738,2230,5508,24,45,14,10,0
65339,53,4097,53,775,102,673,2,30,1,1,0
57201,53,40982,53,214,110,104,2,29,1,1,0
48817,51413,48817,51413,479,152,327,2,1200,1,1,0
18632,51505,0,0,66,66,0,1,0,1,0,1
58638,5900,0,0,62,62,0,1,0,1,0,1
51244,42416,0,0,100,100,0,1,0,1,0,1
55594,53,28823,53,168,78,90,2,30,1,1,0
40392,443,64453,443,8105,2278,5827,27,196,15,12,0
50197,64147,0,0,66,66,0,1,0,1,0,1
123,123,26903,123,826,376,450,10,34,5,5,0
36144,443,36144,443,170890,13800,157090,246,97,123,123,0
49336,25174,0,0,66,66,0,1,0,1,0,1
53577,445,0,0,66,66,0,1,0,1,0,2
64520,53,44752,53,184,86,98,2,29,1,1,0
65526,53,17062,53,198,101,97,2,31,1,1,0
47976,443,55009,443,16187,11705,4482,33,159,19,14,0
64290,53,4027,53,302,98,204,4,47,2,2,0
60381,443,9520,443,24271,17315,6956,53,107,34,19,0
49373,443,19953,443,1857,1218,639,18,104,11,7,0
57425,443,33540,443,130,70,60,2,15,1,1,0
56450,53,26592,53,170,87,83,2,30,1,1,0
46822,443,53756,443,71073,4403,66670,99,116,41,58,0
61411,80,31645,80,145440,11034,134406,292,158,135,157,0
63401,445,0,0,70,70,0,1,0,1,0,2
33965,443,25810,443,1409634,52704,1356930,1536,173,533,1003,0
56711,25174,0,0,62,62,0,1,0,1,0,1
64882,53,14352,53,180,94,86,2,30,1,1,0
49209,53,27106,53,199,102,97,2,31,1,1,0
43345,443,34624,443,7767,1069,6698,23,3971,7,16,0
50864,443,18823,443,6663,1556,5107,21,132,10,11,0
59754,53,11671,53,260,86,174,2,30,1,1,0
64082,53,17005,53,356,97,259,4,58,2,2,0
16387,7205,0,0,60,60,0,1,0,1,0,1
50282,445,0,0,66,66,0,1,0,1,0,2
55126,53,57162,53,177,94,83,2,30,1,1,0
51810,445,0,0,70,70,0,1,0,1,0,2
63574,445,0,0,70,70,0,1,0,1,0,2
57504,44847,0,0,66,66,0,1,0,1,0,1
54998,443,38889,443,10151,2256,7895,32,39,17,15,0
50859,445,0,0,70,70,0,1,0,1,0,2
9058,443,18160,443,5655,934,4721,16,130,8,8,0
37582,443,52781,443,499,425,74,4,0,3,1,0
53705,30600,18470,30600,492,306,186,8,15,5,3,0
50652,445,0,0,66,66,0,1,0,1,0,2
51246,445,0,0,70,70,0,1,0,1,0,2
53298,80,1119,80,12660,7492,5168,27,274,14,13,0
65428,443,7165,443,14203,1525,12678,13,143,2,11,0
54137,443,48423,443,2573,330,2243,12,136,5,7,0
49390,53,36883,53,210,110,100,2,30,1,1,0
64480,53,30625,53,276,126,150,2,30,1,1,0
56837,53,4890,53,195,102,93,2,29,1,1,0
35637,443,59473,443,5611,1559,4052,22,648,13,9,0
54602,445,0,0,70,70,0,1,0,1,0,2
6881,6881,44146,6881,502,150,352,2,1199,1,1,0
55246,31573,0,0,62,62,0,1,0,1,0,1
57470,50321,52574,50321,1584,1584,0,25,1537,25,0,0
62125,445,0,0,66,66,0,1,0,1,0,2
1936,80,29393,80,214,140,74,4,15,3,1,0
49667,443,61228,443,334,140,194,6,25,3,3,0
57652,445,0,0,66,66,0,1,0,1,0,2
5826,26467,0,0,62,62,0,1,0,1,0,1
49224,53,51489,53,199,102,97,2,34,1,1,0
58638,5900,0,0,62,62,0,1,0,1,0,1
49485,443,26234,443,49823,7236,42587,56,29,20,36,0
51808,46390,34181,46390,70,70,0,1,4,1,0,0
60174,80,16526,80,1564,990,574,15,24,8,7,0
38364,15000,10224,15000,130,70,60,2,5,1,1,0
2062,35440,0,0,66,66,0,1,0,1,0,1
56658,53,42222,53,177,94,83,2,29,1,1,0
55644,53,55094,53,184,94,90,2,30,1,1,0
42298,40039,40294,40039,211,89,122,4,30,2,2,0
65514,443,30386,443,92638,4519,88119,105,15,39,66,0
56263,53,57350,53,385,134,251,2,31,1,1,0
47388,443,44848,443,2897,728,2169,10,121,5,5,0
64573,53,58393,53,558,104,454,4,49,2,2,0
43743,53,43743,53,240,98,142,2,29,1,1,0
55919,53,57611,53,754,94,660,2,31,1,1,0
64809,53,47769,53,312,78,234,2,30,1,1,0
24144,57470,0,0,62,62,0,1,0,1,0,1
6881,6881,0,0,62,62,0,1,0,1,0,1
52673,80,57831,80,23776,1372,22404,35,112,15,20,0
64956,53,13763,53,565,92,473,4,38,2,2,0
56426,53,37263,53,184,94,90,2,31,1,1,0
54375,445,0,0,66,66,0,1,0,1,0,2
61536,445,0,0,70,70,0,1,0,1,0,2
31660,35440,0,0,66,66,0,1,0,1,0,1
54746,22114,0,0,146,146,0,1,0,1,0,1
60329,80,45049,80,374,192,182,7,61,4,3,0
49704,80,31664,80,217502,6597,210905,211,109,62,149,0
35232,36602,0,0,74,74,0,1,0,1,0,1
65098,53,21613,53,740,93,647,2,31,1,1,0
60383,16881,9133,16881,564,318,246,9,18,5,4,0
55835,62413,0,0,66,66,0,1,0,1,0,1
50233,53,42089,53,748,94,654,2,30,1,1,0
58835,17372,0,0,66,66,0,1,0,1,0,1
53806,37267,20623,37267,70,70,0,1,4,1,0,0
57834,80,57834,80,2106,1657,449,10,20,6,4,0
29300,35440,0,0,146,146,0,1,0,1,0,1
5223,44091,0,0,66,66,0,1,0,1,0,1
56500,53,41129,53,199,102,97,2,30,1,1,0
58239,445,0,0,70,70,0,1,0,1,0,2
61467,445,0,0,70,70,0,1,0,1,0,2
58040,445,0,0,66,66,0,1,0,1,0,2
49257,53,6745,53,199,102,97,2,30,1,1,0
443,14591,0,0,100,100,0,1,0,1,0,1
53019,80,53019,80,181759,5146,176613,216,25,77,139,0
25679,27189,0,0,62,62,0,1,0,1,0,1
6881,40783,51733,40783,509,150,359,2,1199,1,1,0
50303,443,52524,443,208,60,148,4,11,2,2,0
58500,445,0,0,66,66,0,1,0,1,0,2
50722,445,0,0,70,70,0,1,0,1,0,2
34981,80,29727,80,1658,1344,314,10,15,5,5,0
61637,25174,0,0,66,66,0,1,0,1,0,1
65319,445,0,0,66,66,0,1,0,1,0,2
55564,80,32717,80,944,529,415,11,315,6,5,0
24040,22114,0,0,62,62,0,1,0,1,0,1
50282,37965,0,0,66,66,0,1,0,1,0,1
50822,50584,0,0,66,66,0,1,0,1,0,1
55190,53,57289,53,311,94,217,2,30,1,1,0
52459,33890,0,0,60,60,0,1,0,1,0,1
50862,445,0,0,70,70,0,1,0,1,0,2
52272,80,52272,80,237488,7574,229914,231,27,71,160,0
52959,80,37640,80,122572,3630,118942,128,358,46,82,0
27005,27216,53096,27216,883,126,757,2,31,1,1,0
55021,53,44725,53,179,94,85,2,30,1,1,0
29011,32468,0,0,62,62,0,1,0,1,0,1
51382,56205,0,0,62,62,0,1,0,1,0,1
55698,45710,57579,45710,70,70,0,1,5,1,0,0
64580,53,3526,53,180,94,86,2,30,1,1,0
56292,53,0,0,238,94,144,2,29,1,1,0
63778,50584,0,0,146,146,0,1,0,1,0,1
56633,53,46953,53,342,99,243,4,32,2,2,0
56734,445,0,0,66,66,0,1,0,1,0,2
49786,25174,0,0,66,66,0,1,0,1,0,1
58701,27030,51697,27030,70,70,0,2,9,2,0,0
58536,53,40631,53,522,162,360,6,64,3,3,0
63069,443,57757,443,2523249,58976,2464273,2483,33,820,1663,0
52724,64147,0,0,62,62,0,1,0,1,0,1
51606,443,26654,443,2895,2046,849,14,134,8,6,0
51988,32239,13198,32239,66,66,0,1,5,1,0,0
19473,28109,14230,28109,468,149,319,2,1200,1,1,0
56631,80,27363,80,61771,2713,59058,80,45,35,45,0
64631,53,5606,53,193,102,91,2,30,1,1,0
50726,445,0,0,70,70,0,1,0,1,0,2
40175,80,8302,80,130,70,60,2,15,1,1,0
57018,53,10253,53,177,94,83,2,30,1,1,0
50496,443,27297,443,90570,3437,87133,103,90,34,69,0
55543,445,0,0,70,70,0,1,0,1,0,2
27528,35440,0,0,66,66,0,1,0,1,0,1
31727,57470,0,0,62,62,0,1,0,1,0,1
50123,443,58250,443,15011,5619,9392,50,35,26,24,0
55706,33677,37931,33677,210,140,70,4,14,3,1,0
54941,80,51171,80,2513,567,1946,10,75,6,4,0
64157,445,0,0,70,70,0,1,0,1,0,2
59845,15503,0,0,66,66,0,1,0,1,0,1
47831,443,18559,443,180582,6020,174562,196,200,70,126,0
63643,445,0,0,66,66,0,1,0,1,0,2
65139,53,58108,53,754,94,660,2,31,1,1,0
55605,53,56113,53,196,100,96,2,30,1,1,0
11252,23,0,0,60,60,0,1,0,1,0,1
52065,80,44925,80,692,300,392,9,26,6,3,0
55203,443,52613,443,12947,4309,8638,29,152,15,14,0
20706,37965,0,0,62,62,0,1,0,1,0,1
56614,443,40071,443,8034,2014,6020,20,15,11,9,0
56423,445,0,0,70,70,0,1,0,1,0,2
2076,7000,2076,7000,5194,3739,1455,18,15,10,8,0
53030,56205,0,0,66,66,0,1,0,1,0,1
34038,5222,46652,5222,2853,1289,1564,30,1555,12,18,0
60405,5900,0,0,60,60,0,1,0,1,0,1
65189,27015,44891,27015,255,78,177,2,30,1,1,0
50948,80,50948,80,520,246,274,9,25,5,4,0
29016,25174,0,0,62,62,0,1,0,1,0,1
53131,80,64503,80,2957,619,2338,12,15,6,6,0
1024,25174,0,0,62,62,0,1,0,1,0,1
53898,443,56204,443,499,425,74,4,0,3,1,0
49486,53,40876,53,177,94,83,2,31,1,1,0
50,64147,0,0,66,66,0,1,0,1,0,1
35519,80,60080,80,841,715,126,5,15,3,2,0
56532,443,14584,443,198167,11702,186465,220,105,84,136,0
55132,445,0,0,70,70,0,1,0,1,0,2
59107,25174,0,0,66,66,0,1,0,1,0,1
15513,25174,0,0,62,62,0,1,0,1,0,1
56835,445,0,0,66,66,0,1,0,1,0,2
54280,3398,0,0,60,60,0,1,0,1,0,1
56940,53,50066,53,200,102,98,2,30,1,1,0
11967,57470,0,0,62,62,0,1,0,1,0,1
51346,51221,0,0,70,70,0,1,0,1,0,1
52054,443,46268,443,9339,4411,4928,20,135,10,10,0
62692,445,0,0,70,70,0,1,0,1,0,2
50865,445,0,0,66,66,0,1,0,1,0,2
57188,53,20332,53,193,102,91,2,30,1,1,0
59117,53,0,0,82,82,0,1,31,1,0,0
53722,443,10654,443,70,70,0,2,7,2,0,0
63868,60392,39941,60392,66,66,0,2,7,2,0,0
62014,35440,0,0,66,66,0,1,0,1,0,1
56407,53,58288,53,216,102,114,2,29,1,1,0
57182,445,0,0,66,66,0,1,0,1,0,2
56322,53,7412,53,202,103,99,2,31,1,1,0
53195,443,44058,443,2016,1160,856,17,46,9,8,0
50990,445,0,0,66,66,0,1,0,1,0,2
11450,57470,0,0,66,66,0,1,0,1,0,1
65277,53,20067,53,196,102,94,2,30,1,1,0
57284,53,3184,53,212,108,104,2,31,1,1,0
37905,443,37905,443,4707,1800,2907,19,26,11,8,0
40204,40010,8959,40010,148,86,62,2,29,1,1,0
33215,37965,0,0,62,62,0,1,0,1,0,1
52385,53,0,0,139,70,69,2,30,1,1,0
38041,10104,0,0,146,146,0,1,0,1,0,1
14336,64147,0,0,62,62,0,1,0,1,0,1
55163,53,4604,53,197,102,95,2,31,1,1,0
35738,80,42244,80,1151,711,440,10,16,5,5,0
51827,56205,0,0,66,66,0,1,0,1,0,1
48286,443,64439,443,9590,3002,6588,25,96,14,11,0
61845,11392,0,0,66,66,0,1,0,1,0,1
38557,443,3043,443,70,70,0,1,5,1,0,0
50734,37965,0,0,62,62,0,1,0,1,0,1
53608,445,0,0,66,66,0,1,0,1,0,2
56783,53,31906,53,751,95,656,2,31,1,1,0
58941,80,60543,80,1114,534,580,12,15,7,5,0
53748,51413,19666,51413,70,70,0,1,5,1,0,0
55109,53,12323,53,711,87,624,2,30,1,1,0
58199,445,0,0,66,66,0,1,0,1,0,2
55330,445,0,0,70,70,0,1,0,1,0,2
64762,53,20987,53,194,102,92,2,31,1,1,0
40252,443,46211,443,543828,50144,493684,682,172,254,428,0
50290,53,2460,53,211,110,101,2,30,1,1,0
63239,445,0,0,66,66,0,1,0,1,0,2
50452,80,41109,80,318,192,126,6,29,4,2,0
54996,53,39612,53,168,86,82,2,35,1,1,0
58837,3389,58837,3389,4429,2581,1848,21,33,11,10,0
56955,53,2081,53,182,93,89,2,31,1,1,0
51281,445,0,0,70,70,0,1,0,1,0,2
65447,53,29961,53,330,105,225,4,37,2,2,0
42811,443,38598,443,2766,1907,859,17,25,10,7,0
25602,64147,0,0,62,62,0,1,0,1,0,1
56783,53,7045,53,193,102,91,2,30,1,1,0
64660,445,0,0,66,66,0,1,0,1,0,2
52155,445,0,0,70,70,0,1,0,1,0,2
55846,53,27827,53,198,102,96,2,30,1,1,0
64887,445,0,0,66,66,0,1,0,1,0,2
53555,57861,41718,57861,492,306,186,8,15,5,3,0
51524,445,0,0,66,66,0,1,0,1,0,2
49326,53,16602,53,186,95,91,2,30,1,1,0
50669,53,9177,53,578,286,292,9,16,5,4,0
39118,443,29645,443,5229,2388,2841,23,367,12,11,0
57543,445,0,0,70,70,0,1,0,1,0,2
53531,48908,54109,48908,70,70,0,2,7,2,0,0
49428,445,0,0,66,66,0,1,0,1,0,2
50462,53,31547,53,299,94,205,2,30,1,1,0
56921,443,49898,443,8416,2142,6274,25,330,12,13,0
55634,53,46753,53,308,102,206,2,30,1,1,0
39742,62413,0,0,66,66,0,1,0,1,0,1
20641,53,20641,53,240,98,142,2,29,1,1,0
63214,445,0,0,70,70,0,1,0,1,0,2
49509,443,10156,443,8248,2508,5740,31,271,13,18,0
62887,993,3389,993,8921,4675,4246,77,200,47,30,0
49909,443,16969,443,6754,2219,4535,21,75,11,10,0
27005,27016,24190,27016,1696,126,1570,4,31,2,2,0
37600,443,40571,443,19917,8751,11166,51,56,32,19,0
60295,53,27114,53,224,94,130,2,30,1,1,0
13281,51050,0,0,66,66,0,1,0,1,0,1
27677,22114,0,0,146,146,0,1,0,1,0,1
7000,23117,0,0,66,66,0,1,0,1,0,1
57999,80,9823,80,5434,3724,1710,26,76,14,12,0
23151,53,23151,53,194,87,107,2,31,1,1,0
5379,37965,0,0,62,62,0,1,0,1,0,1
64154,53,35293,53,194,102,92,2,29,1,1,0
49813,445,0,0,70,70,0,1,0,1,0,2
58791,15503,0,0,66,66,0,1,0,1,0,1
58362,53,30634,53,167,78,89,2,30,1,1,0
57183,53,32090,53,178,94,84,2,30,1,1,0
55137,445,0,0,70,70,0,1,0,1,0,2
50186,443,39007,443,6440,1603,4837,23,361,11,12,0
49180,443,17664,443,888019,22655,865364,902,18,322,580,0
1190,25174,0,0,62,62,0,1,0,1,0,1
50373,443,34130,443,5422,707,4715,16,25,8,8,0
16387,20045,0,0,60,60,0,1,0,1,0,1
49849,53,11014,53,196,102,94,2,30,1,1,0
51922,18413,51851,18413,70,70,0,1,5,1,0,0
44799,443,2515,443,3467,2186,1281,16,15,9,7,0
64537,53,37078,53,168,86,82,2,30,1,1,0
65196,445,0,0,70,70,0,1,0,1,0,2
34454,80,29541,80,2913,633,2280,15,16,8,7,0
20953,53,20953,53,295,90,205,2,30,1,1,0
55069,44847,0,0,66,66,0,1,0,1,0,1
42172,443,15822,443,7071,1908,5163,29,944,14,15,0
56309,22114,0,0,62,62,0,1,0,1,0,1
49929,53,22603,53,214,110,104,2,29,1,1,0
64900,53,55374,53,778,103,675,2,30,1,1,0
80,9918,0,0,60,60,0,1,0,1,0,1
33446,80,33446,80,1753,833,920,10,20,6,4,0
56743,53,16205,53,202,103,99,2,30,1,1,0
49824,25174,0,0,62,62,0,1,0,1,0,1
39583,37965,0,0,66,66,0,1,0,1,0,1
60786,25174,0,0,66,66,0,1,0,1,0,1
57303,53,43423,53,177,94,83,2,30,1,1,0
64580,53,23762,53,199,102,97,2,30,1,1,0
53524,45395,6631,45395,70,70,0,2,8,2,0,0
52179,14354,22942,14354,70,70,0,1,5,1,0,0
58554,443,5045,443,8626,2156,6470,24,81,14,10,0
6661,23,0,0,60,60,0,1,0,1,0,1
56163,53,27486,53,188,96,92,2,31,1,1,0
55205,53,45357,53,167,86,81,2,29,1,1,0
56313,53,7170,53,198,102,96,2,29,1,1,0
50946,44847,0,0,62,62,0,1,0,1,0,1
53191,445,0,0,70,70,0,1,0,1,0,2
56066,53,20182,53,212,110,102,2,30,1,1,0
55504,445,0,0,70,70,0,1,0,1,0,2
20706,23718,0,0,66,66,0,1,0,1,0,1
62039,443,46235,443,356,60,296,6,18,2,4,0
57411,53,38630,53,711,87,624,2,31,1,1,0
27005,27015,35363,27015,884,126,758,2,31,1,1,0
57202,53,37225,53,184,94,90,2,29,1,1,0
58784,445,0,0,66,66,0,1,0,1,0,2
46838,80,4801,80,70,70,0,1,120,1,0,0
64483,53,3911,53,168,86,82,2,30,1,1,0
58699,445,0,0,70,70,0,1,0,1,0,2
50950,80,33535,80,942,527,415,11,342,6,5,0
42804,80,7713,80,1115,534,581,12,15,7,5,0
51295,445,0,0,70,70,0,1,0,1,0,2
59262,5228,3053,5228,7054,2076,4978,32,5115,11,21,0
49756,80,38066,80,20926,3231,17695,37,51,17,20,0
64095,53,40106,53,177,94,83,2,30,1,1,0
35111,22114,0,0,66,66,0,1,0,1,0,1
63213,15503,0,0,66,66,0,1,0,1,0,1
54473,37807,0,0,66,66,0,1,0,1,0,1
37142,443,20503,443,17201,10578,6623,57,145,27,30,0
53235,443,2490,443,11111,1014,10097,24,37,10,14,0
62029,22114,0,0,66,66,0,1,0,1,0,1
52739,445,0,0,70,70,0,1,0,1,0,2
50474,443,49167,443,17449456,390704,17058752,16816,383,4917,11899,0
60438,17148,53794,17148,70,70,0,2,8,2,0,0
55438,443,39653,443,6686,923,5763,19,15,11,8,0
40078,44847,0,0,62,62,0,1,0,1,0,1
60779,40010,64094,40010,316,136,180,6,5,3,3,0
55991,445,0,0,66,66,0,1,0,1,0,2
50307,80,42606,80,3179,863,2316,13,57,7,6,0
56499,80,63072,80,277848,13775,264073,301,63,118,183,0
57804,445,0,0,66,66,0,1,0,1,0,2
0,0,0,0,185,185,0,1,0,1,0,1
37028,51505,0,0,62,62,0,1,0,1,0,1
49906,443,34595,443,159116,5586,153530,191,47,77,114,0
56688,443,37544,443,32780,6864,25916,142,345,57,85,0
51120,443,19662,443,2940,787,2153,11,119,5,6,0
64902,53,48255,53,762,98,664,2,30,1,1,0
18517,31652,0,0,62,62,0,1,0,1,0,3
56685,443,20018,443,7855,1866,5989,20,15,11,9,0
40599,443,12842,443,89724,81316,8408,148,404,69,79,0
64679,53,60915,53,178,94,84,2,30,1,1,0
52712,80,52712,80,2012,1423,589,12,48,6,6,0
50606,80,30995,80,83795,22317,61478,117,43,52,65,0
64128,53,50271,53,606,182,424,6,71,3,3,0
34212,11392,0,0,62,62,0,1,0,1,0,1
61230,445,0,0,70,70,0,1,0,1,0,2
56335,53,48756,53,816,102,714,2,30,1,1,0
52827,445,0,0,70,70,0,1,0,1,0,2
65156,445,0,0,70,70,0,1,0,1,0,2
49310,445,0,0,70,70,0,1,0,1,0,2
52370,443,22287,443,7058,2421,4637,21,17,11,10,0
64381,53,50743,53,198,102,96,2,31,1,1,0
49840,445,0,0,66,66,0,1,0,1,0,2
55719,8060,30409,8060,70,70,0,2,7,2,0,0
56469,53,24320,53,177,94,83,2,30,1,1,0
57255,443,56046,443,36865,3692,33173,61,47,30,31,0
58046,443,22923,443,1536,1089,447,11,56,7,4,0
38733,443,28389,443,9058,1542,7516,25,50,13,12,0
42745,50011,0,0,62,62,0,1,0,1,0,1
6886,55839,0,0,139,139,0,1,0,1,0,1
60084,445,0,0,70,70,0,1,0,1,0,2
56911,445,0,0,70,70,0,1,0,1,0,2
26900,27017,64029,27017,422,164,258,6,30,3,3,0
57208,53,63369,53,182,93,89,2,31,1,1,0
48070,53,48070,53,197,90,107,2,30,1,1,0
64908,445,0,0,66,66,0,1,0,1,0,2
59988,64147,0,0,66,66,0,1,0,1,0,1
52469,445,0,0,66,66,0,1,0,1,0,2
18657,53,18657,53,295,90,205,2,29,1,1,0
20898,53,20898,53,233,90,143,2,32,1,1,0
56672,445,0,0,70,70,0,1,0,1,0,2
49183,53,53469,53,194,102,92,2,30,1,1,0
50633,80,7997,80,1717,1247,470,9,15,5,4,0
43580,57470,0,0,145,145,0,1,0,1,0,1
55491,445,0,0,70,70,0,1,0,1,0,2
10151,22208,55626,22208,323,150,173,2,1203,1,1,0
18889,50584,0,0,146,146,0,1,0,1,0,1
19623,25174,0,0,62,62,0,1,0,1,0,1
7810,25174,0,0,62,62,0,1,0,1,0,1
51897,445,0,0,66,66,0,1,0,1,0,2
55346,53,62620,53,177,94,83,2,31,1,1,0
5588,5588,0,0,3354,1792,1562,46,194,23,23,0
62980,445,0,0,70,70,0,1,0,1,0,2
53887,443,39424,443,499,425,74,4,0,3,1,0
50895,445,0,0,66,66,0,1,0,1,0,2
55564,53,50276,53,775,103,672,2,30,1,1,0
56236,445,0,0,70,70,0,1,0,1,0,2
54924,443,37000,443,62,62,0,1,4,1,0,0
56515,53,36823,53,177,94,83,2,30,1,1,0
64627,445,0,0,70,70,0,1,0,1,0,2
45941,23386,0,0,60,60,0,1,0,1,0,1
53249,443,53249,443,1404,697,707,17,121,8,9,0
40363,80,1315,80,3566,1637,1929,18,81,11,7,0
6881,59353,0,0,146,146,0,1,0,1,0,1
49675,53,53697,53,199,102,97,2,30,1,1,0
59758,443,17824,443,4114,2557,1557,22,418,9,13,0
61643,22114,0,0,62,62,0,1,0,1,0,1
59168,39004,0,0,62,62,0,1,0,1,0,1
49224,53,60967,53,177,94,83,2,30,1,1,0
52019,80,54297,80,426,240,186,8,24,5,3,0
61696,445,0,0,70,70,0,1,0,1,0,2
58638,5900,0,0,62,62,0,1,0,1,0,1
9257,443,25692,443,6327,833,5494,19,26,10,9,0
62812,445,0,0,70,70,0,1,0,1,0,2
49418,27015,35776,27015,78,78,0,1,29,1,0,0
35921,443,5709,443,5207,1058,4149,21,150,12,9,0
49706,443,36455,443,32941,1850,31091,46,131,19,27,0
64716,445,0,0,66,66,0,1,0,1,0,2
36452,53,36452,53,226,106,120,2,29,1,1,0
55524,53,46955,53,413,170,243,6,30,3,3,0
54787,445,0,0,70,70,0,1,0,1,0,2
58638,5900,0,0,62,62,0,1,0,1,0,1
64279,445,0,0,70,70,0,1,0,1,0,2
55367,53,11900,53,195,102,93,2,30,1,1,0
15854,50584,0,0,62,62,0,1,0,1,0,1
49650,53,11402,53,216,110,106,2,30,1,1,0
56258,445,0,0,66,66,0,1,0,1,0,2
64493,53,5722,53,353,101,252,4,54,2,2,0
50194,445,0,0,70,70,0,1,0,1,0,2
11574,51505,0,0,66,66,0,1,0,1,0,1
55489,53,34902,53,748,106,642,2,31,1,1,0
57550,50584,0,0,66,66,0,1,0,1,0,1
51339,50584,0,0,62,62,0,1,0,1,0,1
63857,445,0,0,70,70,0,1,0,1,0,2
65219,53,39844,53,410,99,311,4,56,2,2,0
49297,80,62329,80,16249,1328,14921,28,45,14,14,0
58481,15503,0,0,146,146,0,1,0,1,0,1
45268,443,29338,443,7503,2345,5158,34,256,17,17,0
64763,53,14685,53,214,110,104,2,30,1,1,0
56658,53,20785,53,177,94,83,2,29,1,1,0
60413,445,0,0,70,70,0,1,0,1,0,2
59072,445,0,0,66,66,0,1,0,1,0,2
65518,445,0,0,66,66,0,1,0,1,0,2
49418,27016,50703,27016,258,78,180,2,31,1,1,0
65238,53,13271,53,86,86,0,1,30,1,0,0
53278,445,0,0,70,70,0,1,0,1,0,2
57545,445,0,0,66,66,0,1,0,1,0,2
56026,53,37730,53,181,94,87,2,31,1,1,0
56942,443,61847,443,494,420,74,4,0,3,1,0
64979,53,4667,53,194,102,92,2,31,1,1,0
63961,51641,64148,51641,504,382,122,8,16,6,2,0
50458,445,0,0,70,70,0,1,0,1,0,2
33814,22114,0,0,62,62,0,1,0,1,0,1
35828,8970,0,0,146,146,0,1,0,1,0,3
58787,23,0,0,60,60,0,1,0,1,0,1
6882,16276,42707,16276,150,150,0,1,1200,1,0,0
0,0,0,0,2000,1020,980,20,0,10,10,0
62049,443,63135,443,9526,1375,8151,24,125,12,12,0
49914,443,22293,443,12190,2075,10115,28,16,14,14,0
50309,445,0,0,70,70,0,1,0,1,0,2
40408,1488,40408,1488,156,156,0,3,8,3,0,0
26400,44847,0,0,146,146,0,1,0,1,0,1
51948,37965,0,0,62,62,0,1,0,1,0,1
59464,443,49741,443,7333,1933,5400,27,16,15,12,0
56838,53,18546,53,177,94,83,2,29,1,1,0
52191,32843,25090,32843,70,70,0,2,8,2,0,0
61130,445,0,0,66,66,0,1,0,1,0,2
23528,44847,0,0,146,146,0,1,0,1,0,1
52144,15208,55499,15208,70,70,0,1,5,1,0,0
59748,443,39145,443,8789,1592,7197,25,75,13,12,0
1025,35447,0,0,62,62,0,1,0,1,0,1
50584,16526,25996,16526,166,166,0,1,1199,1,0,0
16454,25174,0,0,62,62,0,1,0,1,0,1
27947,26467,0,0,62,62,0,1,0,1,0,1
55619,53,44719,53,183,94,89,2,29,1,1,0
64719,53,59437,53,192,98,94,2,30,1,1,0
56215,53,24448,53,216,110,106,2,30,1,1,0
64803,53,39873,53,102,102,0,1,30,1,0,0
59513,445,0,0,66,66,0,1,0,1,0,2
46604,57866,0,0,66,66,0,1,0,1,0,1
2267,53,17239,53,204,118,86,2,31,1,1,0
45439,443,28530,443,24785,17234,7551,68,421,36,32,0
49589,53,21247,53,198,94,104,2,30,1,1,0
53119,53,39459,53,326,102,224,2,29,1,1,0
10797,50584,0,0,62,62,0,1,0,1,0,1
58049,50265,0,0,145,145,0,1,0,1,0,1
26763,443,27928,443,7343,2586,4757,23,20,11,12,0
40471,53,40471,53,194,87,107,2,31,1,1,0
64854,53,60425,53,178,94,84,2,30,1,1,0
49333,443,11751,443,30571,1990,28581,53,80,21,32,0
64966,53,61255,53,347,100,247,4,49,2,2,0
60215,80,6497,80,21073,15881,5192,47,151,30,17,0
25150,25174,0,0,62,62,0,1,0,1,0,1
51222,35440,0,0,66,66,0,1,0,1,0,1
1024,37450,0,0,62,62,0,1,0,1,0,1
63068,445,0,0,70,70,0,1,0,1,0,2
50057,53,37422,53,177,94,83,2,30,1,1,0
56955,53,64522,53,183,94,89,2,30,1,1,0
46544,443,31614,443,332590,15084,317506,341,139,89,252,0
49781,53,31272,53,194,102,92,2,29,1,1,0
56963,445,0,0,66,66,0,1,0,1,0,2
65346,53,45745,53,182,93,89,2,31,1,1,0
3093,62413,0,0,62,62,0,1,0,1,0,1
52254,445,0,0,70,70,0,1,0,1,0,2
50023,53,38403,53,164,84,80,2,31,1,1,0
0,0,0,0,70,70,0,1,0,1,0,1
27005,27027,32399,27027,880,126,754,2,31,1,1,0
443,54507,0,0,82,82,0,1,0,1,0,1
54956,445,0,0,70,70,0,1,0,1,0,2
50990,53,51984,53,232,94,138,2,29,1,1,0
53115,443,63976,443,9616,6956,2660,39,47,21,18,0
60948,53,22265,53,168,78,90,2,30,1,1,0
49418,27017,55350,27017,275,71,204,2,31,1,1,0
56957,443,26018,443,4359,924,3435,15,59,9,6,0
49837,443,55049,443,4685,2421,2264,10,119,5,5,0
37330,53,37330,53,237,91,146,2,31,1,1,0
56588,53,38290,53,305,99,206,4,49,2,2,0
4706,36237,0,0,146,146,0,1,0,1,0,1
49209,52030,40486,52030,70,70,0,2,8,2,0,0
60102,445,0,0,70,70,0,1,0,1,0,2
57470,1073,4669,1073,402,132,270,6,1209,3,3,0
4138,55777,0,0,66,66,0,1,0,1,0,1
50977,56205,0,0,66,66,0,1,0,1,0,1
63213,15503,0,0,62,62,0,1,0,1,0,1
49909,445,0,0,70,70,0,1,0,1,0,1
56748,443,11472,443,8007,1987,6020,20,15,11,9,0
45941,23386,0,0,60,60,0,1,0,1,0,1
65450,53,49502,53,336,110,226,2,30,1,1,0
55915,53,47313,53,86,86,0,1,30,1,0,0
58009,80,11441,80,495,192,303,6,21,4,2,0
54325,445,0,0,66,66,0,1,0,1,0,2
49865,443,26140,443,5708,1025,4683,16,35,9,7,0
51704,9266,12391,9266,66,66,0,1,5,1,0,0
52888,445,0,0,70,70,0,1,0,1,0,2
56534,443,29507,443,265430,17951,247479,305,105,122,183,0
64936,53,3056,53,193,102,91,2,30,1,1,0
51909,33509,56937,33509,70,70,0,1,5,1,0,0
51046,25174,0,0,62,62,0,1,0,1,0,1
64643,53,62127,53,177,94,83,2,30,1,1,0
57275,53,22195,53,199,102,97,2,31,1,1,0
50330,443,24584,443,9585,2138,7447,26,82,13,13,0
64309,53,10386,53,308,94,214,2,30,1,1,0
64290,53,18678,53,196,102,94,2,31,1,1,0
56214,445,0,0,66,66,0,1,0,1,0,2
43332,81,0,0,60,60,0,1,0,1,0,1
49884,53,8513,53,252,102,150,2,30,1,1,0
58751,9571,0,0,62,62,0,1,0,1,0,1
48676,53395,0,0,60,60,0,1,0,1,0,1
34698,443,50104,443,16164,3053,13111,31,18,16,15,0
6881,25649,11591,25649,509,150,359,2,1200,1,1,0
51808,46390,6189,46390,70,70,0,2,8,2,0,0
49292,53,63112,53,323,94,229,2,31,1,1,0
52662,445,0,0,70,70,0,1,0,1,0,2
55024,53,31814,53,179,94,85,2,30,1,1,0
17146,57470,0,0,62,62,0,1,0,1,0,1
57277,445,0,0,66,66,0,1,0,1,0,2
65373,443,38852,443,3104883,106687,2998196,3406,190,1320,2086,0
57322,53,53567,53,196,102,94,2,29,1,1,0
50290,445,0,0,66,66,0,1,0,1,0,2
51726,64147,0,0,66,66,0,1,0,1,0,1
9329,443,17986,443,3255,430,2825,11,15,6,5,0
65113,53,56187,53,232,102,130,2,29,1,1,0
49539,53,64502,53,340,87,253,4,50,2,2,0
58638,5900,0,0,62,62,0,1,0,1,0,1
65522,445,0,0,66,66,0,1,0,1,0,2
49210,33757,53103,33757,70,70,0,2,8,2,0,0
50321,23684,0,0,143,143,0,1,0,1,0,1
51374,30317,0,0,66,66,0,1,0,1,0,1
55842,445,0,0,70,70,0,1,0,1,0,2
62295,445,0,0,66,66,0,1,0,1,0,2
53071,25174,0,0,66,66,0,1,0,1,0,1
52143,80,6472,80,366,240,126,7,32,5,2,0
52749,64147,0,0,66,66,0,1,0,1,0,1
49520,53,55540,53,229,102,127,2,30,1,1,0
53853,39723,8770,39723,1890,1010,880,13,16,8,5,0
65087,53,28763,53,229,94,135,2,30,1,1,0
64469,445,0,0,70,70,0,1,0,1,0,2
63691,53,63691,53,198,90,108,2,30,1,1,0
55273,53,2212,53,168,78,90,2,30,1,1,0
65063,53,52560,53,180,94,86,2,30,1,1,0
52994,445,0,0,70,70,0,1,0,1,0,2
55272,53,40097,53,599,198,401,6,50,3,3,0
55208,443,24176,443,7224,114,7110,9,122,2,7,0
57131,26296,0,0,145,145,0,1,0,1,0,1
58472,53,5380,53,86,86,0,1,30,1,0,0
38053,50584,0,0,62,62,0,1,0,1,0,1
62329,53,9486,53,268,86,182,2,30,1,1,0
26180,53,26180,53,245,98,147,2,30,1,1,0
63429,445,0,0,70,70,0,1,0,1,0,2
32299,40021,3069,40021,148,86,62,2,31,1,1,0
55621,53,47829,53,453,186,267,6,30,3,3,0
2697,28189,0,0,60,60,0,1,0,1,0,1
56905,53,61024,53,239,110,129,2,30,1,1,0
58638,5900,0,0,62,62,0,1,0,1,0,1
55012,53,50167,53,275,110,165,2,30,1,1,0
55555,53,26797,53,194,102,92,2,30,1,1,0
49429,53,29436,53,188,96,92,2,31,1,1,0
49912,80,32939,80,1590,858,732,10,110,6,4,0
55302,445,0,0,70,70,0,1,0,1,0,2
57898,443,41076,443,240332,6623,233709,258,170,92,166,0
51183,56205,0,0,66,66,0,1,0,1,0,1
58131,3855,0,0,146,146,0,1,0,1,0,1
16403,16385,45121,16385,182,62,120,4,30,2,2,0
56293,53,53658,53,166,86,80,2,30,1,1,0
33768,53,59037,53,168,78,90,2,29,1,1,0
56622,53,51149,53,757,98,659,2,31,1,1,0
58838,443,31088,443,5167,700,4467,16,15,7,9,0
56840,445,0,0,66,66,0,1,0,1,0,2
49980,53,26131,53,152,78,74,2,30,1,1,0
49688,445,0,0,70,70,0,1,0,1,0,2
61682,445,0,0,70,70,0,1,0,1,0,2
28176,35440,0,0,146,146,0,1,0,1,0,1
53979,443,21511,443,3566,871,2695,11,120,5,6,0
54866,37965,0,0,62,62,0,1,0,1,0,1
37708,443,23854,443,8604,2228,6376,36,739,19,17,0
60913,443,14058,443,18805,1162,17643,28,135,11,17,0
35261,15503,0,0,74,74,0,1,0,1,0,1
54379,80,23086,80,1466,729,737,12,16,7,5,0
57059,445,0,0,70,70,0,1,0,1,0,2
49159,53,33263,53,733,86,647,2,31,1,1,0
56167,53,4828,53,178,94,84,2,30,1,1,0
55049,445,0,0,70,70,0,1,0,1,0,2
61415,443,64279,443,6143,1796,4347,21,21,11,10,0
6881,49001,20436,49001,210,111,99,2,1201,1,1,0
56770,443,61506,443,5829,2962,2867,35,89,17,18,0
51759,445,0,0,70,70,0,1,0,1,0,2
55655,53,10525,53,304,110,194,4,34,2,2,0
53904,443,54254,443,495,421,74,4,0,3,1,0
50941,445,0,0,70,70,0,1,0,1,0,2
52013,35185,29346,35185,66,66,0,1,5,1,0,0
37716,443,28375,443,14009,10561,3448,30,135,16,14,0
55685,445,0,0,70,70,0,1,0,1,0,2
50865,445,0,0,66,66,0,1,0,1,0,2
55040,443,51805,443,36648,3634,33014,51,62,23,28,0
54800,443,18015,443,18814,10011,8803,42,129,21,21,0
57470,6881,1701,6881,453,251,202,4,1199,2,2,0
57152,53,41610,53,733,94,639,2,30,1,1,0
51715,80,53478,80,3309,2152,1157,18,150,10,8,0
49514,65504,0,0,162,162,0,1,0,1,0,1
49172,53,13814,53,305,94,211,2,30,1,1,0
57737,53,57737,53,374,240,134,3,32,2,1,0
42469,30188,0,0,62,62,0,1,0,1,0,1
27005,27015,64415,27015,875,126,749,2,30,1,1,0
49954,445,0,0,66,66,0,1,0,1,0,2
51051,443,1978,443,7712,2203,5509,24,516,14,10,0
53156,35993,0,0,66,66,0,1,0,1,0,1
49901,7000,49901,7000,3310,1535,1775,15,15,8,7,0
64644,53,30010,53,364,89,275,4,33,2,2,0
57594,445,0,0,70,70,0,1,0,1,0,2
64689,53,34039,53,183,94,89,2,30,1,1,0
57157,443,64238,443,1647,1375,272,9,48,5,4,0
64793,80,12166,80,508,256,252,9,77,5,4,0
62645,445,0,0,70,70,0,1,0,1,0,2
55464,53,43920,53,216,94,122,2,30,1,1,0
22783,64147,0,0,66,66,0,1,0,1,0,1
65049,53,32515,53,204,104,100,2,31,1,1,0
60560,445,0,0,70,70,0,1,0,1,0,2
51183,445,0,0,66,66,0,1,0,1,0,2
56404,445,0,0,66,66,0,1,0,1,0,2
52202,64241,19062,64241,250,66,184,4,9,2,2,0
37965,51498,7708,51498,158,158,0,1,1199,1,0,0
60698,445,0,0,66,66,0,1,0,1,0,2
11821,64147,0,0,62,62,0,1,0,1,0,1
62349,443,37822,443,3942042,47512,3894530,3167,53,526,2641,0
61550,5529,0,0,145,145,0,1,0,1,0,1
52103,53733,0,0,66,66,0,1,0,1,0,1
59956,25,59956,25,1867,743,1124,24,16,11,13,0
14023,37965,0,0,62,62,0,1,0,1,0,1
58470,445,0,0,70,70,0,1,0,1,0,2
22240,22114,0,0,62,62,0,1,0,1,0,1
18739,23,0,0,60,60,0,1,0,1,0,1
55159,53,25315,53,199,102,97,2,29,1,1,0
60755,443,57914,443,61151,2474,58677,61,25,16,45,0
47652,51505,0,0,62,62,0,1,0,1,0,1
32939,443,44702,443,3312,1936,1376,19,29,10,9,0
50684,80,50889,80,1658,1247,411,8,15,5,3,0
52282,445,0,0,66,66,0,1,0,1,0,2
35136,443,3606,443,25542,17843,7699,58,59,34,24,0
62364,445,0,0,70,70,0,1,0,1,0,2
64958,445,0,0,66,66,0,1,0,1,0,2
50827,443,49837,443,7298,2661,4637,21,17,11,10,0
55179,80,55179,80,374,240,134,7,15,5,2,0
61361,443,55767,443,9604,5021,4583,29,86,15,14,0
55060,53,16844,53,195,102,93,2,30,1,1,0
44169,443,53615,443,12098,5328,6770,25,121,12,13,0
62188,443,50318,443,6973,2413,4560,22,148,11,11,0
61184,445,0,0,70,70,0,1,0,1,0,2
11136,19910,0,0,62,62,0,1,0,1,0,1
49597,53,63650,53,168,86,82,2,31,1,1,0
49791,53,6212,53,777,87,690,2,30,1,1,0
58138,445,0,0,70,70,0,1,0,1,0,2
55554,22114,0,0,62,62,0,1,0,1,0,1
50425,443,34304,443,5653,1079,4574,14,26,8,6,0
64296,53,31060,53,215,94,121,2,29,1,1,0
50520,53,46734,53,732,86,646,2,30,1,1,0
39053,443,36119,443,6699,4494,2205,27,29,14,13,0
55934,53,17194,53,182,102,80,2,30,1,1,0
55752,443,54224,443,11823,4029,7794,25,143,12,13,0
60911,443,41186,443,3862,2679,1183,28,46,15,13,0
8211,28793,0,0,66,66,0,1,0,1,0,1
48347,443,29830,443,8415,883,7532,23,54,8,15,0
48557,37965,0,0,62,62,0,1,0,1,0,1
55615,13826,16730,13826,70,70,0,1,5,1,0,0
50700,80,14024,80,648,256,392,8,27,5,3,0
50040,53,62872,53,322,102,220,2,30,1,1,0
47783,50432,0,0,62,62,0,1,0,1,0,1
56810,443,52495,443,8072,2052,6020,20,16,11,9,0
62912,53,42026,53,214,76,138,2,30,1,1,0
54063,80,60737,80,2545,515,2030,12,17,6,6,0
63978,53,35344,53,214,110,104,2,30,1,1,0
55390,443,55390,443,164571,13257,151314,206,19,95,111,0
64568,443,63585,443,25404,2462,22942,47,32,25,22,0
6882,24271,34047,24271,228,118,110,2,1200,1,1,0
51709,445,0,0,70,70,0,1,0,1,0,2
64485,53,11274,53,183,94,89,2,30,1,1,0
65529,35440,0,0,62,62,0,1,0,1,0,1
30960,45742,3769,45742,330,330,0,6,3609,6,0,0
56668,53,7163,53,199,102,97,2,30,1,1,0
56532,443,17749,443,8381,2848,5533,26,572,14,12,0
39895,26467,0,0,62,62,0,1,0,1,0,1
64856,53,10911,53,755,93,662,2,31,1,1,0
55803,53,18638,53,261,89,172,4,32,2,2,0
9180,443,3139,443,5731,495,5236,14,15,7,7,0
55854,443,29147,443,3387,1672,1715,24,270,11,13,0
34044,161,0,0,18549,5061,13488,54,30,27,27,0
60250,443,56947,443,12389,5180,7209,31,149,17,14,0
57248,443,46396,443,4113,1387,2726,15,36,8,7,0
38629,443,15765,443,9198,2279,6919,18,18,9,9,0
53403,445,0,0,70,70,0,1,0,1,0,2
65278,53,33473,53,403,91,312,4,34,2,2,0
59435,37807,0,0,66,66,0,1,0,1,0,1
56627,443,41594,443,4499,947,3552,14,25,8,6,0
60381,26312,40513,26312,70,70,0,1,5,1,0,0
45690,60038,0,0,62,62,0,1,0,1,0,3
49383,53,63729,53,226,110,116,2,30,1,1,0
48865,443,7956,443,12824,2604,10220,46,255,20,26,0
57983,443,38369,443,7966,3102,4864,18,75,10,8,0
57396,443,49419,443,362,302,60,2,5,1,1,0
53024,57866,0,0,146,146,0,1,0,1,0,1
54470,443,54470,443,101021,6173,94848,142,18,65,77,0
49874,80,9513,80,9921,2945,6976,19,88,8,11,0
49930,443,24713,443,16631,7072,9559,50,134,29,21,0
44173,53,9700,53,168,78,90,2,30,1,1,0
50900,80,42676,80,26867,2743,24124,45,140,23,22,0
9518,443,46388,443,3613,433,3180,11,16,6,5,0
49160,28890,3522,28890,830,150,680,4,1200,2,2,0
54194,443,16208,443,499,425,74,4,0,3,1,0
64568,53,24682,53,388,134,254,2,30,1,1,0
55581,53,6182,53,166,85,81,2,30,1,1,0
52903,445,0,0,70,70,0,1,0,1,0,2
56166,53,15904,53,186,95,91,2,30,1,1,0
50551,80,50551,80,4780,1925,2855,16,22,8,8,0
20400,64147,0,0,62,62,0,1,0,1,0,1
10533,23,0,0,60,60,0,1,0,1,0,1
64697,53,13382,53,199,102,97,2,30,1,1,0
60207,80,10851,80,3596,2562,1034,14,151,8,6,0
64621,53,62273,53,214,102,112,2,30,1,1,0
65479,53,45836,53,728,102,626,2,29,1,1,0
55560,445,0,0,70,70,0,1,0,1,0,2
63200,445,0,0,66,66,0,1,0,1,0,2
443,51550,0,0,100,100,0,1,0,1,0,1
60404,37869,1264,37869,164,70,94,2,5,1,1,0
49723,443,17483,443,11181,3795,7386,50,20,23,27,0
55190,443,14814,443,12801,4250,8551,40,118,21,19,0
65097,53,14229,53,718,94,624,2,30,1,1,0
52431,50265,0,0,62,62,0,1,0,1,0,1
55463,445,0,0,70,70,0,1,0,1,0,2
58621,53,5007,53,256,94,162,2,29,1,1,0
64475,53,56537,53,184,94,90,2,30,1,1,0
55674,48870,19113,48870,70,70,0,2,8,2,0,0
65239,53,27517,53,199,102,97,2,30,1,1,0
52830,443,59305,443,12577,3687,8890,63,415,30,33,0
38114,443,10061,443,863998,37140,826858,1072,61,479,593,0
13159,37965,0,0,66,66,0,1,0,1,0,1
64314,445,0,0,70,70,0,1,0,1,0,2
42252,33303,0,0,60,60,0,1,0,1,0,1
56387,53,9036,53,182,93,89,2,31,1,1,0
54678,443,37690,443,84066,79714,4352,98,125,66,32,0
64733,445,0,0,70,70,0,1,0,1,0,2
63859,80,37247,80,314,192,122,6,15,4,2,0
55962,53,37019,53,193,102,91,2,30,1,1,0
59996,443,60855,443,1641,730,911,14,18,8,6,0
51622,445,0,0,66,66,0,1,0,1,0,2
48388,44847,0,0,62,62,0,1,0,1,0,1
40116,23,0,0,60,60,0,1,0,1,0,1
51946,9407,60623,9407,70,70,0,1,4,1,0,0
65058,53,6038,53,249,94,155,2,30,1,1,0
64833,53,41021,53,167,86,81,2,31,1,1,0
57127,53,41835,53,195,102,93,2,30,1,1,0
53385,445,0,0,70,70,0,1,0,1,0,2
58345,123,37586,123,184,94,90,2,30,1,1,0
59165,53,3627,53,320,94,226,2,30,1,1,0
56697,53,16898,53,198,102,96,2,29,1,1,0
59569,445,0,0,66,66,0,1,0,1,0,2
10001,40041,23223,40041,151,89,62,2,30,1,1,0
10427,32480,0,0,62,62,0,1,0,1,0,1
65530,53,20818,53,166,85,81,2,30,1,1,0
53601,30160,44927,30160,70,70,0,2,8,2,0,0
50584,6881,12157,6881,166,166,0,1,1200,1,0,0
53765,16178,2985,16178,70,70,0,1,5,1,0,0
40988,80,28753,80,19112,2192,16920,46,90,23,23,0
57335,443,6083,443,4048,3089,959,24,15,13,11,0
55836,53,6468,53,177,94,83,2,30,1,1,0
36017,443,12463,443,4883,3524,1359,20,200,11,9,0
59235,52700,0,0,145,145,0,1,0,1,0,1
46384,443,46384,443,4594,1687,2907,19,30,11,8,0
56592,53,24895,53,200,102,98,2,30,1,1,0
34672,53,34672,53,213,87,126,2,30,1,1,0
49757,80,22692,80,1396,864,532,9,15,5,4,0
54830,445,0,0,70,70,0,1,0,1,0,2
61287,445,0,0,66,66,0,1,0,1,0,2
54761,443,53919,443,103367,3730,99637,117,170,42,75,0
27005,27016,11653,27016,876,126,750,3,31,2,1,0
29989,26467,0,0,66,66,0,1,0,1,0,1
63962,53,22978,53,274,93,181,4,64,2,2,0
28999,37807,0,0,62,62,0,1,0,1,0,1
45184,5228,38008,5228,9107,2358,6749,24,3600,13,11,0
57918,445,0,0,66,66,0,1,0,1,0,2
42153,443,25509,443,12306,2097,10209,31,360,15,16,0
65435,80,40330,80,11239,7307,3932,19,25,10,9,0
58701,27030,9286,27030,70,70,0,1,5,1,0,0
26900,27017,63924,27017,422,164,258,6,30,3,3,0
43659,443,24456,443,17592,11518,6074,51,248,26,25,0
57366,53,36112,53,711,87,624,2,31,1,1,0
50365,445,0,0,66,66,0,1,0,1,0,2
54007,445,0,0,70,70,0,1,0,1,0,2
55547,445,0,0,70,70,0,1,0,1,0,2
56600,445,0,0,66,66,0,1,0,1,0,2
65064,30188,0,0,66,66,0,1,0,1,0,1
50895,443,61149,443,130,70,60,3,5,2,1,0
63777,445,0,0,66,66,0,1,0,1,0,2
993,3979,0,0,129,129,0,1,0,1,0,1
38888,22,38888,22,5130,2103,3027,28,25,16,12,0
55742,53,55832,53,193,102,91,2,30,1,1,0
57215,53,55858,53,810,108,702,2,30,1,1,0
49650,53,42506,53,248,110,138,2,30,1,1,0
58638,5900,0,0,62,62,0,1,0,1,0,1
15530,49718,0,0,146,146,0,1,0,1,0,1
22094,23,0,0,60,60,0,1,0,1,0,1
56374,53,38425,53,770,102,668,2,31,1,1,0
11842,35440,0,0,62,62,0,1,0,1,0,1
53892,443,40316,443,9312,4088,5224,23,76,13,10,0
56494,1,0,0,146,146,0,1,0,1,0,1
61891,445,0,0,70,70,0,1,0,1,0,2
3377,50584,0,0,66,66,0,1,0,1,0,1
54679,445,0,0,70,70,0,1,0,1,0,2
52694,443,37161,443,10384,4563,5821,34,436,17,17,0
64683,53,49305,53,821,102,719,2,29,1,1,0
61074,445,0,0,70,70,0,1,0,1,0,2
55611,58049,54667,58049,504,318,186,8,15,5,3,0
52354,445,0,0,70,70,0,1,0,1,0,2
55548,53,39542,53,197,102,95,2,35,1,1,0
56763,27734,6083,27734,70,70,0,1,5,1,0,0
41906,80,41906,80,127215,3221,123994,137,3685,42,95,0
55638,32765,61121,32765,564,318,246,9,15,5,4,0
60759,40010,60253,40010,316,136,180,6,7,3,3,0
29742,50584,0,0,146,146,0,1,0,1,0,1
8889,25033,0,0,60,60,0,1,0,1,0,1
50941,443,22406,443,12831,2277,10554,37,145,17,20,0
54079,443,34399,443,6931,1974,4957,24,342,11,13,0
64874,445,0,0,66,66,0,1,0,1,0,2
58502,445,0,0,70,70,0,1,0,1,0,2
10082,64147,0,0,62,62,0,1,0,1,0,1
50637,44847,0,0,66,66,0,1,0,1,0,1
49246,53,4565,53,177,94,83,2,30,1,1,0
57592,80,57592,80,3118,689,2429,13,144,6,7,0
39385,443,14896,443,89229,6918,82311,131,33,63,68,0
49274,445,0,0,66,66,0,1,0,1,0,2
55547,445,0,0,70,70,0,1,0,1,0,2
58638,5900,0,0,62,62,0,1,0,1,0,1
60059,445,0,0,66,66,0,1,0,1,0,2
2572,17546,0,0,66,66,0,1,0,1,0,1
52782,445,0,0,66,66,0,1,0,1,0,2
63893,443,26379,443,3071,804,2267,15,135,7,8,0
55577,53,20988,53,199,102,97,2,30,1,1,0
49501,53,50847,53,193,102,91,2,31,1,1,0
7288,25174,0,0,62,62,0,1,0,1,0,1
55503,53,12220,53,200,102,98,2,30,1,1,0
65344,53,52002,53,190,90,100,3,60,2,1,0
53737,443,15661,443,499,425,74,4,0,3,1,0
58638,5900,0,0,62,62,0,1,0,1,0,1
57245,443,39703,443,170452,9659,160793,224,68,97,127,0
42770,443,4955,443,8820,2996,5824,27,95,14,13,0
46567,443,52746,443,6407,984,5423,21,360,11,10,0
16221,50584,0,0,62,62,0,1,0,1,0,1
55010,445,0,0,70,70,0,1,0,1,0,2
56103,443,24314,443,22293,16437,5856,51,30,27,24,0
56186,445,0,0,70,70,0,1,0,1,0,2
60645,35440,0,0,66,66,0,1,0,1,0,1
40501,443,64068,443,6517,1812,4705,21,255,11,10,0
26782,443,49572,443,7407,2650,4757,24,20,12,12,0
4328,7302,0,0,66,66,0,1,0,1,0,1
443,18411,0,0,74,74,0,1,0,1,0,1
60950,443,63675,443,7431,2753,4678,40,18,21,19,0
443,62451,0,0,199,199,0,1,0,1,0,1
50699,80,28391,80,54318,27824,26494,227,174,113,114,0
60292,7129,0,0,62,62,0,1,0,1,0,1
56649,443,46574,443,4628,1035,3593,19,25,11,8,0
63171,445,0,0,70,70,0,1,0,1,0,2
55513,53,52238,53,184,94,90,2,29,1,1,0
34440,53,34440,53,235,90,145,2,32,1,1,0
56009,53,53982,53,178,94,84,2,30,1,1,0
25570,35440,0,0,146,146,0,1,0,1,0,1
50424,55777,0,0,62,62,0,1,0,1,0,1
44368,443,44368,443,7123,1020,6103,19,151,11,8,0
62912,26467,0,0,62,62,0,1,0,1,0,1
55372,53,64639,53,271,93,178,4,43,2,2,0
58352,445,0,0,70,70,0,1,0,1,0,2
8889,10794,0,0,60,60,0,1,0,1,0,1
52996,445,0,0,70,70,0,1,0,1,0,2
50779,443,64325,443,3247,1630,1617,8,120,4,4,0
51717,445,0,0,70,70,0,1,0,1,0,2
15986,8000,55850,8000,212,150,62,2,30,1,1,0
51948,443,29548,443,4876,2559,2317,32,56,18,14,0
6546,37965,0,0,62,62,0,1,0,1,0,1
56642,80,4720,80,234,234,0,4,12,4,0,0
5588,5588,0,0,3498,1872,1626,48,204,24,24,0
64040,53,17235,53,226,102,124,2,29,1,1,0
28668,8696,0,0,60,60,0,1,0,1,0,1
53051,44847,0,0,66,66,0,1,0,1,0,1
56940,53,36969,53,200,102,98,2,31,1,1,0
55420,445,0,0,70,70,0,1,0,1,0,2
63572,443,58406,443,125798,40014,85784,276,171,125,151,0
443,61686,0,0,1484,1484,0,1,0,1,0,1
63753,445,0,0,70,70,0,1,0,1,0,2
52168,445,0,0,66,66,0,1,0,1,0,2
55596,14795,19064,14795,630,444,186,9,16,6,3,0
50143,35253,0,0,66,66,0,1,0,1,0,1
53366,53,53366,53,237,98,139,2,30,1,1,0
50463,445,0,0,66,66,0,1,0,1,0,2
49869,53,17507,53,414,103,311,4,31,2,2,0
64885,53,14280,53,261,102,159,2,29,1,1,0
37654,443,34226,443,12531,5566,6965,34,46,20,14,0
56520,53,9113,53,177,94,83,2,29,1,1,0
50027,445,0,0,70,70,0,1,0,1,0,2
39771,443,64614,443,6903,1273,5630,25,255,13,12,0
50162,445,0,0,70,70,0,1,0,1,0,2
64678,53,7690,53,758,93,665,2,31,1,1,0
64245,445,0,0,70,70,0,1,0,1,0,2
60829,445,0,0,70,70,0,1,0,1,0,2
56863,53,37391,53,177,94,83,2,30,1,1,0
59957,443,65089,443,8677,2714,5963,21,114,13,8,0
63464,443,28849,443,3120,976,2144,13,135,6,7,0
65227,53,53714,53,180,86,94,2,30,1,1,0
49717,53,48239,53,444,96,348,4,44,2,2,0
58447,445,0,0,70,70,0,1,0,1,0,2
55693,53,60577,53,748,95,653,2,31,1,1,0
58638,5900,0,0,62,62,0,1,0,1,0,1
40787,57470,0,0,62,62,0,1,0,1,0,1
57258,53,16585,53,177,94,83,2,30,1,1,0
63109,445,0,0,70,70,0,1,0,1,0,2
51135,443,24290,443,6678,1212,5466,22,256,12,10,0
65507,53,17701,53,211,102,109,2,30,1,1,0
60510,445,0,0,70,70,0,1,0,1,0,2
50116,22,50116,22,184,120,64,4,10,3,1,0
50862,443,14909,443,9930,2085,7845,21,318,11,10,0
13090,36237,0,0,66,66,0,1,0,1,0,1
50351,80,28696,80,1083,653,430,8,15,5,3,0
63759,443,31179,443,7995,2096,5899,18,120,8,10,0
50528,445,0,0,70,70,0,1,0,1,0,2
7595,80,7595,80,34707,1796,32911,45,45,20,25,0
56004,53,27325,53,177,94,83,2,29,1,1,0
60778,445,0,0,70,70,0,1,0,1,0,2
61115,445,0,0,70,70,0,1,0,1,0,2
51053,80,62409,80,1638,1324,314,10,14,5,5,0
50782,445,0,0,70,70,0,1,0,1,0,2
50263,53,23939,53,172,94,78,2,30,1,1,0
37097,80,49884,80,1114,534,580,12,15,7,5,0
27046,51505,0,0,66,66,0,1,0,1,0,1
52028,80,63717,80,422,240,182,8,24,5,3,0
49418,27015,42227,27015,251,78,173,2,30,1,1,0
54571,445,0,0,70,70,0,1,0,1,0,2
63975,445,0,0,70,70,0,1,0,1,0,2
53459,445,0,0,70,70,0,1,0,1,0,2
37587,5228,8359,5228,5509,2203,3306,22,3600,10,12,0
37786,443,52361,443,5544,2626,2918,28,145,15,13,0
64905,53,16169,53,245,94,151,2,30,1,1,0
58638,5900,0,0,62,62,0,1,0,1,0,1
56924,53,7241,53,216,110,106,2,30,1,1,0
54537,80,39580,80,4096,3455,641,13,15,8,5,0
64634,445,0,0,70,70,0,1,0,1,0,2
49201,53,51989,53,200,102,98,2,30,1,1,0
55291,445,0,0,70,70,0,1,0,1,0,2
63027,443,10834,443,384,166,218,2,30,1,1,0
34616,53,34616,53,197,90,107,2,30,1,1,0
55555,53,24469,53,194,102,92,2,30,1,1,0
56739,53,42182,53,195,102,93,2,30,1,1,0
55840,443,56226,443,9374,2150,7224,42,255,19,23,0
62068,64147,0,0,66,66,0,1,0,1,0,1
44125,53,44125,53,209,79,130,2,30,1,1,0
50265,48982,51729,48982,480,149,331,2,1200,1,1,0
38698,443,26967,443,628,250,378,11,39,5,6,0
60612,443,17628,443,117190,11380,105810,171,212,67,104,0
54298,48983,0,0,159,159,0,1,0,1,0,1
56356,53,2062,53,758,96,662,2,31,1,1,0
42252,33303,0,0,60,60,0,1,0,1,0,1
33502,5529,0,0,143,143,0,1,0,1,0,1
48818,443,11974,443,4167,1669,2498,23,15,12,11,0
65403,53,49597,53,359,94,265,2,30,1,1,0
9137,80,35596,80,908,842,66,7,18,6,1,0
64797,53,38007,53,183,94,89,2,30,1,1,0
60246,445,0,0,70,70,0,1,0,1,0,2
60474,53,36065,53,195,94,101,2,30,1,1,0
56344,53,2417,53,199,102,97,2,30,1,1,0
53460,443,38830,443,25079,5739,19340,39,337,18,21,0
60561,53,50880,53,343,86,257,2,30,1,1,0
19570,50584,0,0,62,62,0,1,0,1,0,1
60945,443,60187,443,1373,712,661,14,18,8,6,0
56258,53,24780,53,167,86,81,2,30,1,1,0
57470,5382,65418,5382,2411,1328,1083,19,1200,11,8,0
26713,64147,0,0,62,62,0,1,0,1,0,1
52034,80,13450,80,4185,3462,723,14,16,7,7,0
11574,51505,0,0,66,66,0,1,0,1,0,1
56669,443,61657,443,8058,2038,6020,20,15,11,9,0
64981,445,0,0,70,70,0,1,0,1,0,2
17750,6992,50842,6992,150,150,0,1,1200,1,0,0
51467,443,7148,443,20313,6637,13676,45,24,23,22,0
63905,445,0,0,66,66,0,1,0,1,0,2
55754,53,55090,53,199,102,97,2,30,1,1,0
57886,53,57886,53,216,90,126,2,29,1,1,0
27005,27015,19164,27015,871,126,745,2,31,1,1,0
50624,26467,0,0,66,66,0,1,0,1,0,1
56303,53,13622,53,170,87,83,2,30,1,1,0
19096,64147,0,0,62,62,0,1,0,1,0,1
49701,80,18933,80,6132,634,5498,13,130,6,7,0
52842,445,0,0,70,70,0,1,0,1,0,2
56705,443,63668,443,8007,1987,6020,20,15,11,9,0
56495,53,8652,53,199,102,97,2,30,1,1,0
50230,80,20217,80,2384,952,1432,15,75,8,7,0
21294,21247,0,0,146,146,0,1,0,1,0,1
49773,53,59337,53,225,110,115,2,30,1,1,0
48890,443,48166,443,79665,4371,75294,110,256,45,65,0
61852,445,0,0,66,66,0,1,0,1,0,2
62301,445,0,0,70,70,0,1,0,1,0,2
49451,443,37319,443,1855625,57182,1798443,1981,70,703,1278,0
40971,1433,0,0,60,60,0,1,0,1,0,1
26054,80,26054,80,1798,540,1258,10,15,6,4,0
55582,53,15587,53,168,86,82,2,30,1,1,0
50038,445,0,0,66,66,0,1,0,1,0,2
55291,445,0,0,66,66,0,1,0,1,0,2
55727,53,33963,53,335,93,242,4,32,2,2,0
57442,53,59819,53,411,110,301,2,30,1,1,0
57029,445,0,0,70,70,0,1,0,1,0,2
56813,443,32005,443,8021,2001,6020,20,16,11,9,0
49479,56205,0,0,66,66,0,1,0,1,0,1
49927,53,25486,53,763,102,661,2,30,1,1,0
58638,5900,0,0,62,62,0,1,0,1,0,1
51325,445,0,0,70,70,0,1,0,1,0,2
50504,53,13475,53,168,86,82,2,31,1,1,0
53608,445,0,0,70,70,0,1,0,1,0,2
64675,445,0,0,66,66,0,1,0,1,0,2
3615,53,3615,53,231,90,141,2,30,1,1,0
65494,53,0,0,88,88,0,1,0,1,0,1
54883,51505,0,0,66,66,0,1,0,1,0,1
49786,53,59022,53,752,110,642,2,30,1,1,0
54670,443,29364,443,18487,3434,15053,37,80,20,17,0
64226,53,55510,53,211,102,109,2,30,1,1,0
58245,445,0,0,66,66,0,1,0,1,0,2
50317,445,0,0,70,70,0,1,0,1,0,2
65042,53,26467,53,183,94,89,2,29,1,1,0
6666,62078,0,0,60,60,0,1,0,1,0,1
59031,25174,0,0,62,62,0,1,0,1,0,1
57528,445,0,0,66,66,0,1,0,1,0,2
55383,53,49153,53,177,94,83,2,29,1,1,0
51382,56205,0,0,66,66,0,1,0,1,0,1
64627,53,26278,53,168,86,82,2,30,1,1,0
51803,445,0,0,70,70,0,1,0,1,0,2
52934,26467,0,0,66,66,0,1,0,1,0,1
55877,53546,37144,53546,481,150,331,2,1200,1,1,0
59086,445,0,0,66,66,0,1,0,1,0,2
19944,22114,0,0,66,66,0,1,0,1,0,1
49997,80,20317,80,2863,604,2259,11,15,6,5,0
26799,6881,0,0,62,62,0,1,0,1,0,1
12632,25174,0,0,62,62,0,1,0,1,0,1
59480,443,64952,443,5058,2667,2391,25,92,13,12,0
61804,51505,0,0,66,66,0,1,0,1,0,1
62241,443,33164,443,7205,2250,4955,16,120,7,9,0
57089,443,54231,443,5574,999,4575,21,256,11,10,0
23274,50584,0,0,62,62,0,1,0,1,0,1
37485,161,0,0,6435,2535,3900,22,30,11,11,0
37995,49152,51662,49152,156,156,0,3,8,3,0,0
6882,43825,33329,43825,200,111,89,2,1200,1,1,0
46495,4607,0,0,60,60,0,1,0,1,0,1
50162,445,0,0,66,66,0,1,0,1,0,2
46441,443,33380,443,416,210,206,7,28,4,3,0
56864,15646,57596,15646,70,70,0,1,5,1,0,0
2305,35440,0,0,62,62,0,1,0,1,0,1
27005,27016,26608,27016,880,126,754,2,30,1,1,0
49664,80,19625,80,7561,3181,4380,16,41,8,8,0
51962,443,60648,443,8600,1735,6865,27,25,14,13,0
50224,445,0,0,66,66,0,1,0,1,0,2
52854,445,0,0,66,66,0,1,0,1,0,2
62829,445,0,0,66,66,0,1,0,1,0,2
45753,80,11896,80,48495,10969,37526,83,477,39,44,0
49324,443,52610,443,6147,943,5204,17,16,9,8,0
23306,25174,0,0,146,146,0,1,0,1,0,1
56790,443,12015,443,8073,2053,6020,20,16,11,9,0
63459,445,0,0,66,66,0,1,0,1,0,2
48300,443,42844,443,7762,2247,5515,21,31,11,10,0
63305,62413,0,0,66,66,0,1,0,1,0,1
49508,443,20014,443,13719,5017,8702,40,283,20,20,0
49250,53,20588,53,731,85,646,2,30,1,1,0
64114,445,0,0,66,66,0,1,0,1,0,2
49672,53,36807,53,718,94,624,2,30,1,1,0
62765,445,0,0,70,70,0,1,0,1,0,2
43788,80,23555,80,2597,699,1898,11,181,6,5,0
443,22323,0,0,83,83,0,1,0,1,0,1
45941,23386,0,0,60,60,0,1,0,1,0,1
40204,40016,4435,40016,148,86,62,2,30,1,1,0
2935,64147,0,0,62,62,0,1,0,1,0,1
57431,53,4214,53,733,94,639,2,30,1,1,0
50070,443,16090,443,9148,1570,7578,31,257,13,18,0
49317,53,61249,53,164,84,80,2,31,1,1,0
42969,8146,0,0,62,62,0,1,0,1,0,1
53261,12348,58794,12348,552,306,246,9,142,5,4,0
64905,53,22894,53,458,188,270,6,29,3,3,0
50299,53,31351,53,770,102,668,2,30,1,1,0
50476,80,50476,80,28872,5086,23786,50,24,24,26,0
27005,27015,32114,27015,1634,126,1508,4,31,2,2,0
55413,37965,0,0,62,62,0,1,0,1,0,1
443,10010,0,0,60,60,0,1,0,1,0,1
56202,15503,0,0,146,146,0,1,0,1,0,1
63593,443,12181,443,36819,3967,32852,59,152,30,29,0
59579,445,0,0,66,66,0,1,0,1,0,2
62937,30975,0,0,185,185,0,1,0,1,0,1
46193,53,56530,53,311,86,225,2,30,1,1,0
64801,53,33594,53,728,96,632,2,30,1,1,0
65077,443,2224,443,6118,5698,420,12,123,6,6,0
27005,31000,35910,31000,898,126,772,2,31,1,1,0
37874,19000,47411,19000,602,174,428,2,31,1,1,0
58946,443,24412,443,3990,2586,1404,17,16,9,8,0
57553,443,21487,443,7075,2575,4500,21,30,12,9,0
50818,445,0,0,66,66,0,1,0,1,0,2
42820,443,41684,443,8155,1999,6156,22,81,13,9,0
22583,9822,0,0,62,62,0,1,0,1,0,1
65498,53,22566,53,752,93,659,2,31,1,1,0
61868,445,0,0,70,70,0,1,0,1,0,2
38688,443,23677,443,90166,3481,86685,96,16,31,65,0
59064,445,0,0,66,66,0,1,0,1,0,2
59157,443,21885,443,7139,3570,3569,22,166,11,11,0
56816,53,22918,53,233,94,139,2,30,1,1,0
51684,445,0,0,70,70,0,1,0,1,0,2
49795,53,44891,53,263,94,169,2,30,1,1,0
49410,53,14771,53,167,86,81,2,30,1,1,0
62453,445,0,0,70,70,0,1,0,1,0,2
51300,64147,0,0,62,62,0,1,0,1,0,1
2394,43890,0,0,62,62,0,1,0,1,0,1
49475,80,53528,80,1548,847,701,10,16,5,5,0
56975,53,38883,53,197,102,95,2,29,1,1,0
51602,22114,0,0,66,66,0,1,0,1,0,1
33498,443,13950,443,3672,1802,1870,25,129,10,15,0
52585,53,6341,53,265,91,174,4,40,2,2,0
3478,61463,0,0,455,455,0,1,0,1,0,1
50331,80,36568,80,1677,862,815,10,15,5,5,0
52519,44847,0,0,66,66,0,1,0,1,0,1
35610,37965,0,0,62,62,0,1,0,1,0,1
64338,53,41701,53,200,102,98,2,30,1,1,0
52917,445,0,0,70,70,0,1,0,1,0,2
51891,23238,33315,23238,70,70,0,2,8,2,0,0
64914,53,14005,53,224,94,130,2,30,1,1,0
59861,445,0,0,66,66,0,1,0,1,0,2
64093,445,0,0,70,70,0,1,0,1,0,2
58188,445,0,0,70,70,0,1,0,1,0,2
51682,80,11682,80,59786,3488,56298,119,55,45,74,0
64284,53,35627,53,306,94,212,2,29,1,1,0
63043,445,0,0,70,70,0,1,0,1,0,2
65507,53,47508,53,167,86,81,2,30,1,1,0
35412,443,65351,443,1251,749,502,11,68,6,5,0
60384,443,14731,443,130,70,60,2,15,1,1,0
55729,53,3835,53,256,96,160,4,42,2,2,0
63104,445,0,0,70,70,0,1,0,1,0,2
60948,445,0,0,70,70,0,1,0,1,0,2
59377,9319,0,0,62,62,0,1,0,1,0,1
55770,53,9659,53,177,94,83,2,30,1,1,0
53867,60272,36955,60272,70,70,0,1,5,1,0,0
55081,445,0,0,70,70,0,1,0,1,0,2
65276,53,46929,53,212,102,110,2,30,1,1,0
50697,80,53956,80,2525,1403,1122,22,272,12,10,0
53932,445,0,0,70,70,0,1,0,1,0,2
55582,445,0,0,70,70,0,1,0,1,0,2
52925,5555,0,0,60,60,0,1,0,1,0,1
65130,80,61798,80,2500,531,1969,11,76,6,5,0
50328,80,59408,80,55878,5841,50037,70,94,29,41,0
58701,80,43595,80,12499310,161518,12337792,10496,70,2325,8171,0
52026,26467,0,0,60,60,0,1,0,1,0,1
57325,37965,0,0,62,62,0,1,0,1,0,1
56994,53,65507,53,170,87,83,2,30,1,1,0
52930,445,0,0,70,70,0,1,0,1,0,2
51994,25509,30907,25509,70,70,0,2,8,2,0,0
53138,443,15464,443,6760,1346,5414,18,325,9,9,0
17947,36237,0,0,62,62,0,1,0,1,0,1
63456,37965,0,0,62,62,0,1,0,1,0,1
49187,2710,40478,2710,70,70,0,2,7,2,0,0
49514,80,16033,80,1352,832,520,12,38,7,5,0
5223,14446,0,0,220,220,0,1,0,1,0,1
30353,53,30353,53,200,90,110,2,30,1,1,0
56513,445,0,0,66,66,0,1,0,1,0,2
52077,51638,13368,51638,70,70,0,2,8,2,0,0
58597,35440,0,0,62,62,0,1,0,1,0,1
49820,123,49820,123,184,94,90,2,30,1,1,0
49666,53,61369,53,392,124,268,4,35,2,2,0
6778,50584,0,0,66,66,0,1,0,1,0,1
55146,53,27596,53,178,91,87,2,31,1,1,0
59659,445,0,0,66,66,0,1,0,1,0,2
64899,445,0,0,70,70,0,1,0,1,0,2
64117,445,0,0,70,70,0,1,0,1,0,2
14023,37965,0,0,62,62,0,1,0,1,0,1
55085,53,9873,53,301,94,207,2,30,1,1,0
63631,443,40886,443,8640,5157,3483,17,120,10,7,0
50547,53,45838,53,210,110,100,2,30,1,1,0
52498,80,52498,80,15453,911,14542,25,16,11,14,0
19209,62413,0,0,146,146,0,1,0,1,0,1
64587,53,36595,53,167,86,81,2,31,1,1,0
49911,445,0,0,70,70,0,1,0,1,0,2
50253,53,23205,53,167,86,81,2,31,1,1,0
57357,445,0,0,70,70,0,1,0,1,0,2
57288,53,40505,53,177,94,83,2,30,1,1,0
58638,5900,0,0,62,62,0,1,0,1,0,1
34814,53,64232,53,168,78,90,2,30,1,1,0
443,35385,0,0,161,161,0,1,0,1,0,1
49935,445,0,0,70,70,0,1,0,1,0,2
55841,53,16397,53,458,188,270,6,31,3,3,0
35570,443,64379,443,3221,705,2516,15,135,7,8,0
50841,443,31504,443,10475,1518,8957,24,139,11,13,0
57022,445,0,0,70,70,0,1,0,1,0,2
53842,57861,18155,57861,492,306,186,8,14,5,3,0
1025,51221,0,0,62,62,0,1,0,1,0,1
60827,445,0,0,70,70,0,1,0,1,0,2
22574,44847,0,0,62,62,0,1,0,1,0,1
59549,445,0,0,70,70,0,1,0,1,0,2
6224,37965,0,0,62,62,0,1,0,1,0,1
65004,53,23515,53,323,94,229,2,30,1,1,0
60709,53,36089,53,260,86,174,2,30,1,1,0
55477,53,61973,53,183,94,89,2,31,1,1,0
57363,53,22472,53,178,94,84,2,30,1,1,0
28878,51505,0,0,62,62,0,1,0,1,0,1
32132,25174,0,0,66,66,0,1,0,1,0,1
20217,8333,0,0,60,60,0,1,0,1,0,1
65405,53,50341,53,560,104,456,4,43,2,2,0
46899,443,58934,443,9085,2222,6863,39,125,19,20,0
64942,53,20482,53,215,94,121,2,30,1,1,0
63305,62413,0,0,66,66,0,1,0,1,0,1
55605,27274,9607,27274,130,70,60,2,4,1,1,0
63305,445,0,0,70,70,0,1,0,1,0,2
55896,53,45886,53,184,94,90,2,31,1,1,0
42488,53,42488,53,235,90,145,2,32,1,1,0
55596,53,2008,53,177,94,83,2,29,1,1,0
60049,443,35659,443,10124,2145,7979,24,156,11,13,0
58638,5900,0,0,62,62,0,1,0,1,0,1
54634,443,32455,443,225732,7330,218402,246,174,86,160,0
59862,443,40236,443,5301,953,4348,17,28,9,8,0
41315,11392,0,0,146,146,0,1,0,1,0,1
61592,443,6581,443,19544,8237,11307,29,121,13,16,0
56941,445,0,0,70,70,0,1,0,1,0,2
57643,445,0,0,70,70,0,1,0,1,0,2
18157,53,35666,53,215,94,121,2,30,1,1,0
55897,53,62688,53,711,87,624,2,31,1,1,0
65115,53,32763,53,167,86,81,2,30,1,1,0
9246,80,48818,80,318,192,126,6,26,4,2,0
59270,53,59270,53,825,99,726,2,30,1,1,0
65231,53,23789,53,200,102,98,2,31,1,1,0
55539,57470,0,0,66,66,0,1,0,1,0,1
55933,445,0,0,70,70,0,1,0,1,0,2
12458,161,0,0,85,85,0,1,0,1,0,1
65047,53,53893,53,196,86,110,2,30,1,1,0
56625,443,54912,443,6734,2065,4669,21,16,11,10,0
62941,445,0,0,66,66,0,1,0,1,0,2
45060,37965,0,0,62,62,0,1,0,1,0,1
56463,17,0,0,60,60,0,1,0,1,0,1
37965,18122,9264,18122,3957,2324,1633,51,1794,29,22,0
57312,53,15531,53,212,110,102,2,30,1,1,0
46945,64147,0,0,62,62,0,1,0,1,0,1
58035,80,30742,80,100364,4917,95447,133,241,67,66,0
57335,443,56068,443,56199,3856,52343,81,216,39,42,0
40288,80,46706,80,1195,763,432,10,32,6,4,0
63172,445,0,0,70,70,0,1,0,1,0,2
56485,80,20851,80,569,365,204,6,16,3,3,0
50219,445,0,0,70,70,0,1,0,1,0,2
55427,53,22421,53,200,102,98,2,33,1,1,0
52929,443,26411,443,8623,4829,3794,44,195,22,22,0
55747,445,0,0,70,70,0,1,0,1,0,2
58638,5900,0,0,62,62,0,1,0,1,0,1
64915,53,33891,53,170,87,83,2,31,1,1,0
443,14591,0,0,85,85,0,1,0,1,0,1
7048,25174,0,0,66,66,0,1,0,1,0,1
50683,443,31278,443,12362,1650,10712,33,300,14,19,0
45404,80,36835,80,574,500,74,6,15,5,1,0
42283,443,51990,443,16831,14003,2828,31,63,18,13,0
53266,443,13911,443,12822,4426,8396,42,18,24,18,0
56236,443,26673,443,9597,2488,7109,32,287,16,16,0
64593,53,5715,53,602,93,509,4,42,2,2,0
22724,9822,0,0,66,66,0,1,0,1,0,1
48068,443,12098,443,10418,1427,8991,27,16,12,15,0
55375,44847,0,0,66,66,0,1,0,1,0,1
55945,53,7616,53,177,94,83,2,29,1,1,0
49647,53,18676,53,361,102,259,2,30,1,1,0
61522,64147,0,0,66,66,0,1,0,1,0,1
30960,45694,42221,45694,330,330,0,6,3610,6,0,0
50455,445,0,0,70,70,0,1,0,1,0,2
53303,445,0,0,70,70,0,1,0,1,0,2
55577,53,64711,53,198,101,97,2,31,1,1,0
50730,53,50730,53,228,97,131,2,30,1,1,0
63495,50584,0,0,66,66,0,1,0,1,0,1
61279,443,14356,443,7424,3871,3553,26,160,12,14,0
30443,44847,0,0,62,62,0,1,0,1,0,1
63503,42707,0,0,66,66,0,1,0,1,0,1
50172,443,41441,443,161,101,60,2,5,1,1,0
25961,55783,0,0,60,60,0,1,0,1,0,1
40590,443,36504,443,2965,1650,1315,24,275,12,12,0
55238,443,54700,443,6165,1407,4758,21,45,12,9,0
55242,53,7339,53,373,126,247,2,30,1,1,0
39056,22114,0,0,62,62,0,1,0,1,0,1
54277,22114,0,0,62,62,0,1,0,1,0,1
59762,80,15903,80,1278,774,504,12,361,7,5,0
47531,8080,0,0,184,78,106,3,10,2,1,0
57564,56205,0,0,66,66,0,1,0,1,0,1
55462,53,41879,53,194,102,92,2,33,1,1,0
43537,2323,0,0,60,60,0,1,0,1,0,1
58914,53,2441,53,244,86,158,2,30,1,1,0
39823,36237,0,0,62,62,0,1,0,1,0,1
5938,49414,0,0,60,60,0,1,90,1,0,0
40967,1433,0,0,60,60,0,1,0,1,0,1
65299,53,60442,53,177,94,83,2,30,1,1,0
49267,443,42451,443,19851,15702,4149,63,109,34,29,0
47664,3389,47664,3389,4575,2400,2175,20,19,11,9,0
49905,53,31462,53,180,94,86,2,29,1,1,0
34086,25174,0,0,66,66,0,1,0,1,0,1
8415,8415,47085,8415,66,66,0,1,30,1,0,0
58846,443,58496,443,7680,4905,2775,24,17,12,12,0
56111,53,45505,53,179,94,85,2,30,1,1,0
56697,445,0,0,70,70,0,1,0,1,0,2
51944,80,27996,80,2120,1080,1040,17,55,10,7,0
57979,443,3610,443,7970957,82522,7888435,6370,179,1027,5343,0
53873,52055,21698,52055,70,70,0,2,8,2,0,0
50584,21094,39450,21094,1356,300,1056,6,1200,3,3,0
57020,36237,0,0,66,66,0,1,0,1,0,1
58950,445,0,0,70,70,0,1,0,1,0,2
53957,35440,0,0,62,62,0,1,0,1,0,1
55232,53,52840,53,177,94,83,2,30,1,1,0
55098,53,8835,53,176,90,86,2,30,1,1,0
60912,443,25198,443,9959,2430,7529,27,46,16,11,0
58492,443,51321,443,5611,1560,4051,22,266,13,9,0
65454,61600,0,0,66,66,0,1,0,1,0,1
37648,443,15216,443,9618,7387,2231,30,26,18,12,0
1081,64910,0,0,146,146,0,1,0,1,0,1
80,9918,0,0,60,60,0,1,0,1,0,1
53902,67,0,0,60,60,0,1,0,1,0,1
61653,445,0,0,70,70,0,1,0,1,0,2
27005,27016,52333,27016,892,126,766,2,30,1,1,0
51414,50584,0,0,66,66,0,1,0,1,0,1
63131,445,0,0,66,66,0,1,0,1,0,2
53433,445,0,0,66,66,0,1,0,1,0,2
64051,36829,0,0,66,66,0,1,0,1,0,1
51052,53,0,0,82,82,0,1,30,1,0,0
62459,445,0,0,66,66,0,1,0,1,0,2
24560,51050,0,0,146,146,0,1,0,1,0,1
57224,445,0,0,70,70,0,1,0,1,0,2
55660,42459,61425,42459,1717,1129,588,17,25,10,7,0
32805,443,65246,443,438124,21529,416595,481,398,138,343,0
59048,57470,0,0,66,66,0,1,0,1,0,1
45964,55559,0,0,60,60,0,1,0,1,0,1
56964,445,0,0,66,66,0,1,0,1,0,2
56333,53,17825,53,199,102,97,2,30,1,1,0
11716,37965,0,0,62,62,0,1,0,1,0,1
56354,53,51631,53,200,94,106,2,30,1,1,0
64252,53,2109,53,199,102,97,2,29,1,1,0
27322,443,7841,443,5235,1839,3396,22,48,10,12,0
62731,21247,0,0,66,66,0,1,0,1,0,1
53033,445,0,0,66,66,0,1,0,1,0,2
54990,53,13608,53,168,86,82,2,31,1,1,0
52949,443,60761,443,9564,2054,7510,42,114,20,22,0
55415,53,7035,53,183,94,89,2,30,1,1,0
51342,53,21697,53,199,94,105,2,30,1,1,0
53955,3290,25446,3290,70,70,0,1,5,1,0,0
55245,53,61157,53,209,110,99,2,29,1,1,0
58608,62413,0,0,66,66,0,1,0,1,0,1
123,123,22929,123,184,94,90,2,29,1,1,0
49475,443,44120,443,10402,1945,8457,24,158,11,13,0
56830,53,35063,53,752,93,659,2,30,1,1,0
53771,37965,0,0,66,66,0,1,0,1,0,1
61227,445,0,0,70,70,0,1,0,1,0,2
50209,53,40978,53,86,86,0,1,30,1,0,0
56695,443,5124,443,8006,1986,6020,20,15,11,9,0
56725,53,46910,53,262,90,172,4,59,2,2,0
38700,443,49227,443,130,70,60,2,14,1,1,0
56020,53,53467,53,198,101,97,2,31,1,1,0
64733,445,0,0,66,66,0,1,0,1,0,2
55847,443,25138,443,8443,1430,7013,17,141,8,9,0
49207,443,35081,443,2643240,203689,2439551,3285,576,1237,2048,0
56917,53,28057,53,194,102,92,2,31,1,1,0
1054,57470,0,0,62,62,0,1,0,1,0,1
13747,8887,13747,8887,500,500,0,1,0,1,0,1
55431,53,2541,53,196,102,94,2,31,1,1,0
57001,53,43521,53,177,94,83,2,30,1,1,0
62212,445,0,0,70,70,0,1,0,1,0,2
53918,24300,60964,24300,1735,975,760,11,16,7,4,0
55803,53,28022,53,174,89,85,3,36,2,1,0
64235,53,30515,53,321,99,222,4,52,2,2,0
55713,53,11593,53,308,94,214,2,30,1,1,0
11319,443,11319,443,179461,16904,162557,220,36,105,115,0
51145,445,0,0,70,70,0,1,0,1,0,2
56428,80,32588,80,17247,1619,15628,26,25,11,15,0
1955,53,1955,53,216,89,127,2,30,1,1,0
49578,445,0,0,70,70,0,1,0,1,0,2
56941,443,33358,443,4581,2831,1750,29,96,15,14,0
57157,445,0,0,70,70,0,1,0,1,0,2
64656,53,38366,53,718,94,624,2,30,1,1,0
58941,445,0,0,70,70,0,1,0,1,0,2
58264,44847,0,0,66,66,0,1,0,1,0,1
11385,48543,0,0,145,145,0,1,0,1,0,1
52218,80,8584,80,2373,614,1759,11,15,6,5,0
56127,445,0,0,66,66,0,1,0,1,0,2
52174,43106,3385,43106,160,70,90,2,8,1,1,0
60854,42873,0,0,66,66,0,1,0,1,0,1
56007,53,0,0,86,86,0,1,30,1,0,0
12694,12446,0,0,145,145,0,1,0,1,0,1
58029,80,1723,80,374,192,182,7,21,4,3,0
56611,80,8801,80,1114,534,580,12,16,7,5,0
43106,443,35974,443,3259,1913,1346,18,16,8,10,0
60891,443,53303,443,204,70,134,4,25,2,2,0
57301,53,42748,53,177,94,83,2,29,1,1,0
1187,64147,0,0,66,66,0,1,0,1,0,1
49589,53,16073,53,214,102,112,2,31,1,1,0
53131,44021,31517,44021,698,320,378,10,16,6,4,0
63284,445,0,0,70,70,0,1,0,1,0,2
65341,53,19741,53,200,102,98,2,29,1,1,0
54372,80,17871,80,3517,1612,1905,17,186,10,7,0
58550,21247,0,0,66,66,0,1,0,1,0,1
65374,53,60025,53,261,102,159,2,30,1,1,0
65099,445,0,0,70,70,0,1,0,1,0,2
56373,53,9472,53,200,102,98,2,30,1,1,0
55355,445,0,0,70,70,0,1,0,1,0,2
49958,36829,0,0,66,66,0,1,0,1,0,1
12143,56205,0,0,62,62,0,1,0,1,0,1
54234,443,2984,443,499,425,74,4,0,3,1,0
64414,53,3637,53,193,102,91,2,30,1,1,0
61784,445,0,0,66,66,0,1,0,1,0,2
65246,53,35369,53,179,94,85,2,30,1,1,0
21892,15503,0,0,62,62,0,1,0,1,0,1
49781,53,35337,53,254,102,152,2,29,1,1,0
39038,443,14810,443,3970,2230,1740,17,114,10,7,0
55043,443,34590,443,37068,4085,32983,66,48,33,33,0
52040,80,54028,80,366,240,126,7,24,5,2,0
52424,445,0,0,66,66,0,1,0,1,0,2
57172,53,27478,53,196,102,94,2,31,1,1,0
14352,8055,0,0,148,148,0,1,0,1,0,1
33261,443,59567,443,14176,1843,12333,30,201,16,14,0
54808,443,25043,443,9657,1944,7713,31,82,15,16,0
56273,53,59580,53,182,93,89,2,30,1,1,0
57267,443,26309,443,126,60,66,3,6,2,1,0
50985,443,12787,443,8007,3336,4671,19,78,11,8,0
44847,6881,59803,6881,484,150,334,2,1200,1,1,0
49788,445,0,0,70,70,0,1,0,1,0,2
55306,53,44864,53,177,94,83,2,31,1,1,0
43113,443,54317,443,3083,1817,1266,18,15,8,10,0
60327,80,34206,80,2125,1159,966,13,61,7,6,0
50292,80,5743,80,442,250,192,8,44,5,3,0
54417,53,12775,53,259,86,173,2,30,1,1,0
48952,443,47489,443,15944,6988,8956,135,324,72,63,0
43131,53,0,0,82,82,0,1,30,1,0,0
49763,53,30741,53,258,110,148,2,30,1,1,0
60769,443,3938,443,7639,2051,5588,33,120,17,16,0
63129,445,0,0,70,70,0,1,0,1,0,2
57002,445,0,0,70,70,0,1,0,1,0,2
55332,53,45716,53,211,110,101,2,30,1,1,0
57340,53,7589,53,216,110,106,2,30,1,1,0
26989,80,26989,80,256062,8754,247308,297,18,124,173,0
37444,53,37444,53,213,79,134,2,32,1,1,0
19361,23117,0,0,66,66,0,1,0,1,0,1
60022,443,60022,443,18674,1910,16764,32,18,17,15,0
55542,445,0,0,70,70,0,1,0,1,0,2
6929,35440,0,0,66,66,0,1,0,1,0,1
56115,445,0,0,70,70,0,1,0,1,0,2
16387,8455,0,0,60,60,0,1,0,1,0,1
3047,50584,0,0,146,146,0,1,0,1,0,1
55244,53,26585,53,184,102,82,2,30,1,1,0
63181,445,0,0,66,66,0,1,0,1,0,2
58638,5900,0,0,62,62,0,1,0,1,0,1
443,20995,0,0,83,83,0,1,0,1,0,1
55067,443,5248,443,17968,12031,5937,38,63,21,17,0
53222,53,43522,53,165,78,87,2,30,1,1,0
80,53945,0,0,60,60,0,1,0,1,0,1
53951,8999,2950,8999,70,70,0,2,7,2,0,0
49805,6881,0,0,66,66,0,1,0,1,0,1
55527,80,13344,80,20513,1960,18553,39,21,18,21,0
36644,443,15948,443,9329,3935,5394,30,405,17,13,0
51910,37965,0,0,62,62,0,1,0,1,0,1
43890,123,0,0,234,234,0,1,0,1,0,1
45964,2225,0,0,60,60,0,1,0,1,0,1
56676,443,53618,443,7889,1900,5989,20,15,11,9,0
49525,445,0,0,70,70,0,1,0,1,0,2
123,123,49669,123,184,94,90,2,29,1,1,0
49968,53,46436,53,285,94,191,2,30,1,1,0
50090,50265,0,0,66,66,0,1,0,1,0,1
58845,443,51619,443,22402,14820,7582,52,20,29,23,0
49892,53,17000,53,525,110,415,4,43,2,2,0
61387,80,56509,80,28791,2297,26494,41,255,20,21,0
49548,443,37968,443,1346,918,428,10,22,6,4,0
53342,445,0,0,70,70,0,1,0,1,0,2
55577,53,3000,53,699,204,495,6,57,3,3,0
58903,80,49363,80,22851,3171,19680,39,147,20,19,0
44612,25174,0,0,66,66,0,1,0,1,0,1
64767,80,54344,80,3199,988,2211,14,99,7,7,0
50859,445,0,0,66,66,0,1,0,1,0,2
52478,443,31557,443,7985,2085,5900,18,121,8,10,0
57232,53,8301,53,198,102,96,2,30,1,1,0
10333,22114,0,0,62,62,0,1,0,1,0,1
62885,443,65198,443,8097,2684,5413,22,248,12,10,0
36738,80,36738,80,416,198,218,7,121,4,3,0
49884,443,63837,443,5998,978,5020,19,50,10,9,0
56704,53,10036,53,194,102,92,2,31,1,1,0
64347,445,0,0,66,66,0,1,0,1,0,2
57212,53,19775,53,780,104,676,2,31,1,1,0
60506,56243,34455,56243,70,70,0,2,8,2,0,0
50230,445,0,0,70,70,0,1,0,1,0,2
60652,445,0,0,70,70,0,1,0,1,0,2
11878,37807,0,0,62,62,0,1,0,1,0,1
49333,53,61415,53,392,102,290,2,30,1,1,0
57902,443,28629,443,20509,7660,12849,54,131,28,26,0
42981,44847,0,0,146,146,0,1,0,1,0,1
48982,53,28037,53,306,212,94,3,29,2,1,0
56400,80,42500,80,1281,398,883,16,392,4,12,0
36601,443,32906,443,16455,11185,5270,37,271,22,15,0
51883,16325,58501,16325,316,136,180,6,6,3,3,0
9401,443,34975,443,7135,1346,5789,21,32,10,11,0
37568,443,13649,443,1702,861,841,19,110,10,9,0
50932,445,0,0,66,66,0,1,0,1,0,2
48883,53,16845,53,168,78,90,2,30,1,1,0
59937,37965,0,0,66,66,0,1,0,1,0,1
64599,445,0,0,66,66,0,1,0,1,0,2
51419,443,59979,443,13049,4849,8200,31,31,15,16,0
49501,80,23659,80,183116,16652,166464,279,486,59,220,0
52281,161,0,0,550,550,0,6,35,6,0,0
5222,64493,0,0,1514,1514,0,1,0,1,0,1
55179,53,20932,53,194,102,92,2,35,1,1,0
48735,443,54377,443,77050,5353,71697,113,95,46,67,0
34998,443,4497,443,9114,2208,6906,36,120,19,17,0
59733,445,0,0,70,70,0,1,0,1,0,2
39105,443,21624,443,2853588,73973,2779615,2907,129,994,1913,0
59526,445,0,0,70,70,0,1,0,1,0,2
56589,53,29325,53,198,101,97,2,31,1,1,0
53785,53,12230,53,167,78,89,2,31,1,1,0
42285,57470,0,0,62,62,0,1,0,1,0,1
55052,53,1245,53,198,102,96,2,30,1,1,0
56337,53,25650,53,268,89,179,4,45,2,2,0
62030,53,0,0,229,85,144,2,31,1,1,0
52994,443,57845,443,10694,4129,6565,41,111,20,21,0
58638,5900,0,0,62,62,0,1,0,1,0,1
41322,443,7553,443,153,93,60,2,5,1,1,0
1117,37965,0,0,62,62,0,1,0,1,0,1
59947,445,0,0,70,70,0,1,0,1,0,2
3478,61463,0,0,1188,1188,0,1,0,1,0,1
49898,53,22442,53,184,94,90,2,30,1,1,0
59803,22114,0,0,62,62,0,1,0,1,0,1
58884,15000,25949,15000,138,78,60,2,5,1,1,0
49608,80,48854,80,318,192,126,6,41,4,2,0
26501,80,26501,80,93644,8868,84776,131,31,64,67,0
63968,53,61368,53,310,142,168,2,30,1,1,0
64205,445,0,0,70,70,0,1,0,1,0,2
51894,445,0,0,70,70,0,1,0,1,0,2
55732,53,61011,53,194,102,92,2,30,1,1,0
9289,443,57036,443,9051,3480,5571,31,23,17,14,0
62528,445,0,0,70,70,0,1,0,1,0,2
55069,53,50203,53,195,102,93,2,30,1,1,0
50066,30188,0,0,62,62,0,1,0,1,0,1
61550,5529,0,0,145,145,0,1,0,1,0,1
28064,53,28064,53,233,90,143,2,32,1,1,0
55193,53,60056,53,170,87,83,2,31,1,1,0
37569,443,62296,443,97539,6936,90603,160,597,74,86,0
58646,445,0,0,70,70,0,1,0,1,0,2
63847,445,0,0,66,66,0,1,0,1,0,2
36414,80,15964,80,5046,4132,914,31,15,16,15,0
38795,40042,2140,40042,142,80,62,2,31,1,1,0
49768,443,40344,443,12934,1419,11515,27,127,11,16,0
61514,445,0,0,70,70,0,1,0,1,0,2
64155,53,2380,53,183,94,89,2,30,1,1,0
26791,443,23053,443,21391,16334,5057,38,20,21,17,0
1024,25174,0,0,62,62,0,1,0,1,0,1
64072,53,31241,53,292,110,182,2,30,1,1,0
56067,53,5556,53,195,102,93,2,30,1,1,0
51114,443,50404,443,10301,4593,5708,21,121,10,11,0
39762,443,10128,443,9264,2848,6416,31,100,16,15,0
60308,37965,0,0,66,66,0,1,0,1,0,1
58910,443,57868,443,27575,18478,9097,64,22,36,28,0
39570,62413,0,0,146,146,0,1,0,1,0,1
64353,445,0,0,70,70,0,1,0,1,0,2
64679,53,50625,53,172,88,84,2,31,1,1,0
59928,80,12349,80,5755,3943,1812,24,31,13,11,0
57470,48622,44893,48622,166,166,0,1,1200,1,0,0
56395,53,56804,53,199,102,97,2,29,1,1,0
53676,3678,29317,3678,70,70,0,2,7,2,0,0
60158,445,0,0,70,70,0,1,0,1,0,2
58457,445,0,0,70,70,0,1,0,1,0,2
40804,8434,40804,8434,156,156,0,3,8,3,0,0
61637,445,0,0,70,70,0,1,0,1,0,2
54924,3478,47718,3478,312,140,172,4,30,2,2,0
32520,47993,0,0,66,66,0,1,0,1,0,1
55616,445,0,0,66,66,0,1,0,1,0,2
63369,445,0,0,66,66,0,1,0,1,0,2
35657,48637,0,0,62,62,0,1,0,1,0,1
52023,41791,61647,41791,70,70,0,2,8,2,0,0
32578,443,32578,443,25033,2433,22600,42,25,21,21,0
64890,53,13860,53,210,110,100,2,30,1,1,0
56496,445,0,0,70,70,0,1,0,1,0,2
55069,44847,0,0,62,62,0,1,0,1,0,1
64756,11392,0,0,62,62,0,1,0,1,0,1
42865,55839,0,0,137,137,0,1,0,1,0,1
27005,27015,60376,27015,878,126,752,2,30,1,1,0
55423,53,31871,53,177,94,83,2,31,1,1,0
17760,50584,0,0,62,62,0,1,0,1,0,1
53221,445,0,0,66,66,0,1,0,1,0,2
56639,445,0,0,70,70,0,1,0,1,0,2
49500,53,31434,53,248,118,130,2,29,1,1,0
1057,57470,0,0,62,62,0,1,0,1,0,1
59378,50584,0,0,66,66,0,1,0,1,0,1
50803,445,0,0,70,70,0,1,0,1,0,2
60839,445,0,0,66,66,0,1,0,1,0,2
12969,55777,0,0,66,66,0,1,0,1,0,1
52957,443,8095,443,38149,4388,33761,68,113,26,42,0
44885,443,34599,443,296,78,218,4,19,1,3,0
56170,53,28854,53,196,100,96,2,30,1,1,0
49708,53,19029,53,186,95,91,2,31,1,1,0
7198,53,7198,53,398,255,143,3,32,2,1,0
50861,3389,50861,3389,4241,2521,1720,18,32,10,8,0
56640,80,54626,80,234,234,0,4,11,4,0,0
52024,445,0,0,70,70,0,1,0,1,0,2
443,32698,0,0,89,89,0,1,0,1,0,1
64382,44847,0,0,66,66,0,1,0,1,0,1
58638,5900,0,0,62,62,0,1,0,1,0,1
54631,443,58856,443,8367,3945,4422,81,616,42,39,0
52190,29765,59554,29765,70,70,0,1,4,1,0,0
63147,445,0,0,70,70,0,1,0,1,0,2
64026,53,2303,53,244,94,150,2,31,1,1,0
5237,30128,2836,30128,621281,256,621025,881,49,5,876,0
55384,53,51117,53,194,102,92,2,30,1,1,0
65447,53,45832,53,756,95,661,2,31,1,1,0
65477,445,0,0,70,70,0,1,0,1,0,2
46654,80,33249,80,1518,954,564,14,320,8,6,0
52009,1035,48428,1035,316,136,180,6,7,3,3,0
64988,445,0,0,70,70,0,1,0,1,0,2
57798,445,0,0,70,70,0,1,0,1,0,2
53242,37965,0,0,66,66,0,1,0,1,0,1
58190,445,0,0,70,70,0,1,0,1,0,2
57745,445,0,0,70,70,0,1,0,1,0,2
51782,445,0,0,66,66,0,1,0,1,0,2
46767,443,3623,443,8376,2231,6145,25,330,12,13,0
63877,445,0,0,70,70,0,1,0,1,0,2
443,10010,0,0,60,60,0,1,0,1,0,1
9708,53,0,0,304,94,210,2,30,1,1,0
53342,443,18889,443,82909,70964,11945,139,283,71,68,0
9687,57470,0,0,78,78,0,1,0,1,0,1
54820,443,53134,443,16366,4160,12206,41,55,20,21,0
64627,53,12613,53,184,102,82,2,31,1,1,0
49636,443,48846,443,6158,1149,5009,17,52,9,8,0
45932,53,57917,53,199,94,105,2,30,1,1,0
34822,31573,0,0,62,62,0,1,0,1,0,1
64665,53,19631,53,181,94,87,2,31,1,1,0
55542,443,51637,443,58975,3359,55616,78,26,34,44,0
64618,53,55916,53,198,102,96,2,31,1,1,0
44680,80,65456,80,1658,922,736,10,17,6,4,0
62696,50584,0,0,62,62,0,1,0,1,0,1
51490,1,0,0,100,100,0,1,0,1,0,1
65349,53,10010,53,275,110,165,2,30,1,1,0
45939,5228,13443,5228,7528,1416,6112,29,811,11,18,0
62678,445,0,0,70,70,0,1,0,1,0,2
50384,443,60892,443,7723,2591,5132,23,49,12,11,0
51657,80,10496,80,318,192,126,6,37,4,2,0
65319,53,47160,53,285,103,182,4,44,2,2,0
49856,53,57011,53,168,78,90,2,30,1,1,0
49554,443,18292,443,7540,1840,5700,18,15,10,8,0
51375,445,0,0,66,66,0,1,0,1,0,2
2839,53,2839,53,229,94,135,2,30,1,1,0
20057,44847,0,0,62,62,0,1,0,1,0,1
36417,443,45000,443,3579,1914,1665,23,291,8,15,0
41027,80,41027,80,18224,2763,15461,29,126,14,15,0
50193,3389,50193,3389,3473,1518,1955,17,19,9,8,0
57005,80,30107,80,214,140,74,4,30,3,1,0
65221,53,38871,53,258,102,156,2,29,1,1,0
60117,50934,0,0,66,66,0,1,0,1,0,1
52976,445,0,0,70,70,0,1,0,1,0,2
47969,53,59484,53,199,94,105,2,30,1,1,0
2886,35440,0,0,66,66,0,1,0,1,0,1
52437,443,30974,443,384,384,0,7,33,7,0,0
56330,53,48273,53,199,102,97,2,30,1,1,0
63761,25933,42159,25933,436,254,182,7,15,4,3,0
62417,443,4381,443,79513,7480,72033,106,122,39,67,0
10006,64147,0,0,62,62,0,1,0,1,0,1
14259,53,14259,53,247,98,149,2,33,1,1,0
55800,53,53999,53,711,87,624,2,30,1,1,0
55733,51505,0,0,66,66,0,1,0,1,0,1
57018,53,57758,53,177,94,83,2,30,1,1,0
49577,57470,0,0,66,66,0,1,0,1,0,1
60309,445,0,0,66,66,0,1,0,1,0,2
61053,443,61053,443,40415,2911,37504,57,18,27,30,0
26900,27017,37818,27017,422,164,258,6,30,3,3,0
53967,54589,5598,54589,70,70,0,2,8,2,0,0
2170,43227,0,0,62,62,0,1,0,1,0,1
51973,44847,0,0,66,66,0,1,0,1,0,1
55691,16410,58376,16410,70,70,0,2,8,2,0,0
55588,53,17857,53,168,86,82,2,34,1,1,0
51943,53,57117,53,200,86,114,2,30,1,1,0
40682,443,13381,443,10010,4051,5959,32,346,17,15,0
57541,445,0,0,70,70,0,1,0,1,0,2
50470,61463,0,0,86,86,0,1,0,1,0,1
51265,63960,52529,63960,70,70,0,2,8,2,0,0
54828,443,1359,443,150,150,0,1,5,1,0,0
1925,53,9734,53,210,78,132,2,30,1,1,0
55114,445,0,0,70,70,0,1,0,1,0,2
53161,443,30923,443,2731,1895,836,18,28,10,8,0
62468,445,0,0,70,70,0,1,0,1,0,2
64104,53,19823,53,288,101,187,4,57,2,2,0
49708,443,3133,443,7772,2563,5209,18,121,9,9,0
58521,445,0,0,70,70,0,1,0,1,0,2
58939,443,28561,443,6403,4065,2338,22,16,11,11,0
22971,50584,0,0,62,62,0,1,0,1,0,1
50690,80,20479,80,4805,3639,1166,16,31,9,7,0
57329,443,20931,443,7472,2014,5458,29,16,16,13,0
54214,443,38557,443,499,425,74,4,0,3,1,0
65014,53,11511,53,718,94,624,2,29,1,1,0
443,9986,0,0,669,669,0,1,0,1,0,1
40151,443,46330,443,80789,5008,75781,92,128,33,59,0
56765,53,6433,53,194,102,92,2,30,1,1,0
50128,80,27649,80,20575,11455,9120,92,966,47,45,0
50201,445,0,0,70,70,0,1,0,1,0,2
57220,445,0,0,70,70,0,1,0,1,0,2
26249,7000,26249,7000,2269,815,1454,14,16,7,7,0
62408,3478,62290,3478,140,140,0,1,30,1,0,0
55288,53,34566,53,196,102,94,2,30,1,1,0
58074,11392,0,0,66,66,0,1,0,1,0,1
36834,80,37812,80,12993,6920,6073,22,20,13,9,0
64094,445,0,0,70,70,0,1,0,1,0,2
55071,53,33464,53,177,94,83,2,31,1,1,0
57470,44046,49985,44046,166,166,0,1,1199,1,0,0
51103,443,36898,443,20280,13177,7103,82,1176,46,36,0
46525,53,46525,53,404,259,145,3,32,2,1,0
60875,50584,0,0,66,66,0,1,0,1,0,1
65479,443,61050,443,92397,4379,88018,102,16,37,65,0
51261,53,15838,53,259,86,173,2,30,1,1,0
64357,53,57507,53,271,85,186,4,30,2,2,0
62189,64147,0,0,145,145,0,1,0,1,0,1
55479,53,50336,53,184,94,90,2,31,1,1,0
9506,443,29564,443,3614,434,3180,11,15,6,5,0
63796,60557,39305,60557,66,66,0,2,8,2,0,0
52356,55442,0,0,66,66,0,1,0,1,0,1
48019,22114,0,0,66,66,0,1,0,1,0,1
58779,445,0,0,70,70,0,1,0,1,0,2
20726,2767,0,0,66,66,0,1,0,1,0,1
37698,443,12829,443,1781,1062,719,16,275,8,8,0
22683,39210,0,0,60,60,0,1,0,1,0,1
55600,22,0,0,60,60,0,1,0,1,0,1
53669,59056,20109,59056,70,70,0,1,5,1,0,0
57101,445,0,0,70,70,0,1,0,1,0,2
49744,53,14742,53,816,102,714,2,30,1,1,0
49781,445,0,0,70,70,0,1,0,1,0,2
55102,53,47869,53,195,102,93,2,30,1,1,0
51300,64147,0,0,66,66,0,1,0,1,0,1
53597,445,0,0,70,70,0,1,0,1,0,2
60947,445,0,0,70,70,0,1,0,1,0,2
55037,445,0,0,66,66,0,1,0,1,0,2
50010,53,28513,53,330,126,204,2,31,1,1,0
59008,51221,0,0,62,62,0,1,0,1,0,1
61495,37965,0,0,66,66,0,1,0,1,0,1
55276,80,42794,80,1594,1280,314,10,15,5,5,0
63083,53,63784,53,303,85,218,2,30,1,1,0
49651,37965,0,0,74,74,0,1,0,1,0,1
56730,53,53565,53,210,110,100,2,30,1,1,0
64437,445,0,0,66,66,0,1,0,1,0,2
24351,57470,0,0,62,62,0,1,0,1,0,1
52552,445,0,0,66,66,0,1,0,1,0,2
53534,40960,13903,40960,320,140,180,6,6,3,3,0
49104,80,61237,80,1638,1324,314,10,15,5,5,0
56392,445,0,0,66,66,0,1,0,1,0,2
1025,40108,0,0,146,146,0,1,0,1,0,1
47274,5223,2647,5223,4269,1451,2818,22,3002,13,9,0
58999,445,0,0,66,66,0,1,0,1,0,2
50474,445,0,0,70,70,0,1,0,1,0,2
50325,80,35970,80,2535,783,1752,13,48,7,6,0
49270,53,43465,53,216,110,106,2,30,1,1,0
64155,53,25938,53,183,94,89,2,30,1,1,0
49536,53,5228,53,239,94,145,2,30,1,1,0
55881,443,18861,443,25586,4360,21226,57,81,29,28,0
49922,445,0,0,70,70,0,1,0,1,0,2
55513,53,5223,53,184,94,90,2,30,1,1,0
50067,64147,0,0,66,66,0,1,0,1,0,1
52033,50584,0,0,66,66,0,1,0,1,0,1
56837,445,0,0,66,66,0,1,0,1,0,2
62299,445,0,0,70,70,0,1,0,1,0,2
65413,445,0,0,70,70,0,1,0,1,0,2
55126,53,24901,53,186,95,91,2,31,1,1,0
50576,53,22318,53,765,102,663,2,29,1,1,0
52743,443,59107,443,1547,960,587,14,26,8,6,0
51628,445,0,0,66,66,0,1,0,1,0,2
61119,53,61119,53,217,90,127,2,29,1,1,0
52809,56205,0,0,146,146,0,1,0,1,0,1
53138,15048,61968,15048,70,70,0,2,7,2,0,0
26978,443,38800,443,7547,2728,4819,26,20,13,13,0
54403,443,27679,443,3486,924,2562,13,122,6,7,0
18608,11392,0,0,66,66,0,1,0,1,0,1
40826,443,36041,443,4125,2847,1278,18,255,10,8,0
14397,37965,0,0,62,62,0,1,0,1,0,1
13418,22,0,0,60,60,0,1,0,1,0,1
53144,53,53144,53,231,90,141,2,31,1,1,0
64331,53,13624,53,226,110,116,2,30,1,1,0
60382,62582,16978,62582,70,70,0,1,5,1,0,0
52754,26467,0,0,62,62,0,1,0,1,0,1
64333,57470,0,0,78,78,0,1,0,1,0,1
57397,53,11845,53,183,94,89,2,29,1,1,0
23066,443,23066,443,5573,2434,3139,21,25,12,9,0
59974,443,8585,443,7820,1344,6476,24,16,13,11,0
52233,42673,65112,42673,136,136,0,3,14,3,0,0
50932,443,17054,443,167483,7402,160081,221,23,93,128,0
59909,445,0,0,70,70,0,1,0,1,0,2
49756,53,23691,53,264,89,175,4,48,2,2,0
37749,15503,0,0,62,62,0,1,0,1,0,1
56288,445,0,0,70,70,0,1,0,1,0,2
50641,443,27533,443,1473,890,583,13,140,7,6,0
37109,80,41807,80,763,434,329,8,14,5,3,0
60269,443,14941,443,499,425,74,4,0,3,1,0
62586,445,0,0,66,66,0,1,0,1,0,2
60971,443,28807,443,396507,14667,381840,458,21,171,287,0
58638,5900,0,0,62,62,0,1,0,1,0,1
64016,53,54267,53,183,94,89,2,30,1,1,0
63180,445,0,0,66,66,0,1,0,1,0,2
63032,22114,0,0,66,66,0,1,0,1,0,1
49797,25174,0,0,66,66,0,1,0,1,0,1
65513,53,15039,53,195,102,93,2,31,1,1,0
48822,53,49162,53,168,78,90,2,30,1,1,0
53460,445,0,0,70,70,0,1,0,1,0,2
38690,443,27226,443,8871,3470,5401,24,123,13,11,0
56773,53,31138,53,183,94,89,2,30,1,1,0
49925,53,18861,53,953,215,738,6,46,3,3,0
63456,37965,0,0,62,62,0,1,0,1,0,1
44182,443,55726,443,8241,1810,6431,25,20,14,11,0
52358,443,40970,443,4145,2738,1407,29,27,16,13,0
26697,37965,0,0,66,66,0,1,0,1,0,1
64022,53,2782,53,197,102,95,2,30,1,1,0
53652,1900,0,0,139,139,0,1,0,1,0,1
17702,6881,0,0,66,66,0,1,0,1,0,1
51035,445,0,0,66,66,0,1,0,1,0,2
59227,11392,0,0,62,62,0,1,0,1,0,1
56461,445,0,0,66,66,0,1,0,1,0,2
58869,445,0,0,70,70,0,1,0,1,0,2
52633,30188,0,0,66,66,0,1,0,1,0,1
16393,22114,0,0,66,66,0,1,0,1,0,1
62014,445,0,0,70,70,0,1,0,1,0,2
49623,443,29272,443,36302,2869,33433,67,180,32,35,0
59245,445,0,0,66,66,0,1,0,1,0,2
59673,445,0,0,66,66,0,1,0,1,0,2
51191,26467,0,0,66,66,0,1,0,1,0,1
63960,53,31296,53,178,94,84,2,30,1,1,0
52113,443,33178,443,17710,1892,15818,37,24,17,20,0
59277,445,0,0,70,70,0,1,0,1,0,2
56961,445,0,0,66,66,0,1,0,1,0,2
60825,445,0,0,66,66,0,1,0,1,0,2
49505,53,42199,53,225,110,115,2,30,1,1,0
64758,445,0,0,66,66,0,1,0,1,0,2
56792,53,2003,53,782,105,677,2,31,1,1,0
50123,445,0,0,70,70,0,1,0,1,0,2
60375,445,0,0,70,70,0,1,0,1,0,2
57432,53,25990,53,193,102,91,2,30,1,1,0
50040,443,40234,443,1097,654,443,12,86,7,5,0
22404,443,22404,443,5576,2436,3140,21,26,12,9,0
47042,80,50684,80,1122,682,440,11,15,6,5,0
57086,53,16252,53,711,87,624,2,30,1,1,0
49576,445,0,0,70,70,0,1,0,1,0,2
10036,44847,0,0,66,66,0,1,0,1,0,1
60311,56205,0,0,66,66,0,1,0,1,0,1
49997,53,1711,53,209,110,99,2,30,1,1,0
52194,22674,46846,22674,70,70,0,2,8,2,0,0
27005,30007,41112,30007,890,126,764,2,31,1,1,0
51369,445,0,0,66,66,0,1,0,1,0,2
50296,53,43204,53,183,94,89,2,29,1,1,0
37098,443,22843,443,1835,1190,645,17,26,10,7,0
443,64347,0,0,131,131,0,1,0,1,0,1
43175,53,11498,53,194,86,108,2,30,1,1,0
58781,443,48906,443,6673,4335,2338,22,16,11,11,0
53353,26467,0,0,62,62,0,1,0,1,0,1
65234,53,55204,53,248,110,138,2,29,1,1,0
50709,445,0,0,70,70,0,1,0,1,0,2
52068,39864,30686,39864,70,70,0,1,5,1,0,0
59493,44847,0,0,66,66,0,1,0,1,0,1
51965,48708,36849,48708,66,66,0,1,5,1,0,0
50691,80,62082,80,4237,3610,627,15,31,8,7,0
49863,443,31339,443,6057,1038,5019,20,56,11,9,0
39132,44847,0,0,62,62,0,1,0,1,0,1
1025,46232,0,0,145,145,0,1,0,1,0,1
38703,443,53775,443,90561,3481,87080,96,16,31,65,0
55161,53,36813,53,197,94,103,2,30,1,1,0
50036,53,50623,53,353,118,235,2,31,1,1,0
59636,443,44710,443,3197,1047,2150,15,120,8,7,0
42796,22114,0,0,146,146,0,1,0,1,0,1
53103,445,0,0,70,70,0,1,0,1,0,2
65365,445,0,0,70,70,0,1,0,1,0,2
61865,35440,0,0,66,66,0,1,0,1,0,1
9327,57470,0,0,62,62,0,1,0,1,0,1
39536,80,4904,80,2749,1732,1017,21,361,12,9,0
64219,53,14756,53,403,94,309,4,38,2,2,0
27005,27021,28946,27021,879,126,753,2,31,1,1,0
53871,43266,32431,43266,70,70,0,1,5,1,0,0
30434,53,30434,53,197,90,107,2,30,1,1,0
51555,445,0,0,66,66,0,1,0,1,0,2
49710,445,0,0,66,66,0,1,0,1,0,2
33801,62413,0,0,66,66,0,1,0,1,0,1
38976,46824,0,0,62,62,0,1,0,1,0,1
35085,443,56294,443,1617,1062,555,13,45,8,5,0
55338,445,0,0,70,70,0,1,0,1,0,2
53794,443,48669,443,499,425,74,4,0,3,1,0
39570,443,62469,443,70,70,0,1,5,1,0,0
50378,443,15906,443,8663,1983,6680,21,33,10,11,0
61460,80,11498,80,1507,1184,323,11,79,7,4,0
3478,61463,0,0,902,902,0,1,0,1,0,1
56020,53,48606,53,168,86,82,2,31,1,1,0
11317,61248,0,0,143,143,0,1,0,1,0,3
58638,5900,0,0,62,62,0,1,0,1,0,1
38445,443,60732,443,23571,4700,18871,60,48,30,30,0
54266,445,0,0,66,66,0,1,0,1,0,2
50211,1688,3994,1688,70,70,0,1,4,1,0,0
65507,53,7082,53,229,102,127,2,30,1,1,0
53755,445,0,0,66,66,0,1,0,1,0,2
51956,443,47122,443,8256,3157,5099,28,46,16,12,0
65497,53,35507,53,194,99,95,2,31,1,1,0
56435,80,7640,80,17248,1619,15629,26,25,11,15,0
33067,53,47200,53,168,78,90,2,30,1,1,0
44674,80,41945,80,1298,624,674,12,16,5,7,0
65385,53,9523,53,227,110,117,2,30,1,1,0
19068,37965,0,0,62,62,0,1,0,1,0,1
51838,29448,55370,29448,70,70,0,2,7,2,0,0
62025,445,0,0,70,70,0,1,0,1,0,2
64217,53,33943,53,193,102,91,2,30,1,1,0
60222,80,61233,80,1989,1365,624,11,151,6,5,0
64238,53,6347,53,215,102,113,2,30,1,1,0
56848,19556,15601,19556,66,66,0,1,5,1,0,0
52787,443,54390,443,1550,834,716,19,141,10,9,0
27988,40031,63445,40031,140,78,62,2,30,1,1,0
63974,445,0,0,70,70,0,1,0,1,0,2
53222,443,42780,443,4531,974,3557,18,65,10,8,0
31404,52955,0,0,100,100,0,1,0,1,0,1
45713,53,45713,53,217,87,130,2,30,1,1,0
443,20087,0,0,83,83,0,1,0,1,0,1
53337,445,0,0,70,70,0,1,0,1,0,2
59755,53,7532,53,211,78,133,2,30,1,1,0
49767,53,46615,53,200,102,98,2,31,1,1,0
53766,51505,0,0,66,66,0,1,0,1,0,1
65289,53,55210,53,179,94,85,2,30,1,1,0
3436,46783,0,0,62,62,0,1,0,1,0,1
53252,443,50911,443,6899,2368,4531,27,27,14,13,0
23079,9694,0,0,62,62,0,1,0,1,0,1
56602,443,27563,443,7942,1953,5989,20,15,11,9,0
57992,80,4887,80,10247,3696,6551,32,33,16,16,0
64208,53,37921,53,194,94,100,2,29,1,1,0
14084,43890,0,0,146,146,0,1,0,1,0,1
50951,53,0,0,82,82,0,1,30,1,0,0
6881,6889,24381,6889,228,118,110,2,1199,1,1,0
57169,53,55765,53,458,188,270,6,31,3,3,0
55605,53,27341,53,195,102,93,2,30,1,1,0
53192,445,0,0,66,66,0,1,0,1,0,2
49535,445,0,0,66,66,0,1,0,1,0,2
27005,27015,65078,27015,878,126,752,2,30,1,1,0
59543,443,39979,443,7358,2661,4697,22,17,11,11,0
55711,26467,0,0,66,66,0,1,0,1,0,1
65516,53,16518,53,209,110,99,2,31,1,1,0
44147,64147,0,0,62,62,0,1,0,1,0,1
50547,22197,0,0,66,66,0,1,0,1,0,1
51227,445,0,0,70,70,0,1,0,1,0,2
64684,53,47246,53,184,94,90,2,30,1,1,0
42685,51180,0,0,62,62,0,1,0,1,0,1
55156,53,47092,53,256,87,169,4,36,2,2,0
49385,53,7961,53,214,102,112,2,30,1,1,0
42106,443,29417,443,5361,973,4388,18,15,10,8,0
2238,22114,0,0,62,62,0,1,0,1,0,1
46516,57470,0,0,62,62,0,1,0,1,0,1
53257,37450,0,0,66,66,0,1,0,1,0,1
49515,53,21422,53,226,110,116,2,29,1,1,0
6666,21,0,0,60,60,0,1,0,1,0,1
60015,443,28429,443,6340,3788,2552,21,143,10,11,0
51413,1,0,0,72,72,0,1,0,1,0,1
59563,30188,0,0,66,66,0,1,0,1,0,1
24041,55783,0,0,62,62,0,1,0,1,0,1
65289,53,55084,53,174,89,85,2,31,1,1,0
57142,53,22612,53,165,86,79,2,31,1,1,0
46327,25903,25335,25903,332,192,140,6,25,4,2,0
49348,53,28507,53,312,96,216,4,35,2,2,0
443,49988,0,0,82,82,0,1,0,1,0,1
54977,53,63603,53,275,93,182,4,32,2,2,0
58537,445,0,0,66,66,0,1,0,1,0,2
60728,445,0,0,70,70,0,1,0,1,0,2
18130,25174,0,0,62,62,0,1,0,1,0,1
55062,80,41792,80,486,240,246,9,28,5,4,0
56295,443,26147,443,8550,1880,6670,22,376,12,10,0
59430,50584,0,0,66,66,0,1,0,1,0,1
42796,22114,0,0,62,62,0,1,0,1,0,1
24504,37965,0,0,62,62,0,1,0,1,0,1
52261,53,8647,53,578,286,292,9,15,5,4,0
28436,22114,0,0,146,146,0,1,0,1,0,1
50246,445,0,0,70,70,0,1,0,1,0,2
56941,53,56569,53,193,102,91,2,30,1,1,0
55842,443,52718,443,8661,2036,6625,40,256,19,21,0
56802,443,7219,443,8072,2052,6020,20,15,11,9,0
57913,443,45296,443,9578079,276384,9301695,9817,153,2984,6833,0
34994,443,34994,443,5046,2069,2977,20,15,11,9,0
58594,445,0,0,70,70,0,1,0,1,0,2
55748,53,53147,53,194,102,92,2,31,1,1,0
62401,445,0,0,70,70,0,1,0,1,0,2
20388,53,20388,53,217,90,127,2,30,1,1,0
27005,27017,8108,27017,1658,126,1532,4,30,2,2,0
55644,445,0,0,70,70,0,1,0,1,0,2
4127,26467,0,0,66,66,0,1,0,1,0,1
40512,57470,0,0,74,74,0,1,0,1,0,1
60586,445,0,0,70,70,0,1,0,1,0,2
1594,44847,0,0,62,62,0,1,0,1,0,1
51504,443,9734,443,6656,769,5887,14,16,9,5,0
50920,445,0,0,70,70,0,1,0,1,0,2
52729,443,62575,443,9026,3447,5579,50,45,26,24,0
42298,40007,31436,40007,148,86,62,2,30,1,1,0
51833,445,0,0,66,66,0,1,0,1,0,2
51207,443,64631,443,12171,2763,9408,53,17,30,23,0
51598,443,10892,443,14194,4643,9551,34,30,19,15,0
51086,443,36949,443,11749,5336,6413,32,153,18,14,0
6890,27520,0,0,146,146,0,1,0,1,0,1
56367,443,5869,443,4863,3011,1852,20,234,12,8,0
52150,39109,0,0,66,66,0,1,0,1,0,1
56143,53,42893,53,195,94,101,2,30,1,1,0
49631,53,6299,53,198,102,96,2,33,1,1,0
50556,80,38454,80,378,192,186,7,26,4,3,0
51166,31573,0,0,66,66,0,1,0,1,0,1
65277,53,40732,53,199,102,97,2,30,1,1,0
19698,502,0,0,60,60,0,1,0,1,0,1
37584,443,21310,443,499,425,74,4,0,3,1,0
50069,53,45809,53,764,102,662,2,29,1,1,0
63455,445,0,0,70,70,0,1,0,1,0,2
15341,23,0,0,60,60,0,1,0,1,0,1
51186,445,0,0,66,66,0,1,0,1,0,2
49558,53,29414,53,177,94,83,2,30,1,1,0
12694,22114,0,0,66,66,0,1,0,1,0,1
52361,443,27364,443,7488,2474,5014,23,3600,12,11,0
64567,53,13390,53,193,102,91,2,30,1,1,0
47302,53,19968,53,168,78,90,2,30,1,1,0
5394,23,5394,23,124,60,64,2,5,1,1,0
57587,80,57587,80,218150,5323,212827,218,145,69,149,0
46518,44847,0,0,62,62,0,1,0,1,0,1
55648,445,0,0,70,70,0,1,0,1,0,2
27005,27025,27504,27025,895,126,769,2,30,1,1,0
23122,26296,0,0,159,159,0,1,0,1,0,1
65118,53,14399,53,539,91,448,4,43,2,2,0
62852,445,0,0,70,70,0,1,0,1,0,2
60227,443,25151,443,6553,871,5682,19,45,9,10,0
55990,53,40258,53,182,93,89,2,30,1,1,0
49608,445,0,0,70,70,0,1,0,1,0,1
49826,443,4711,443,1738,1159,579,16,74,10,6,0
51388,443,52372,443,20351,3359,16992,52,103,27,25,0
27844,52700,0,0,74,74,0,1,0,1,0,1
22733,26467,0,0,62,62,0,1,0,1,0,1
59119,445,0,0,70,70,0,1,0,1,0,2
52037,445,0,0,66,66,0,1,0,1,0,2
57346,445,0,0,66,66,0,1,0,1,0,2
56937,53,51825,53,178,91,87,2,30,1,1,0
54742,37965,0,0,66,66,0,1,0,1,0,1
53614,443,10121,443,8347,1979,6368,32,19,17,15,0
56432,53,38041,53,195,102,93,2,30,1,1,0
27005,33059,58962,33059,900,126,774,3,30,2,1,0
64473,53,45476,53,184,94,90,2,30,1,1,0
58600,443,58600,443,4396,1489,2907,19,26,11,8,0
55024,53,61199,53,174,89,85,2,30,1,1,0
59124,443,18887,443,9612,1720,7892,32,130,15,17,0
49623,53,34250,53,790,110,680,2,29,1,1,0
49367,53,30708,53,389,94,295,4,55,2,2,0
58318,445,0,0,66,66,0,1,0,1,0,2
52191,443,46265,443,7882,810,7072,21,15,9,12,0
52450,445,0,0,70,70,0,1,0,1,0,2
22530,23718,0,0,66,66,0,1,0,1,0,1
51893,445,0,0,66,66,0,1,0,1,0,2
65172,53,3984,53,211,102,109,2,30,1,1,0
42744,443,24894,443,224178,118713,105465,333,140,162,171,0
57074,53,64644,53,195,102,93,2,30,1,1,0
49856,443,13732,443,18685,4528,14157,31,151,13,18,0
50127,80,7047,80,164773,6196,158577,200,135,83,117,0
49709,80,19787,80,1702,1388,314,10,15,5,5,0
41613,80,21847,80,6003,691,5312,13,16,7,6,0
50013,53,8187,53,199,102,97,2,30,1,1,0
49814,445,0,0,70,70,0,1,0,1,0,2
63561,445,0,0,70,70,0,1,0,1,0,2
52967,443,11017,443,9893,2231,7662,42,113,21,21,0
60848,443,33330,443,6513,1863,4650,28,255,15,13,0
51691,445,0,0,70,70,0,1,0,1,0,2
56782,53,51399,53,197,94,103,2,30,1,1,0
55688,53,51379,53,184,94,90,2,30,1,1,0
55384,53,33566,53,212,102,110,2,30,1,1,0
57007,53,36349,53,183,94,89,2,31,1,1,0
49494,445,0,0,66,66,0,1,0,1,0,2
60546,443,51628,443,52666,33941,18725,95,139,49,46,0
62431,445,0,0,70,70,0,1,0,1,0,2
55551,445,0,0,70,70,0,1,0,1,0,2
49790,53,8407,53,229,110,119,2,30,1,1,0
65140,53,14372,53,199,102,97,2,30,1,1,0
62282,445,0,0,70,70,0,1,0,1,0,2
57405,443,36790,443,5734,1543,4191,24,26,13,11,0
56638,445,0,0,66,66,0,1,0,1,0,2
56006,445,0,0,70,70,0,1,0,1,0,2
59161,445,0,0,70,70,0,1,0,1,0,2
59970,443,18481,443,6720,1166,5554,22,360,11,11,0
56805,443,33799,443,8022,2002,6020,20,15,11,9,0
49680,26467,0,0,146,146,0,1,0,1,0,1
80,37649,0,0,60,60,0,1,0,1,0,1
46760,50584,0,0,146,146,0,1,0,1,0,1
64195,53,9148,53,270,110,160,2,29,1,1,0
64546,57470,0,0,66,66,0,1,0,1,0,1
50321,445,0,0,70,70,0,1,0,1,0,2
64214,53,1437,53,337,106,231,4,43,2,2,0
53035,5228,40515,5228,2725,1610,1115,20,3600,10,10,0
50027,21247,0,0,62,62,0,1,0,1,0,1
56552,53,47161,53,195,102,93,2,29,1,1,0
63179,445,0,0,70,70,0,1,0,1,0,2
64204,53,35802,53,193,102,91,2,30,1,1,0
2267,53,10522,53,204,118,86,2,30,1,1,0
53559,58968,7595,58968,70,70,0,2,7,2,0,0
42356,443,3759,443,276,70,206,5,26,2,3,0
61745,443,5419,443,8123,5308,2815,18,134,9,9,0
58432,445,0,0,70,70,0,1,0,1,0,2
65299,53,37280,53,177,94,83,2,30,1,1,0
58870,443,34912,443,21207,14062,7145,50,19,28,22,0
64706,27065,37449,27065,924,924,0,3,30,3,0,0
55301,443,54571,443,9881,1486,8395,22,200,12,10,0
63763,17368,13988,17368,66,66,0,2,8,2,0,0
50711,445,0,0,70,70,0,1,0,1,0,2
17010,57470,0,0,62,62,0,1,0,1,0,1
55871,53,54072,53,189,102,87,2,30,1,1,0
61733,443,10616,443,168812,5693,163119,186,21,68,118,0
59753,27016,15718,27016,1718,1386,332,8,30,4,4,0
56186,53,36968,53,198,102,96,2,30,1,1,0
54206,445,0,0,70,70,0,1,0,1,0,2
56134,53,19695,53,167,86,81,2,30,1,1,0
58346,53,2203,53,209,102,107,2,30,1,1,0
59312,22,59312,22,327,140,187,4,0,2,2,1
52062,443,2872,443,61141,52577,8564,102,363,50,52,0
50850,445,0,0,66,66,0,1,0,1,0,2
17786,44847,0,0,62,62,0,1,0,1,0,1
50996,443,60752,443,12654,1719,10935,28,21,15,13,0
53934,443,47963,443,360,360,0,7,4,7,0,0
46026,443,9317,443,8908,3897,5011,19,135,9,10,0
55315,53,41500,53,192,98,94,2,31,1,1,0
52569,30188,0,0,66,66,0,1,0,1,0,1
64044,445,0,0,70,70,0,1,0,1,0,2
58638,5900,0,0,62,62,0,1,0,1,0,1
51967,443,38807,443,10684,3167,7517,43,34,24,19,0
54909,445,0,0,70,70,0,1,0,1,0,2
64968,53,62769,53,767,102,665,2,30,1,1,0
38211,443,38211,443,4653,1746,2907,19,26,11,8,0
50584,49001,36650,49001,1290,300,990,6,1200,3,3,0
65066,53,65066,53,240,98,142,2,30,1,1,0
52925,64147,0,0,62,62,0,1,0,1,0,1
57067,53,18004,53,183,94,89,2,29,1,1,0
53122,443,25117,443,23067,5901,17166,43,73,21,22,0
56717,53,46335,53,178,94,84,2,31,1,1,0
55386,53,64239,53,822,102,720,2,30,1,1,0
64799,443,56278,443,1671,1004,667,16,76,8,8,0
64170,53,8544,53,355,118,237,2,30,1,1,0
38468,53,0,0,82,82,0,2,40,2,0,0
8191,51221,0,0,62,62,0,1,0,1,0,1
56216,5228,61293,5228,2495,1477,1018,17,3600,8,9,0
58638,5900,58638,5900,126,62,64,2,5,1,1,0
52565,445,0,0,70,70,0,1,0,1,0,2
64277,53,1694,53,337,110,227,2,30,1,1,0
60480,80,35551,80,7406,1038,6368,18,16,10,8,0
58375,445,0,0,66,66,0,1,0,1,0,2
57396,53,7718,53,184,94,90,2,30,1,1,0
36276,7000,36276,7000,3638,2027,1611,17,15,9,8,0
56962,53,33318,53,210,102,108,2,30,1,1,0
38444,443,18273,443,3547,955,2592,13,120,6,7,0
62785,445,0,0,70,70,0,1,0,1,0,2
45941,23388,0,0,60,60,0,1,0,1,0,1
50730,445,0,0,70,70,0,1,0,1,0,2
42030,25,0,0,74,74,0,1,0,1,0,1
65237,445,0,0,70,70,0,1,0,1,0,2
50313,445,0,0,70,70,0,1,0,1,0,2
49258,80,49258,80,17197,1551,15646,29,27,13,16,0
42344,48637,0,0,60,60,0,1,0,1,0,1
55244,445,0,0,70,70,0,1,0,1,0,2
52474,123,6683,123,184,94,90,2,30,1,1,0
59736,51505,0,0,62,62,0,1,0,1,0,1
49941,53,34590,53,186,95,91,2,31,1,1,0
56496,53,60823,53,186,95,91,2,30,1,1,0
34932,38608,0,0,62,62,0,1,0,1,0,1
58638,5900,0,0,62,62,0,1,0,1,0,1
44554,5900,0,0,60,60,0,1,0,1,0,1
56407,445,0,0,70,70,0,1,0,1,0,2
10006,64147,0,0,145,145,0,1,0,1,0,1
49742,443,32248,443,4490,750,3740,16,128,8,8,0
37959,3855,0,0,72,72,0,1,0,1,0,1
51075,445,0,0,70,70,0,1,0,1,0,2
59948,80,1436,80,1756,414,1342,12,15,6,6,0
53916,23505,16942,23505,70,70,0,1,5,1,0,0
64168,53,53054,53,306,94,212,2,30,1,1,0
51874,43161,58126,43161,70,70,0,2,8,2,0,0
60192,35440,0,0,66,66,0,1,0,1,0,1
57371,53,5536,53,214,110,104,2,30,1,1,0
50822,445,0,0,70,70,0,1,0,1,0,2
55643,53,36774,53,183,94,89,2,30,1,1,0
60740,443,50087,443,12605,5558,7047,42,101,18,24,0
49592,80,33337,80,4173,2324,1849,14,42,8,6,0
57051,443,6628,443,594793,518081,76712,1350,1004,781,569,0
58555,443,6848,443,15546,2361,13185,39,123,18,21,0
39839,443,5588,443,5829,1408,4421,21,188,11,10,0
48308,443,61860,443,4654,2499,2155,17,31,9,8,0
7539,53,7539,53,194,87,107,2,30,1,1,0
40202,5222,32011,5222,5958,2420,3538,40,25,20,20,0
50584,63015,51175,63015,166,166,0,1,1200,1,0,0
51795,60258,12488,60258,70,70,0,2,8,2,0,0
44710,25174,0,0,62,62,0,1,0,1,0,1
56636,43890,0,0,66,66,0,1,0,1,0,1
50535,53,14934,53,210,110,100,2,29,1,1,0
50468,80,50468,80,90393,7684,82709,132,22,69,63,0
6881,6881,37919,6881,238,118,120,2,1200,1,1,0
63955,445,0,0,70,70,0,1,0,1,0,2
16393,22114,0,0,62,62,0,1,0,1,0,1
19502,53,19502,53,198,89,109,2,31,1,1,0
49218,443,48762,443,8929,3316,5613,38,255,18,20,0
56532,53,37108,53,164,86,78,2,30,1,1,0
50274,445,0,0,70,70,0,1,0,1,0,2
38783,443,19297,443,584,370,214,9,25,6,3,0
50444,80,3294,80,378,192,186,7,19,4,3,0
39422,443,26393,443,557795,16003,541792,528,76,139,389,0
56111,53,27769,53,227,110,117,2,30,1,1,0
61967,445,0,0,70,70,0,1,0,1,0,2
55056,53,24229,53,177,94,83,2,30,1,1,0
54782,445,0,0,70,70,0,1,0,1,0,2
46785,53,46785,53,230,91,139,2,30,1,1,0
58638,5900,0,0,62,62,0,1,0,1,0,1
58858,443,56785,443,7413235,214811,7198424,7869,344,2785,5084,0
52993,443,64908,443,16229,3316,12913,23,125,9,14,0
30960,45718,62760,45718,330,330,0,6,3609,6,0,0
50484,80,53622,80,318,192,126,6,26,4,2,0
56760,443,12477,443,8006,1986,6020,20,15,11,9,0
27005,27015,55058,27015,1666,126,1540,4,31,2,2,0
44258,25,0,0,74,74,0,1,0,1,0,1
56742,53,0,0,82,82,0,2,40,2,0,0
57132,443,41283,443,6489,1065,5424,22,255,12,10,0
55942,53,46906,53,194,99,95,2,31,1,1,0
57557,64147,0,0,66,66,0,1,0,1,0,1
56724,443,37476,443,7941,1952,5989,20,15,11,9,0
52430,35440,0,0,62,62,0,1,0,1,0,1
51383,445,0,0,70,70,0,1,0,1,0,2
39851,443,44930,443,9355,3422,5933,56,16,28,28,0
51918,445,0,0,70,70,0,1,0,1,0,2
50427,443,32859,443,783009,84254,698755,776,706,250,526,0
61031,445,0,0,70,70,0,1,0,1,0,2
55086,445,0,0,70,70,0,1,0,1,0,2
50397,445,0,0,70,70,0,1,0,1,0,2
36837,443,3546,443,9311,1387,7924,20,31,10,10,0
56968,443,61875,443,5649,2005,3644,21,186,11,10,0
54739,445,0,0,66,66,0,1,0,1,0,2
53667,22114,0,0,66,66,0,1,0,1,0,1
58847,443,11614,443,7014,1630,5384,20,120,10,10,0
54155,445,0,0,70,70,0,1,0,1,0,2
37460,443,55415,443,2885,1732,1153,16,256,9,7,0
50037,53,63751,53,195,102,93,2,31,1,1,0
65265,53,37973,53,821,102,719,2,30,1,1,0
21482,22114,0,0,62,62,0,1,0,1,0,1
65348,53,2839,53,177,94,83,2,30,1,1,0
5223,44091,0,0,119,119,0,1,0,1,0,1
65167,445,0,0,70,70,0,1,0,1,0,2
62913,445,0,0,70,70,0,1,0,1,0,2
52159,445,0,0,66,66,0,1,0,1,0,2
59786,25174,0,0,66,66,0,1,0,1,0,1
51635,80,51635,80,699944,13137,686807,676,20,195,481,0
60209,445,0,0,70,70,0,1,0,1,0,2
57008,123,60959,123,184,94,90,2,30,1,1,0
52348,445,0,0,70,70,0,1,0,1,0,2
54959,53,54959,53,230,90,140,2,29,1,1,0
60020,443,30222,443,495428,22440,472988,692,106,316,376,0
27005,27016,2493,27016,895,126,769,2,30,1,1,0
56328,36237,0,0,66,66,0,1,0,1,0,1
58638,5900,58638,5900,156,62,94,2,10,1,1,0
55423,445,0,0,70,70,0,1,0,1,0,2
49529,445,0,0,70,70,0,1,0,1,0,2
61865,35440,0,0,66,66,0,1,0,1,0,1
44962,8802,46440,8802,4014,2342,1672,42,386,21,21,0
6881,8229,31730,8229,150,150,0,1,1200,1,0,0
58638,5900,0,0,62,62,0,1,0,1,0,1
56756,53,14084,53,167,86,81,2,30,1,1,0
49875,443,6451,443,31715,20427,11288,103,54,54,49,0
49232,53,52451,53,242,78,164,2,29,1,1,0
65469,53,59478,53,190,97,93,2,30,1,1,0
57254,443,23704,443,6000,1578,4422,22,36,12,10,0
55333,445,0,0,70,70,0,1,0,1,0,2
26879,37965,0,0,62,62,0,1,0,1,0,1
52107,53,0,0,210,77,133,2,29,1,1,0
65465,53,17852,53,755,102,653,2,29,1,1,0
57723,445,0,0,70,70,0,1,0,1,0,2
60431,443,1098,443,3260,1646,1614,9,120,5,4,0
51169,443,30146,443,975832,29038,946794,991,51,341,650,0
54762,53,0,0,86,86,0,1,30,1,0,0
16387,22272,0,0,60,60,0,1,0,1,0,1
37174,443,43183,443,752907,69016,683891,1372,231,537,835,0
32837,443,39597,443,3167,1498,1669,19,315,10,9,0
51884,22828,1526,22828,70,70,0,1,5,1,0,0
57204,443,62645,443,340,140,200,6,25,3,3,0
58461,445,0,0,70,70,0,1,0,1,0,2
51032,445,0,0,66,66,0,1,0,1,0,2
57264,53,5808,53,197,102,95,2,29,1,1,0
60212,445,0,0,70,70,0,1,0,1,0,2
15503,14130,48221,14130,480,149,331,2,1200,1,1,0
49230,445,0,0,66,66,0,1,0,1,0,2
60171,443,39238,443,1059,556,503,12,25,6,6,0
62331,61689,0,0,66,66,0,1,0,1,0,1
65317,51221,0,0,78,78,0,1,0,1,0,1
57430,53,65274,53,177,94,83,2,30,1,1,0
16387,35244,0,0,60,60,0,1,0,1,0,1
52989,51505,0,0,66,66,0,1,0,1,0,1
58801,445,0,0,70,70,0,1,0,1,0,2
55395,445,0,0,70,70,0,1,0,1,0,2
65224,53,48832,53,758,93,665,2,30,1,1,0
64767,51221,0,0,62,62,0,1,0,1,0,1
51966,443,55026,443,35199,15909,19290,70,152,34,36,0
35844,443,58126,443,5196,1875,3321,45,5922,12,33,0
49898,80,5457,80,1550,1157,393,8,86,5,3,0
59009,445,0,0,70,70,0,1,0,1,0,2
8884,443,38785,443,5307,3288,2019,25,397,8,17,0
60579,25174,0,0,62,62,0,1,0,1,0,1
62324,445,0,0,70,70,0,1,0,1,0,2
63717,37965,0,0,66,66,0,1,0,1,0,1
51042,22114,0,0,66,66,0,1,0,1,0,1
1027,23684,0,0,159,159,0,1,0,1,0,1
57228,53,47428,53,199,102,97,2,30,1,1,0
62263,445,0,0,70,70,0,1,0,1,0,2
49281,53,63913,53,251,102,149,2,30,1,1,0
50487,445,0,0,70,70,0,1,0,1,0,2
63679,443,51267,443,7987,2092,5895,18,119,8,10,0
55194,53,21353,53,195,102,93,2,29,1,1,0
50265,41071,33048,41071,1716,1716,0,27,2188,27,0,0
57677,57470,0,0,62,62,0,1,0,1,0,1
63810,27064,25460,27064,1778,1386,392,8,31,4,4,0
57435,443,34425,443,13536,5529,8007,55,18,24,31,0
33812,443,2950,443,16120,8754,7366,36,327,21,15,0
53105,61310,38041,61310,70,70,0,1,5,1,0,0
56450,53,63813,53,177,94,83,2,30,1,1,0
56707,445,0,0,70,70,0,1,0,1,0,2
53456,445,0,0,70,70,0,1,0,1,0,2
52128,37807,0,0,66,66,0,1,0,1,0,1
53881,11513,24027,11513,320,140,180,6,5,3,3,0
26494,26467,0,0,62,62,0,1,0,1,0,1
62716,23,0,0,60,60,0,1,0,1,0,1
54737,50584,0,0,66,66,0,1,0,1,0,1
11362,64147,0,0,145,145,0,1,0,1,0,1
56989,80,28425,80,526,304,222,8,35,5,3,0
61398,80,61398,80,1917,1468,449,10,19,6,4,0
49186,443,54954,443,508520,13734,494786,527,18,192,335,0
58638,5900,0,0,62,62,0,1,0,1,0,1
64344,53,14813,53,568,192,376,6,71,3,3,0
53260,53,10585,53,199,94,105,2,30,1,1,0
7619,50584,0,0,146,146,0,1,0,1,0,1
60217,445,0,0,70,70,0,1,0,1,0,2
49418,27015,63355,27015,244,78,166,2,30,1,1,0
30181,61689,0,0,62,62,0,1,0,1,0,1
29177,44847,0,0,66,66,0,1,0,1,0,1
63262,445,0,0,70,70,0,1,0,1,0,2
50354,445,0,0,70,70,0,1,0,1,0,2
56519,53,32715,53,711,87,624,2,30,1,1,0
36191,443,31290,443,9386,1934,7452,32,135,17,15,0
56652,53,11062,53,177,94,83,2,30,1,1,0
56924,53,57471,53,177,94,83,2,30,1,1,0
53048,445,0,0,66,66,0,1,0,1,0,2
58813,80,56191,80,2393,551,1842,10,21,6,4,0
60192,35440,0,0,66,66,0,1,0,1,0,1
53594,445,0,0,70,70,0,1,0,1,0,2
44065,443,13980,443,6114,862,5252,17,71,9,8,0
51708,21278,38128,21278,70,70,0,1,5,1,0,0
55320,53,12991,53,239,102,137,2,30,1,1,0
3478,61463,0,0,1306,1306,0,1,0,1,0,1
56496,53,28777,53,193,102,91,2,30,1,1,0
11988,48817,0,0,66,66,0,1,0,1,0,1
52741,24211,0,0,66,66,0,1,0,1,0,1
64068,53,64068,53,1184,83,1101,4,59,2,2,0
51310,64147,0,0,66,66,0,1,0,1,0,1
52830,445,0,0,70,70,0,1,0,1,0,2
52025,443,47252,443,8034,2692,5342,15,16,8,7,0
45510,443,22832,443,130,70,60,2,15,1,1,0
50889,445,0,0,70,70,0,1,0,1,0,2
33087,53,33087,53,228,97,131,2,31,1,1,0
42414,50939,0,0,148,148,0,1,0,1,0,1
56422,53,41175,53,199,102,97,2,30,1,1,0
50611,445,0,0,66,66,0,1,0,1,0,2
58966,30188,0,0,66,66,0,1,0,1,0,1
10151,6881,61137,6881,469,150,319,2,1200,1,1,0
57017,53,22107,53,177,94,83,2,30,1,1,0
65060,53,36666,53,761,100,661,2,30,1,1,0
51914,20777,59494,20777,256,136,120,5,8,3,2,0
55699,445,0,0,70,70,0,1,0,1,0,2
56563,53,53188,53,292,126,166,2,30,1,1,0
50969,445,0,0,70,70,0,1,0,1,0,2
2467,2767,0,0,62,62,0,1,0,1,0,1
60159,445,0,0,66,66,0,1,0,1,0,2
63584,443,24147,443,3182,1568,1614,8,120,4,4,0
16387,8455,0,0,60,60,0,1,0,1,0,1
64815,445,0,0,70,70,0,1,0,1,0,2
51640,80,25604,80,2895,1428,1467,12,38,7,5,0
9504,25174,0,0,146,146,0,1,0,1,0,1
65284,445,0,0,70,70,0,1,0,1,0,2
11592,80,11592,80,6967,765,6202,15,16,7,8,0
56307,53,24670,53,185,102,83,2,29,1,1,0
59127,445,0,0,66,66,0,1,0,1,0,2
55666,35440,0,0,66,66,0,1,0,1,0,1
54830,443,23517,443,4478,1133,3345,13,26,8,5,0
33262,443,40811,443,4067,2672,1395,23,23,14,9,0
59889,443,31832,443,1576,973,603,14,28,7,7,0
50880,445,0,0,70,70,0,1,0,1,0,2
49418,49000,14471,49000,270,78,192,2,30,1,1,0
65328,445,0,0,70,70,0,1,0,1,0,2
53987,16571,41017,16571,70,70,0,2,7,2,0,0
30960,45762,15257,45762,330,330,0,6,3609,6,0,0
51166,443,54384,443,13072,4708,8364,47,130,24,23,0
62042,445,0,0,66,66,0,1,0,1,0,2
53161,30013,56221,30013,70,70,0,1,5,1,0,0
59051,445,0,0,70,70,0,1,0,1,0,2
55018,53,37429,53,179,94,85,2,30,1,1,0
31738,51505,0,0,62,62,0,1,0,1,0,1
50302,80,5947,80,5100,1620,3480,17,114,10,7,0
50937,445,0,0,70,70,0,1,0,1,0,2
50272,53,50516,53,168,78,90,2,30,1,1,0
56883,53,20999,53,184,94,90,2,30,1,1,0
49637,53,40941,53,255,102,153,2,30,1,1,0
54955,445,0,0,70,70,0,1,0,1,0,2
35985,443,7017,443,6250,1312,4938,23,28,12,11,0
50124,443,33361,443,24329,7675,16654,47,16,25,22,0
56667,53,55956,53,199,102,97,2,29,1,1,0
60463,445,0,0,66,66,0,1,0,1,0,2
31019,53,31019,53,194,87,107,2,30,1,1,0
51211,443,40776,443,7638,2405,5233,44,17,25,19,0
53500,443,53500,443,960,539,421,9,35,5,4,0
49923,80,28185,80,1126,609,517,11,15,6,5,0
49481,53,49481,53,222,101,121,2,31,1,1,0
53180,443,55711,443,7876,3195,4681,22,20,11,11,0
53864,443,51683,443,232,172,60,3,5,2,1,0
58045,443,63795,443,3296,1329,1967,14,135,7,7,0
55172,443,53179,443,25605,3359,22246,47,82,26,21,0
51462,445,0,0,70,70,0,1,0,1,0,2
48706,23393,0,0,60,60,0,1,0,1,0,1
34488,443,33891,443,8363,1573,6790,24,49,14,10,0
57259,53,28924,53,167,86,81,2,29,1,1,0
56477,53,13759,53,199,102,97,2,30,1,1,0
55973,25174,0,0,62,62,0,1,0,1,0,1
50126,443,34426,443,15032,5689,9343,51,35,27,24,0
51397,445,0,0,66,66,0,1,0,1,0,2
63139,53,41966,53,78,78,0,1,30,1,0,0
57196,445,0,0,70,70,0,1,0,1,0,2
25237,25174,0,0,62,62,0,1,0,1,0,1
53377,445,0,0,66,66,0,1,0,1,0,2
7001,6881,0,0,62,62,0,1,0,1,0,1
49948,445,0,0,70,70,0,1,0,1,0,2
8999,1,0,0,62,62,0,1,0,1,0,1
56606,53,17065,53,762,97,665,2,31,1,1,0
51058,445,0,0,70,70,0,1,0,1,0,2
59895,53,59895,53,643,88,555,2,30,1,1,0
55651,445,0,0,70,70,0,1,0,1,0,2
50320,80,20341,80,50565,32661,17904,77,167,39,38,0
56126,53,32815,53,183,94,89,2,30,1,1,0
41954,2323,0,0,60,60,0,1,0,1,0,1
59853,445,0,0,66,66,0,1,0,1,0,2
42386,443,56294,443,12516,2906,9610,41,427,17,24,0
59977,30188,0,0,66,66,0,1,0,1,0,1
64819,445,0,0,66,66,0,1,0,1,0,2
42971,3478,56626,3478,452,280,172,5,30,3,2,0
56172,53,39320,53,216,102,114,2,30,1,1,0
20706,37965,0,0,62,62,0,1,0,1,0,1
49163,22114,0,0,146,146,0,1,0,1,0,1
57418,53,56760,53,209,102,107,2,30,1,1,0
45844,80,40841,80,152,78,74,2,5,1,1,0
55462,53,6708,53,194,102,92,2,30,1,1,0
50295,443,29927,443,18401,4536,13865,48,27,24,24,0
65145,445,0,0,70,70,0,1,0,1,0,2
57440,53,58703,53,199,102,97,2,30,1,1,0
64483,53,53474,53,168,86,82,2,29,1,1,0
63976,25725,46114,25725,66,66,0,2,8,2,0,0
56278,445,0,0,70,70,0,1,0,1,0,2
38057,443,24418,443,9486,2668,6818,26,81,14,12,0
49690,53,24171,53,216,110,106,2,30,1,1,0
26900,27017,64702,27017,422,164,258,6,30,3,3,0
56486,80,1722,80,46682,3447,43235,61,135,27,34,0
52751,443,8615,443,5378,984,4394,18,17,10,8,0
61407,443,61407,443,4552,1645,2907,19,26,11,8,0
64357,53,36127,53,183,94,89,2,30,1,1,0
55142,26467,0,0,62,62,0,1,0,1,0,1
49862,53,40662,53,180,94,86,2,30,1,1,0
62980,445,0,0,70,70,0,1,0,1,0,2
59834,445,0,0,70,70,0,1,0,1,0,2
52194,443,33437,443,9075,3727,5348,38,50,18,20,0
51222,35440,0,0,62,62,0,1,0,1,0,1
37042,48983,0,0,159,159,0,1,0,1,0,1
63888,25174,0,0,66,66,0,1,0,1,0,1
65056,53,13429,53,168,94,74,2,30,1,1,0
62458,445,0,0,70,70,0,1,0,1,0,2
55985,44847,0,0,62,62,0,1,0,1,0,1
49944,80,49944,80,220279,13007,207272,266,22,115,151,0
57860,23,0,0,60,60,0,1,0,1,0,1
33401,51505,0,0,62,62,0,1,0,1,0,1
49713,53,39823,53,184,94,90,2,30,1,1,0
63063,443,23701,443,303,85,218,2,30,1,1,0
58497,445,0,0,66,66,0,1,0,1,0,2
58610,443,32629,443,6345,1545,4800,23,18,12,11,0
50929,445,0,0,66,66,0,1,0,1,0,2
49491,445,0,0,70,70,0,1,0,1,0,2
58834,443,42035,443,7880,5105,2775,25,17,13,12,0
56511,445,0,0,70,70,0,1,0,1,0,2
65220,53,21177,53,184,94,90,2,30,1,1,0
41501,80,33952,80,306627,58973,247654,556,297,246,310,0
54624,445,0,0,70,70,0,1,0,1,0,2
35869,80,16584,80,2604,1690,914,20,610,11,9,0
30114,65151,0,0,60,60,0,1,0,1,0,1
53671,80,50539,80,956,502,454,12,15,7,5,0
49489,53,23234,53,241,118,123,2,30,1,1,0
60859,445,0,0,70,70,0,1,0,1,0,2
54892,445,0,0,70,70,0,1,0,1,0,2
53269,445,0,0,66,66,0,1,0,1,0,2
55315,53,15960,53,196,102,94,2,30,1,1,0
13287,16933,0,0,62,62,0,1,0,1,0,1
53224,445,0,0,66,66,0,1,0,1,0,2
45337,443,2595,443,2312,1382,930,19,24,11,8,0
55910,53,26815,53,183,94,89,2,30,1,1,0
20826,53,20826,53,228,90,138,2,32,1,1,0
65307,445,0,0,70,70,0,1,0,1,0,2
61459,80,3928,80,4671,2593,2078,15,85,9,6,0
61430,37965,0,0,66,66,0,1,0,1,0,1
53662,55043,16806,55043,320,140,180,6,6,3,3,0
49218,53,31585,53,179,86,93,2,30,1,1,0
60369,445,0,0,66,66,0,1,0,1,0,2
55045,443,26442,443,5541,2778,2763,24,15,14,10,0
59964,445,0,0,70,70,0,1,0,1,0,2
49240,443,49240,443,8448,3368,5080,25,48,15,10,0
58685,445,0,0,66,66,0,1,0,1,0,2
34366,443,43232,443,1053,566,487,10,16,6,4,0
65377,53,42499,53,186,95,91,2,31,1,1,0
55216,53,56986,53,179,94,85,2,30,1,1,0
64967,53,21374,53,389,134,255,2,30,1,1,0
58183,445,0,0,66,66,0,1,0,1,0,2
46525,5228,57899,5228,1410,933,477,11,3601,6,5,0
65096,443,53521,443,2414,639,1775,9,121,5,4,0
53826,10168,43672,10168,70,70,0,1,5,1,0,0
58638,5900,0,0,62,62,0,1,0,1,0,1
59400,22114,0,0,66,66,0,1,0,1,0,1
63868,60392,13062,60392,70,70,0,1,4,1,0,0
53157,445,0,0,70,70,0,1,0,1,0,2
55620,30188,0,0,66,66,0,1,0,1,0,1
27005,27019,64712,27019,1624,126,1498,4,31,2,2,0
42040,5228,16525,5228,60,60,0,1,5,1,0,0
55893,45711,0,0,78,78,0,1,0,1,0,1
64339,445,0,0,70,70,0,1,0,1,0,2
1827,64147,0,0,66,66,0,1,0,1,0,1
6929,53,6929,53,197,90,107,2,30,1,1,0
56951,53,25030,53,168,86,82,2,29,1,1,0
58638,5900,58638,5900,156,62,94,2,10,1,1,0
50649,80,63151,80,1366,865,501,8,15,5,3,0
64245,53,44468,53,199,102,97,2,30,1,1,0
20400,64147,0,0,62,62,0,1,0,1,0,1
53823,445,0,0,66,66,0,1,0,1,0,2
56487,53,4784,53,194,102,92,2,30,1,1,0
35991,443,1116,443,10857,4247,6610,27,121,13,14,0
48436,443,64004,443,9744,1958,7786,25,18,13,12,0
56922,29434,0,0,107,107,0,1,0,1,0,1
60123,443,13855,443,6485,1957,4528,22,16,11,11,0
58399,56205,0,0,66,66,0,1,0,1,0,1
43357,443,59688,443,1053,566,487,10,15,6,4,0
50895,80,56986,80,9046,1139,7907,20,255,11,9,0
65418,443,32664,443,2494,1643,851,17,26,9,8,0
60684,53,9516,53,199,94,105,2,30,1,1,0
61887,443,28383,443,81136,7785,73351,109,131,40,69,0
53218,56205,0,0,62,62,0,1,0,1,0,1
64946,53,64946,53,233,90,143,2,33,1,1,0
51899,47537,54934,47537,70,70,0,2,8,2,0,0
33255,443,24023,443,7579,3093,4486,25,21,14,11,0
56624,80,12583,80,234,234,0,4,12,4,0,0
45619,80,13038,80,1052,612,440,10,15,5,5,0
53760,443,44529,443,499,425,74,4,0,3,1,0
1024,63737,0,0,518,518,0,1,0,1,0,1
60488,27615,36232,27615,70,70,0,2,8,2,0,0
37965,6881,15418,6881,1534,248,1286,4,1200,2,2,0
19473,41049,5316,41049,149,149,0,1,1200,1,0,0
52069,443,58319,443,8593,2221,6372,31,232,17,14,0
39599,443,45420,443,1352,691,661,14,18,8,6,0
65437,53,50016,53,190,97,93,2,30,1,1,0
63832,25174,0,0,66,66,0,1,0,1,0,1
19875,30170,0,0,145,145,0,1,0,1,0,1
56819,53,1488,53,209,110,99,2,30,1,1,0
59770,443,37125,443,7316,1933,5383,27,16,15,12,0
62579,445,0,0,70,70,0,1,0,1,0,2
33136,443,16239,443,6648,1556,5092,23,29,13,10,0
51408,443,61197,443,1576,789,787,17,122,9,8,0
51174,445,0,0,70,70,0,1,0,1,0,2
55787,445,0,0,70,70,0,1,0,1,0,2
57914,443,40977,443,17285,4005,13280,26,120,11,15,0
63062,53,18913,53,70,70,0,1,30,1,0,0
47971,443,27561,443,11482,2506,8976,48,1329,24,24,0
53043,51050,0,0,62,62,0,1,0,1,0,1
49655,443,10531,443,31956,13344,18612,64,65,36,28,0
24504,37965,0,0,62,62,0,1,0,1,0,1
60369,443,26606,443,6052,1841,4211,21,82,10,11,0
58550,445,0,0,66,66,0,1,0,1,0,2
59989,445,0,0,70,70,0,1,0,1,0,2
64112,445,0,0,70,70,0,1,0,1,0,2
17177,64147,0,0,62,62,0,1,0,1,0,1
35017,443,23449,443,826,362,464,13,30,6,7,0
6980,48543,0,0,139,139,0,1,0,1,0,1
50914,51505,0,0,66,66,0,1,0,1,0,1
50578,80,29631,80,1791,900,891,14,79,7,7,0
50253,53,52044,53,167,86,81,2,29,1,1,0
63091,445,0,0,70,70,0,1,0,1,0,2
49452,53,60984,53,244,110,134,2,30,1,1,0
52263,16350,50284,16350,70,70,0,2,8,2,0,0
55365,53,26447,53,184,94,90,2,30,1,1,0
50350,445,0,0,66,66,0,1,0,1,0,2
55144,443,5039,443,3522,869,2653,13,121,6,7,0
60646,11392,0,0,66,66,0,1,0,1,0,1
49222,53,15691,53,199,94,105,2,30,1,1,0
56523,443,42102,443,5212,1037,4175,20,115,10,10,0
63062,53,6744,53,303,85,218,2,30,1,1,0
65254,53,46437,53,459,94,365,4,45,2,2,0
58266,443,20650,443,5619,1387,4232,18,205,10,8,0
53073,80,1603,80,2594,1200,1394,16,17,10,6,0
58352,445,0,0,70,70,0,1,0,1,0,2
56160,53,39836,53,195,102,93,2,30,1,1,0
57846,57866,0,0,66,66,0,1,0,1,0,1
56712,53,17239,53,177,94,83,2,30,1,1,0
52061,35717,37968,35717,70,70,0,1,5,1,0,0
64313,445,0,0,70,70,0,1,0,1,0,2
58638,5900,0,0,62,62,0,1,0,1,0,1
41750,443,14251,443,4636,792,3844,16,15,8,8,0
56307,52700,0,0,66,66,0,1,0,1,0,1
38334,443,30322,443,1864,250,1614,8,121,4,4,0
49275,53,23304,53,212,102,110,2,30,1,1,0
64601,445,0,0,66,66,0,1,0,1,0,2
49604,53,54196,53,179,94,85,2,29,1,1,0
27005,27212,63313,27212,889,126,763,2,30,1,1,0
52412,443,22141,443,11565,5557,6008,52,16,27,25,0
37896,443,37896,443,4704,1797,2907,19,30,11,8,0
56067,53,20488,53,189,102,87,2,30,1,1,0
10006,64147,0,0,62,62,0,1,0,1,0,1
52544,443,52544,443,4487,1580,2907,19,26,11,8,0
60390,56494,64175,56494,70,70,0,2,8,2,0,0
34095,53,34095,53,243,104,139,2,30,1,1,0
0,0,0,0,98,98,0,1,0,1,0,1
53650,64147,0,0,62,62,0,1,0,1,0,1
65055,53,62687,53,225,86,139,2,30,1,1,0
51570,443,51570,443,11204,3773,7431,29,132,12,17,0
52470,14037,0,0,66,66,0,1,0,1,0,1
50015,53,0,0,234,86,148,2,30,1,1,0
32742,53,46400,53,207,86,121,2,30,1,1,0
30960,45731,48545,45731,330,330,0,6,3610,6,0,0
58901,443,21819,443,5168,700,4468,16,15,7,9,0
56982,80,33665,80,3817,829,2988,11,16,7,4,0
62373,445,0,0,70,70,0,1,0,1,0,2
56184,53,63317,53,215,94,121,2,30,1,1,0
30046,15503,0,0,62,62,0,1,0,1,0,1
50318,53,63172,53,732,89,643,2,30,1,1,0
38654,443,36804,443,9144,1783,7361,19,16,10,9,0
50012,445,0,0,70,70,0,1,0,1,0,2
58638,5900,0,0,62,62,0,1,0,1,0,1
58736,443,28275,443,7978,1143,6835,19,26,9,10,0
14023,37965,0,0,62,62,0,1,0,1,0,1
49480,7000,49480,7000,3050,1659,1391,16,15,9,7,0
50106,31573,0,0,66,66,0,1,0,1,0,1
64729,53,36616,53,262,94,168,2,30,1,1,0
55413,37965,0,0,66,66,0,1,0,1,0,1
58858,445,0,0,66,66,0,1,0,1,0,2
52075,445,0,0,70,70,0,1,0,1,0,2
45564,443,3708,443,69614,5520,64094,100,21,52,48,0
49174,443,55183,443,524887,14310,510577,546,18,201,345,0
59082,445,0,0,70,70,0,1,0,1,0,2
53232,443,40771,443,69742,34581,35161,105,63,52,53,0
26900,27017,46103,27017,422,164,258,6,30,3,3,0
50498,53,36030,53,751,94,657,2,29,1,1,0
51984,445,0,0,70,70,0,1,0,1,0,2
4041,50584,0,0,62,62,0,1,0,1,0,1
60191,80,55591,80,2589,1231,1358,9,28,5,4,0
36908,26467,0,0,62,62,0,1,0,1,0,1
27005,1305,52487,1305,855,126,729,2,30,1,1,0
53287,445,0,0,66,66,0,1,0,1,0,2
45364,443,12194,443,9276,2422,6854,25,186,14,11,0
49629,53,36000,53,196,100,96,2,31,1,1,0
52033,443,12817,443,9609,3239,6370,25,143,12,13,0
57441,53,7425,53,177,94,83,2,30,1,1,0
59096,8604,0,0,66,66,0,1,0,1,0,1
65356,53,49410,53,199,102,97,2,30,1,1,0
64862,53,39051,53,211,110,101,2,30,1,1,0
27005,27014,39253,27014,882,126,756,2,30,1,1,0
57034,443,8240,443,30645,2719,27926,60,153,25,35,0
65133,53,34896,53,198,102,96,2,30,1,1,0
47910,7454,0,0,60,60,0,1,0,1,0,1
27153,80,27153,80,6397,947,5450,15,18,8,7,0
8976,44847,0,0,66,66,0,1,0,1,0,1
44157,53,44157,53,216,90,126,2,29,1,1,0
45119,443,35597,443,2227,1018,1209,17,16,8,9,0
40026,443,36114,443,6058,1749,4309,22,200,13,9,0
50354,80,47927,80,306,180,126,6,25,4,2,0
50050,53,17602,53,253,87,166,4,52,2,2,0
53615,867,2680,867,70,70,0,1,5,1,0,0
56674,53,43592,53,182,93,89,2,31,1,1,0
51462,3027,51462,3027,156,156,0,3,8,3,0,0
50367,53,22257,53,578,286,292,9,15,5,4,0
50675,56205,0,0,66,66,0,1,0,1,0,1
64308,445,0,0,70,70,0,1,0,1,0,2
51998,80,30634,80,52288,7809,44479,105,37,40,65,0
4910,2149,0,0,66,66,0,1,0,1,0,1
62709,445,0,0,70,70,0,1,0,1,0,2
42167,443,27521,443,4117,1026,3091,15,31,9,6,0
15320,30188,0,0,146,146,0,1,0,1,0,1
0,0,0,0,70,70,0,1,0,1,0,1
34883,443,14501,443,51393,3538,47855,70,30,29,41,0
60137,443,42633,443,10407,3966,6441,30,149,18,12,0
58614,53,27670,53,218,78,140,2,31,1,1,0
57120,443,27868,443,23906,9380,14526,40,16,24,16,0
48016,443,47269,443,138,78,60,2,5,1,1,0
1943,48817,0,0,66,66,0,1,0,1,0,1
56666,443,25263,443,8006,1986,6020,20,15,11,9,0
61807,443,12289,443,6244,1855,4389,16,75,9,7,0
60908,445,0,0,66,66,0,1,0,1,0,2
50403,445,0,0,66,66,0,1,0,1,0,2
65344,53,8855,53,180,94,86,2,35,1,1,0
49263,53,17752,53,178,94,84,2,30,1,1,0
49250,53,39996,53,225,110,115,2,29,1,1,0
60659,443,57729,443,8175,3047,5128,26,165,12,14,0
34765,5222,48630,5222,10109,3480,6629,72,615,38,34,0
53406,44847,0,0,62,62,0,1,0,1,0,1
59276,445,0,0,70,70,0,1,0,1,0,2
10406,35440,0,0,146,146,0,1,0,1,0,1
56056,53,19190,53,184,86,98,2,30,1,1,0
56956,53,28771,53,182,93,89,2,30,1,1,0
64124,53,26589,53,182,93,89,2,31,1,1,0
64312,445,0,0,66,66,0,1,0,1,0,2
49418,31000,20791,31000,78,78,0,1,30,1,0,0
48627,443,55025,443,638,70,568,10,207,2,8,0
55080,53,13972,53,165,86,79,2,29,1,1,0
55647,61042,18333,61042,320,140,180,6,7,3,3,0
59985,443,16838,443,25649,1485,24164,36,144,14,22,0
55685,48407,34505,48407,320,140,180,6,6,3,3,0
56035,445,0,0,70,70,0,1,0,1,0,2
59535,25174,0,0,62,62,0,1,0,1,0,1
8889,33698,0,0,60,60,0,1,0,1,0,1
8283,45858,25688,45858,130,70,60,2,30,1,1,0
61630,445,0,0,66,66,0,1,0,1,0,2
443,28215,0,0,60,60,0,1,0,1,0,1
51035,443,33243,443,2227,1018,1209,17,16,8,9,0
55222,443,38278,443,5312,1510,3802,18,45,11,7,0
42298,40037,29650,40037,208,86,122,4,30,2,2,0
39313,37965,0,0,62,62,0,1,0,1,0,1
65112,53,6227,53,209,110,99,2,31,1,1,0
52432,50265,0,0,66,66,0,1,0,1,0,1
63724,445,0,0,66,66,0,1,0,1,0,2
52117,20600,30733,20600,70,70,0,2,8,2,0,0
41254,443,60907,443,12757,4053,8704,39,522,14,25,0
38621,443,27614,443,1593,946,647,15,64,8,7,0
10701,11392,0,0,146,146,0,1,0,1,0,1
25251,53,25251,53,231,90,141,2,30,1,1,0
53922,445,0,0,70,70,0,1,0,1,0,2
58250,35440,0,0,66,66,0,1,0,1,0,1
51718,445,0,0,70,70,0,1,0,1,0,2
40709,53,32661,53,221,75,146,2,30,1,1,0
41156,443,9223,443,59486,3261,56225,74,360,29,45,0
56324,53,13523,53,177,94,83,2,30,1,1,0
19068,37965,0,0,62,62,0,1,0,1,0,1
57067,53,21723,53,183,94,89,2,31,1,1,0
64693,53,28781,53,248,102,146,2,30,1,1,0
51356,22114,0,0,62,62,0,1,0,1,0,1
43109,80,31634,80,7607,3563,4044,18,20,9,9,0
49953,445,0,0,66,66,0,1,0,1,0,2
59829,443,18743,443,182,60,122,4,26,2,2,0
58263,445,0,0,70,70,0,1,0,1,0,2
50332,80,8939,80,5517,2843,2674,19,47,10,9,0
59402,445,0,0,70,70,0,1,0,1,0,2
37887,22114,0,0,66,66,0,1,0,1,0,1
55083,53,35659,53,216,110,106,2,30,1,1,0
54319,445,0,0,70,70,0,1,0,1,0,2
56369,53,59261,53,193,102,91,2,29,1,1,0
50170,445,0,0,70,70,0,1,0,1,0,2
58745,30188,0,0,66,66,0,1,0,1,0,1
56540,443,45404,443,103117,6206,96911,127,106,54,73,0
64652,445,0,0,70,70,0,1,0,1,0,2
57218,445,0,0,66,66,0,1,0,1,0,2
6909,57470,0,0,62,62,0,1,0,1,0,1
57360,18375,0,0,66,66,0,1,0,1,0,1
53260,443,64697,443,6136,1916,4220,28,15,16,12,0
43185,50584,0,0,146,146,0,1,0,1,0,1
9280,443,36215,443,4612,830,3782,16,27,9,7,0
55627,53,20054,53,174,89,85,2,31,1,1,0
50578,123,63477,123,184,94,90,2,30,1,1,0
50520,53,8153,53,183,94,89,2,30,1,1,0
53912,443,53912,443,4447,1540,2907,19,30,11,8,0
56676,80,29076,80,78,78,0,2,6,2,0,0
34165,443,5648,443,8208,2080,6128,24,81,14,10,0
43872,53,52878,53,199,94,105,2,30,1,1,0
5588,5588,0,0,3354,1792,1562,46,194,23,23,0
52883,53,22567,53,339,94,245,2,30,1,1,0
42166,443,46667,443,162,102,60,2,5,1,1,0
55911,445,0,0,70,70,0,1,0,1,0,2
42349,443,27589,443,90562,4227,86335,118,200,49,69,0
50594,80,50594,80,9937,4191,5746,27,17,13,14,0
50546,445,0,0,66,66,0,1,0,1,0,2
60160,445,0,0,66,66,0,1,0,1,0,2
56872,53,25005,53,443,182,261,6,29,3,3,0
51685,80,11134,80,1516,481,1035,11,15,6,5,0
49737,443,56529,443,5566,1444,4122,17,129,10,7,0
49993,37965,0,0,66,66,0,1,0,1,0,1
18029,50584,0,0,66,66,0,1,0,1,0,1
64685,53,52958,53,186,95,91,2,30,1,1,0
49229,53,40938,53,183,94,89,2,29,1,1,0
36036,443,36036,443,261234,32183,229051,326,212,153,173,0
51930,57470,0,0,66,66,0,1,0,1,0,1
50901,26467,0,0,66,66,0,1,0,1,0,1
4427,50584,0,0,62,62,0,1,0,1,0,1
49769,445,0,0,66,66,0,1,0,1,0,2
58638,5900,0,0,62,62,0,1,0,1,0,1
44603,53,44603,53,229,98,131,2,29,1,1,0
10329,7774,0,0,143,143,0,1,0,1,0,1
64001,445,0,0,70,70,0,1,0,1,0,2
56426,53,8485,53,184,94,90,2,30,1,1,0
35203,443,62498,443,232,172,60,3,5,2,1,0
64093,53,8656,53,225,110,115,2,30,1,1,0
55392,445,0,0,70,70,0,1,0,1,0,2
62418,445,0,0,66,66,0,1,0,1,0,2
30794,37965,0,0,62,62,0,1,0,1,0,1
54327,7000,54327,7000,3310,1535,1775,15,15,8,7,0
55620,53,23313,53,177,94,83,2,30,1,1,0
43356,443,48473,443,79561,11513,68048,183,94,95,88,0
50531,80,35066,80,21782,2162,19620,28,20,11,17,0
63755,17866,46456,17866,2568,1944,624,20,29,13,7,0
55011,445,0,0,70,70,0,1,0,1,0,2
63985,43081,52828,43081,70,70,0,1,5,1,0,0
58638,5900,58638,5900,62,62,0,1,5,1,0,0
27005,27015,28442,27015,881,126,755,2,31,1,1,0
59914,445,0,0,66,66,0,1,0,1,0,2
63848,48560,48756,48560,66,66,0,2,7,2,0,0
56765,53,64406,53,194,102,92,2,29,1,1,0
60812,445,0,0,70,70,0,1,0,1,0,2
62737,64147,0,0,66,66,0,1,0,1,0,1
56291,445,0,0,70,70,0,1,0,1,0,2
55067,53,26485,53,178,94,84,2,31,1,1,0
5688,44847,0,0,62,62,0,1,0,1,0,1
65355,53,22974,53,321,102,219,2,30,1,1,0
38056,443,15075,443,9528,2738,6790,27,81,15,12,0
61312,445,0,0,70,70,0,1,0,1,0,2
54633,36237,0,0,66,66,0,1,0,1,0,1
56433,53,26629,53,177,94,83,2,30,1,1,0
65515,53,18245,53,195,102,93,2,31,1,1,0
53815,44847,0,0,66,66,0,1,0,1,0,1
60131,445,0,0,70,70,0,1,0,1,0,2
64403,53,16361,53,783,197,586,6,70,3,3,0
13423,56205,0,0,62,62,0,1,0,1,0,1
59662,445,0,0,66,66,0,1,0,1,0,2
38645,443,41278,443,2535,1177,1358,16,28,7,9,0
61859,445,0,0,70,70,0,1,0,1,0,2
64598,53,46493,53,342,142,200,2,30,1,1,0
37573,443,7707,443,13637,6347,7290,34,46,20,14,0
27005,27016,41130,27016,1622,126,1496,4,31,2,2,0
64543,445,0,0,70,70,0,1,0,1,0,2
56837,53,14391,53,195,102,93,2,33,1,1,0
26900,27017,57594,27017,172,86,86,2,30,1,1,0
17171,22114,0,0,66,66,0,1,0,1,0,1
0,0,0,0,320,320,0,5,0,5,0,0
60900,443,51308,443,7426,1877,5549,22,81,13,9,0
32768,53,4546,53,86,86,0,1,30,1,0,0
62451,445,0,0,70,70,0,1,0,1,0,2
60340,443,5002,443,6844,2441,4403,19,181,9,10,0
55892,53,8349,53,182,93,89,2,30,1,1,0
55413,53,38303,53,216,110,106,2,29,1,1,0
55325,53,47399,53,199,102,97,2,29,1,1,0
4515,37807,0,0,62,62,0,1,0,1,0,1
64349,53,48163,53,392,102,290,2,30,1,1,0
49908,53,39258,53,789,110,679,2,30,1,1,0
57604,32480,0,0,62,62,0,1,0,1,0,1
60823,25174,0,0,66,66,0,1,0,1,0,1
50116,22,50116,22,146,60,86,2,9,1,1,0
62458,53,43371,53,429,102,327,2,31,1,1,0
50282,443,7706,443,24856,2858,21998,57,100,30,27,0
52209,80,41464,80,372,246,126,6,27,4,2,0
53544,445,0,0,70,70,0,1,0,1,0,2
65064,53,48752,53,821,102,719,2,29,1,1,0
57284,445,0,0,66,66,0,1,0,1,0,2
56924,53,61139,53,216,110,106,2,30,1,1,0
50609,443,29620,443,1738,1061,677,18,94,10,8,0
35776,443,4893,443,7500,2339,5161,18,136,8,10,0
52155,63867,61917,63867,70,70,0,1,5,1,0,0
50067,445,0,0,70,70,0,1,0,1,0,2
58638,5900,0,0,62,62,0,1,0,1,0,1
55212,443,36417,443,10500,5056,5444,23,143,11,12,0
49164,443,45916,443,7292,950,6342,19,75,9,10,0
49849,53,33985,53,173,94,79,2,31,1,1,0
19116,53,19116,53,398,255,143,3,33,2,1,0
55312,53,28336,53,195,102,93,2,31,1,1,0
60368,443,34243,443,6041,1830,4211,21,82,10,11,0
63819,18445,34551,18445,70,70,0,1,4,1,0,0
3478,61463,0,0,627,627,0,1,0,1,0,1
6889,9074,0,0,143,143,0,1,0,1,0,1
54413,445,0,0,66,66,0,1,0,1,0,2
65484,53,10578,53,195,86,109,2,30,1,1,0
27110,22114,0,0,62,62,0,1,0,1,0,1
55224,53,33137,53,209,110,99,2,30,1,1,0
55036,53,7624,53,177,94,83,2,30,1,1,0
4269,26672,0,0,60,60,0,1,0,1,0,1
56789,443,21644,443,257154,11550,245604,303,54,121,182,0
58638,5900,0,0,62,62,0,1,0,1,0,1
54033,445,0,0,70,70,0,1,0,1,0,2
3478,61463,0,0,814,814,0,1,0,1,0,1
52128,443,43146,443,16113,2152,13961,35,20,18,17,0
64232,445,0,0,66,66,0,1,0,1,0,2
63390,445,0,0,66,66,0,1,0,1,0,2
55630,43736,8013,43736,70,70,0,1,5,1,0,0
56192,445,0,0,70,70,0,1,0,1,0,2
6881,26296,0,0,146,146,0,1,0,1,0,1
63236,445,0,0,70,70,0,1,0,1,0,2
31281,57470,0,0,145,145,0,1,0,1,0,1
64392,25174,0,0,62,62,0,1,0,1,0,1
58698,445,0,0,66,66,0,1,0,1,0,2
53289,445,0,0,70,70,0,1,0,1,0,2
60868,445,0,0,70,70,0,1,0,1,0,2
64811,53,37013,53,193,102,91,2,29,1,1,0
55936,53,21289,53,177,94,83,2,30,1,1,0
50474,80,50474,80,4994,855,4139,14,21,7,7,0
57339,443,47908,443,1495,768,727,16,26,9,7,0
40512,57470,0,0,74,74,0,1,0,1,0,1
28275,80,28275,80,303421,10894,292527,324,26,116,208,0
15688,56919,0,0,146,146,0,1,0,1,0,1
50315,80,20802,80,1030,310,720,11,56,6,5,0
55568,445,0,0,70,70,0,1,0,1,0,2
42288,443,48757,443,16985,7850,9135,39,121,19,20,0
53078,445,0,0,70,70,0,1,0,1,0,2
51591,80,40282,80,12683,8567,4116,53,271,33,20,0
55142,53,43974,53,889,404,485,10,30,5,5,0
51964,1103,26830,1103,70,70,0,1,4,1,0,0
49878,445,0,0,70,70,0,1,0,1,0,2
45682,25604,0,0,62,62,0,1,0,1,0,1
25878,25174,0,0,66,66,0,1,0,1,0,1
56288,53,34669,53,183,94,89,2,30,1,1,0
57419,445,0,0,66,66,0,1,0,1,0,2
65114,53,28927,53,196,102,94,2,30,1,1,0
50935,80,3414,80,8167195,108448,8058747,7107,121,1531,5576,0
51049,445,0,0,70,70,0,1,0,1,0,2
9468,80,22561,80,1835,421,1414,9,15,4,5,0
23079,9694,0,0,62,62,0,1,0,1,0,1
64024,445,0,0,70,70,0,1,0,1,0,2
51582,48817,0,0,66,66,0,1,0,1,0,1
26835,47993,0,0,62,62,0,1,0,1,0,1
61523,37807,0,0,66,66,0,1,0,1,0,1
51920,32678,28612,32678,70,70,0,1,5,1,0,0
40108,23,0,0,60,60,0,1,0,1,0,1
64467,53,11977,53,184,94,90,2,30,1,1,0
51766,48169,32212,48169,70,70,0,1,5,1,0,0
54983,53,35853,53,728,102,626,2,30,1,1,0
55311,53,61632,53,298,101,197,4,31,2,2,0
53669,23,0,0,60,60,0,1,0,1,0,1
57447,443,54490,443,12192,3788,8404,36,18,18,18,0
57173,53,42104,53,216,110,106,2,31,1,1,0
56656,445,0,0,70,70,0,1,0,1,0,2
59663,445,0,0,66,66,0,1,0,1,0,2
49522,80,55749,80,6908,1652,5256,26,225,12,14,0
48817,21939,48817,21939,513,152,361,2,1200,1,1,0
49300,443,31684,443,4364,2129,2235,12,121,6,6,0
41910,443,63630,443,9358,2304,7054,39,120,20,19,0
63030,25174,0,0,146,146,0,1,0,1,0,1
64987,53,14036,53,192,98,94,2,30,1,1,0
56109,53,59181,53,323,102,221,2,29,1,1,0
65144,53,10538,53,210,110,100,2,30,1,1,0
59483,23,0,0,60,60,0,1,0,1,0,1
123,123,44322,123,184,94,90,2,29,1,1,0
27502,50584,0,0,62,62,0,1,0,1,0,1
54706,443,10559,443,5612,1051,4561,20,16,11,9,0
27452,5222,13129,5222,3751,1007,2744,35,425,11,24,0
53702,445,0,0,66,66,0,1,0,1,0,2
53868,53,38630,53,164,78,86,2,30,1,1,0
64955,53,11149,53,761,100,661,2,0,1,1,0
65366,53,44706,53,458,188,270,6,31,3,3,0
57167,53,41895,53,195,102,93,2,30,1,1,0
64067,53,26067,53,331,102,229,2,30,1,1,0
54167,53,54167,53,242,98,144,2,30,1,1,0
56955,53,20294,53,184,86,98,2,29,1,1,0
53469,44847,0,0,66,66,0,1,0,1,0,1
49456,445,0,0,70,70,0,1,0,1,0,2
60982,443,39893,443,18274,7660,10614,46,48,26,20,0
51704,445,0,0,66,66,0,1,0,1,0,2
49859,443,23944,443,6065,1045,5020,20,60,11,9,0
63407,445,0,0,70,70,0,1,0,1,0,2
64114,443,8780,443,1411,852,559,13,24,7,6,0
49254,53,31955,53,814,110,704,2,30,1,1,0
43571,26467,0,0,62,62,0,1,0,1,0,1
52220,65128,43562,65128,70,70,0,2,8,2,0,0
49699,53,53158,53,209,110,99,2,30,1,1,0
40689,443,13371,443,4203,1564,2639,26,470,14,12,0
53086,445,0,0,70,70,0,1,0,1,0,2
5244,35440,0,0,66,66,0,1,0,1,0,1
34301,21247,0,0,146,146,0,1,0,1,0,1
61418,443,63876,443,7741,1614,6127,21,77,11,10,0
39473,443,25041,443,11226,3340,7886,28,16,16,12,0
63992,53,33581,53,198,101,97,2,31,1,1,0
55664,445,0,0,70,70,0,1,0,1,0,2
44258,25,0,0,74,74,0,1,0,1,0,1
50420,443,27192,443,648,210,438,10,27,4,6,0
65386,445,0,0,70,70,0,1,0,1,0,2
56558,443,2694,443,7702,2155,5547,19,39,11,8,0
59961,445,0,0,70,70,0,1,0,1,0,2
60435,445,0,0,66,66,0,1,0,1,0,2
64104,22114,0,0,62,62,0,1,0,1,0,1
56914,53,41623,53,731,85,646,2,30,1,1,0
43207,26467,0,0,62,62,0,1,0,1,0,1
51459,53,51459,53,256,114,142,2,30,1,1,0
58922,57470,0,0,66,66,0,1,0,1,0,1
50041,445,0,0,70,70,0,1,0,1,0,2
56222,5228,31508,5228,2531,1513,1018,17,3601,8,9,0
60671,445,0,0,70,70,0,1,0,1,0,2
60168,35440,0,0,66,66,0,1,0,1,0,1
46716,443,30978,443,7298,2661,4637,21,17,11,10,0
57038,53,2434,53,186,102,84,2,30,1,1,0
55896,53,65305,53,184,94,90,2,30,1,1,0
50920,445,0,0,66,66,0,1,0,1,0,2
50875,53,21370,53,78,78,0,1,30,1,0,0
60248,46776,0,0,66,66,0,1,0,1,0,1
9331,443,37171,443,3616,429,3187,11,15,6,5,0
53571,19636,50196,19636,70,70,0,2,7,2,0,0
63325,445,0,0,70,70,0,1,0,1,0,2
52217,22114,0,0,66,66,0,1,0,1,0,1
1530,62413,0,0,62,62,0,1,0,1,0,1
60163,443,56805,443,8929,3204,5725,25,80,14,11,0
61075,53,61075,53,244,98,146,2,32,1,1,0
51608,443,59688,443,4646,2347,2299,17,34,9,8,0
65366,53,60695,53,198,101,97,2,31,1,1,0
55489,445,0,0,66,66,0,1,0,1,0,2
48326,53,48326,53,398,255,143,3,33,2,1,0
58791,15503,0,0,66,66,0,1,0,1,0,1
58477,445,0,0,70,70,0,1,0,1,0,2
59180,445,0,0,70,70,0,1,0,1,0,2
55684,80,48603,80,70,70,0,1,5,1,0,0
49476,53,34696,53,764,102,662,2,30,1,1,0
50912,443,28892,443,8527,2387,6140,21,31,11,10,0
51164,64147,0,0,62,62,0,1,0,1,0,1
51973,44847,0,0,62,62,0,1,0,1,0,1
59833,48817,0,0,107,107,0,1,0,1,0,1
57459,51505,0,0,66,66,0,1,0,1,0,1
56719,53,51859,53,185,102,83,2,30,1,1,0
46099,80,56104,80,70,70,0,2,5,2,0,0
55076,80,31296,80,1129,580,549,11,74,6,5,0
49482,7000,49482,7000,3098,1611,1487,16,15,9,7,0
49544,53,31008,53,226,86,140,2,30,1,1,0
50304,445,0,0,70,70,0,1,0,1,0,2
56456,53,39368,53,199,102,97,2,30,1,1,0
50931,445,0,0,70,70,0,1,0,1,0,2
55600,53,56237,53,168,78,90,2,30,1,1,0
39927,443,15384,443,7787,2370,5417,23,242,11,12,0
51535,443,24359,443,322,262,60,2,4,1,1,0
59765,443,22401,443,571,166,405,2,30,1,1,0
55844,445,0,0,66,66,0,1,0,1,0,2
45964,2666,0,0,60,60,0,1,0,1,0,1
39200,443,57759,443,8918,2361,6557,35,255,18,17,0
43286,80,30144,80,1638,1324,314,10,15,5,5,0
40326,443,22959,443,7937,3883,4054,65,4602,25,40,0
56428,30317,0,0,66,66,0,1,0,1,0,1
51839,80,51839,80,951054,20747,930307,902,26,276,626,0
57809,53,57809,53,213,79,134,2,33,1,1,0
60045,445,0,0,66,66,0,1,0,1,0,2
57082,445,0,0,70,70,0,1,0,1,0,2
56413,53,29873,53,233,94,139,2,30,1,1,0
22346,51505,0,0,62,62,0,1,0,1,0,1
57275,53,1884,53,186,95,91,2,31,1,1,0
47013,44512,0,0,62,62,0,1,0,1,0,1
50375,80,22563,80,350,210,140,6,15,4,2,0
50658,445,0,0,66,66,0,1,0,1,0,2
53772,14132,16590,14132,70,70,0,2,8,2,0,0
55051,53,44193,53,167,86,81,2,31,1,1,0
59879,55783,0,0,66,66,0,1,0,1,0,1
9243,80,7873,80,318,192,126,6,26,4,2,0
64975,445,0,0,66,66,0,1,0,1,0,1
39337,443,52807,443,4362,1145,3217,17,26,9,8,0
51397,445,0,0,70,70,0,1,0,1,0,2
55772,445,0,0,70,70,0,1,0,1,0,2
60185,445,0,0,70,70,0,1,0,1,0,2
34485,81,0,0,60,60,0,1,0,1,0,1
63935,445,0,0,66,66,0,1,0,1,0,2
56258,53,14638,53,167,86,81,2,29,1,1,0
51731,39392,29228,39392,66,66,0,1,5,1,0,0
50390,443,34358,443,1328,876,452,11,29,6,5,0
52173,443,52173,443,201007,10015,190992,239,22,100,139,0
54773,50584,0,0,66,66,0,1,0,1,0,1
50787,445,0,0,66,66,0,1,0,1,0,2
63621,445,0,0,70,70,0,1,0,1,0,2
55179,443,6638,443,5839,1984,3855,19,18,11,8,0
49905,53,43598,53,176,90,86,2,31,1,1,0
65068,445,0,0,70,70,0,1,0,1,0,2
56667,53,46013,53,168,86,82,2,30,1,1,0
55408,64147,0,0,66,66,0,1,0,1,0,1
53500,443,28730,443,3036,975,2061,14,136,7,7,0
50116,22,0,0,60,60,0,1,0,1,0,1
51910,37965,0,0,62,62,0,1,0,1,0,1
63906,36909,1381,36909,70,70,0,1,4,1,0,0
55417,445,0,0,70,70,0,1,0,1,0,2
61917,445,0,0,70,70,0,1,0,1,0,2
55171,53,44438,53,199,102,97,2,30,1,1,0
63932,53,27137,53,179,94,85,2,30,1,1,0
49730,443,47083,443,4484,1063,3421,15,10,7,8,0
61181,445,0,0,70,70,0,1,0,1,0,2
57109,445,0,0,66,66,0,1,0,1,0,2
57573,445,0,0,70,70,0,1,0,1,0,2
54280,3385,0,0,60,60,0,1,0,1,0,1
32648,55108,0,0,145,145,0,1,0,1,0,1
64029,443,14573,443,252,70,182,3,120,1,2,0
53570,24874,32383,24874,70,70,0,2,7,2,0,0
4960,53,26982,53,222,86,136,2,30,1,1,0
55757,53,50237,53,177,94,83,2,30,1,1,0
56285,53,40728,53,711,87,624,2,30,1,1,0
56543,445,0,0,70,70,0,1,0,1,0,2
62748,445,0,0,70,70,0,1,0,1,0,2
64551,445,0,0,66,66,0,1,0,1,0,2
36629,23117,0,0,62,62,0,1,0,1,0,1
48176,50584,0,0,62,62,0,1,0,1,0,1
55743,53,6640,53,748,106,642,2,31,1,1,0
65274,445,0,0,70,70,0,1,0,1,0,2
64064,29856,32936,29856,66,66,0,1,5,1,0,0
49939,53,35576,53,229,102,127,2,30,1,1,0
64324,53,5232,53,344,105,239,4,33,2,2,0
45289,80,45289,80,144717,5580,139137,180,20,81,99,0
65360,445,0,0,66,66,0,1,0,1,0,2
56337,53,29643,53,268,89,179,4,45,2,2,0
63867,35993,0,0,66,66,0,1,0,1,0,1
60261,25174,0,0,66,66,0,1,0,1,0,1
62524,123,21935,123,184,94,90,2,31,1,1,0
59848,443,53182,443,2431,1164,1267,27,46,11,16,0
53027,443,45299,443,26309,3035,23274,69,92,27,42,0
36158,443,62102,443,7848,2137,5711,23,25,13,10,0
49271,445,0,0,66,66,0,1,0,1,0,2
57031,443,21412,443,2963,797,2166,10,120,5,5,0
58086,445,0,0,70,70,0,1,0,1,0,2
1024,44847,0,0,62,62,0,1,0,1,0,1
58638,5900,0,0,62,62,0,1,0,1,0,1
6666,138,0,0,60,60,0,1,0,1,0,1
65189,28215,62292,28215,259,78,181,2,29,1,1,0
51602,443,19598,443,2013,1363,650,12,134,7,5,0
57419,445,0,0,70,70,0,1,0,1,0,2
60049,25174,0,0,66,66,0,1,0,1,0,1
25772,7302,0,0,66,66,0,1,0,1,0,1
25889,11446,0,0,66,66,0,1,0,1,0,1
53821,443,16981,443,7980,1434,6546,24,19,13,11,0
50176,445,0,0,70,70,0,1,0,1,0,2
57637,445,0,0,70,70,0,1,0,1,0,2
1042,33175,0,0,145,145,0,1,0,1,0,1
49206,12242,47287,12242,70,70,0,1,5,1,0,0
49939,445,0,0,70,70,0,1,0,1,0,2
49538,53,59762,53,754,94,660,2,30,1,1,0
53016,443,45563,443,50403,2032,48371,66,108,21,45,0
51510,443,23309,443,1047,560,487,10,16,6,4,0
64592,53,37714,53,202,103,99,2,31,1,1,0
65497,53,26978,53,197,102,95,2,30,1,1,0
56202,53,48899,53,749,94,655,2,30,1,1,0
443,59493,0,0,60,60,0,1,0,1,0,1
54166,445,0,0,70,70,0,1,0,1,0,2
62693,445,0,0,70,70,0,1,0,1,0,2
50692,443,11802,443,152,86,66,2,5,1,1,0
62217,37807,0,0,66,66,0,1,0,1,0,1
42285,57470,0,0,62,62,0,1,0,1,0,1
50169,445,0,0,70,70,0,1,0,1,0,2
39110,50584,0,0,62,62,0,1,0,1,0,1
55868,53,18445,53,177,94,83,2,30,1,1,0
34710,53,34710,53,244,98,146,2,33,1,1,0
49400,80,14888,80,40119,2475,37644,49,84,16,33,0
55965,53,4442,53,184,94,90,2,30,1,1,0
56755,53,24589,53,184,94,90,2,30,1,1,0
49433,53,38840,53,167,86,81,2,30,1,1,0
50515,445,0,0,70,70,0,1,0,1,0,2
27005,27017,10381,27017,600,126,474,2,30,1,1,0
60118,53,0,0,216,84,132,2,30,1,1,0
50478,445,0,0,70,70,0,1,0,1,0,2
22983,443,22983,443,205941,20753,185188,264,30,129,135,0
58638,5900,0,0,62,62,0,1,0,1,0,1
65487,445,0,0,66,66,0,1,0,1,0,2
52183,445,0,0,70,70,0,1,0,1,0,2
19330,25174,0,0,62,62,0,1,0,1,0,1
56938,80,50995,80,1403,841,562,10,75,6,4,0
48817,48489,48817,48489,480,149,331,2,1200,1,1,0
65476,53,44080,53,226,110,116,2,29,1,1,0
65501,57470,0,0,72,72,0,1,0,1,0,1
33215,37965,0,0,62,62,0,1,0,1,0,1
65361,53,33877,53,760,97,663,2,30,1,1,0
52703,445,0,0,70,70,0,1,0,1,0,2
61701,44847,0,0,66,66,0,1,0,1,0,1
57581,443,57581,443,2512,1465,1047,21,87,10,11,0
50277,445,0,0,66,66,0,1,0,1,0,2
63972,445,0,0,66,66,0,1,0,1,0,2
26198,64147,0,0,62,62,0,1,0,1,0,1
32124,30188,0,0,62,62,0,1,0,1,0,1
16327,55442,0,0,66,66,0,1,0,1,0,1
55944,53,13576,53,194,94,100,2,30,1,1,0
50276,443,53649,443,9984,2917,7067,49,102,28,21,0
43057,80,9462,80,1195,401,794,9,16,5,4,0
37695,443,3343,443,1134364,30994,1103370,1170,175,403,767,0
65031,53,49062,53,184,94,90,2,31,1,1,0
64203,445,0,0,70,70,0,1,0,1,0,2
53669,59056,24869,59056,70,70,0,2,7,2,0,0
57806,445,0,0,66,66,0,1,0,1,0,2
64787,53,29856,53,728,102,626,2,30,1,1,0
59807,53,15491,53,263,94,169,2,30,1,1,0
65503,445,0,0,66,66,0,1,0,1,0,2
55510,53,10819,53,578,286,292,9,15,5,4,0
57595,443,62180,443,291,171,120,4,16,2,2,0
52096,443,15286,443,283,163,120,4,15,2,2,0
60455,445,0,0,70,70,0,1,0,1,0,2
64914,53,27750,53,168,86,82,2,30,1,1,0
23089,48817,0,0,62,62,0,1,0,1,0,1
27005,27016,41906,27016,882,126,756,2,30,1,1,0
59732,27036,24754,27036,1218,924,294,6,30,3,3,0
60770,443,16135,443,4239,2026,2213,15,120,7,8,0
52731,80,58843,80,1029,567,462,10,17,6,4,0
49562,80,14517,80,318,192,126,6,45,4,2,0
12074,10197,0,0,72,72,0,1,0,1,0,1
56503,53,37647,53,578,286,292,9,15,5,4,0
34914,26467,0,0,62,62,0,1,0,1,0,1
50574,443,59952,443,5870,1785,4085,21,80,12,9,0
49506,443,13324,443,6002,1965,4037,23,270,11,12,0
44933,23,0,0,60,60,0,1,0,1,0,1
59784,42246,0,0,62,62,0,1,0,1,0,1
64257,53,61085,53,211,78,133,2,30,1,1,0
57370,53,22264,53,347,110,237,2,30,1,1,0
57917,44847,0,0,62,62,0,1,0,1,0,1
64068,53,64068,53,1184,83,1101,4,59,2,2,0
34239,80,12111,80,1056,682,374,10,15,6,4,0
49812,445,0,0,66,66,0,1,0,1,0,2
58382,50584,0,0,62,62,0,1,0,1,0,1
53137,35111,13746,35111,70,70,0,2,8,2,0,0
55580,445,0,0,70,70,0,1,0,1,0,2
61806,443,30997,443,7439,1156,6283,19,75,11,8,0
12232,41864,0,0,139,139,0,1,0,1,0,1
49546,443,3244,443,5519,945,4574,15,23,8,7,0
10701,11392,0,0,62,62,0,1,0,1,0,1
21993,25174,0,0,62,62,0,1,0,1,0,1
54332,445,0,0,70,70,0,1,0,1,0,2
58004,80,58289,80,14922,10566,4356,39,75,20,19,0
55540,443,32830,443,10458,5272,5186,24,76,13,11,0
57044,53,54820,53,177,94,83,2,31,1,1,0
37244,53,37244,53,172,76,96,2,30,1,1,0
49752,50584,0,0,62,62,0,1,0,1,0,1
38639,80,55224,80,1013,504,509,10,15,6,4,0
27005,27016,20035,27016,903,126,777,2,31,1,1,0
39718,443,30883,443,10457,3150,7307,25,217,13,12,0
58638,5900,0,0,62,62,0,1,0,1,0,1
63937,43443,33286,43443,246,66,180,4,7,2,2,0
56622,443,37505,443,3575,1079,2496,15,155,7,8,0
54489,443,33538,443,4263,2019,2244,14,136,7,7,0
25973,26467,0,0,66,66,0,1,0,1,0,1
58113,445,0,0,70,70,0,1,0,1,0,2
47643,80,39174,80,3524,2698,826,14,16,8,6,0
61468,443,50536,443,6265,1185,5080,24,89,14,10,0
52657,80,31996,80,26073,2868,23205,41,110,17,24,0
54776,445,0,0,70,70,0,1,0,1,0,2
49154,443,24167,443,3163100,158133,3004967,3863,264,1464,2399,0
26229,21247,0,0,66,66,0,1,0,1,0,1
50265,54145,30228,54145,858,858,0,14,1200,14,0,0
52012,445,0,0,66,66,0,1,0,1,0,2
50201,80,38325,80,5015,2123,2892,25,96,14,11,0
55002,53,54595,53,192,98,94,2,31,1,1,0
56504,53,4684,53,196,100,96,2,30,1,1,0
52387,445,0,0,70,70,0,1,0,1,0,2
26900,27017,32451,27017,422,164,258,6,30,3,3,0
42650,3389,42650,3389,4930,2691,2239,24,19,14,10,0
53256,5900,0,0,60,60,0,1,0,1,0,1
64872,53,24466,53,730,102,628,2,29,1,1,0
9290,443,4925,443,8041,2882,5159,29,23,16,13,0
53973,50546,28275,50546,2069,1081,988,12,16,7,5,0
36099,443,40194,443,48494,10293,38201,71,129,26,45,0
63544,445,0,0,70,70,0,1,0,1,0,2
61388,80,19899,80,14158,1392,12766,26,255,14,12,0
54816,35440,0,0,146,146,0,1,0,1,0,1
58949,443,63115,443,5166,700,4466,16,15,7,9,0
44228,443,22389,443,2754856,125760,2629096,3115,32,1340,1775,0
51499,443,64851,443,43980,3500,40480,65,16,31,34,0
50140,53,14261,53,177,94,83,2,30,1,1,0
55031,445,0,0,70,70,0,1,0,1,0,2
61229,53,16392,53,261,261,0,4,47,4,0,0
34957,80,4367,80,7136,3526,3610,42,1239,21,21,0
49820,445,0,0,70,70,0,1,0,1,0,2
58836,44847,0,0,70,70,0,1,0,1,0,1
64870,53,42981,53,200,102,98,2,33,1,1,0
52990,445,0,0,70,70,0,1,0,1,0,2
19875,30170,0,0,145,145,0,1,0,1,0,1
50127,64147,0,0,66,66,0,1,0,1,0,1
57415,445,0,0,70,70,0,1,0,1,0,2
52990,443,9852,443,7093,2235,4858,39,111,20,19,0
5938,26428,0,0,60,60,0,1,90,1,0,0
56013,445,0,0,70,70,0,1,0,1,0,2
54058,445,0,0,70,70,0,1,0,1,0,2
57965,443,27190,443,8366,2018,6348,32,104,17,15,0
57140,445,0,0,70,70,0,1,0,1,0,2
59282,443,30587,443,5413,968,4445,20,15,11,9,0
57371,443,2707,443,5619,927,4692,17,15,10,7,0
57294,445,0,0,70,70,0,1,0,1,0,2
43435,5228,26335,5228,6668,1369,5299,20,3600,10,10,0
63927,50265,0,0,62,62,0,1,0,1,0,1
44414,23718,0,0,66,66,0,1,0,1,0,1
62250,23117,0,0,66,66,0,1,0,1,0,1
49639,443,42419,443,21062,2202,18860,34,80,15,19,0
57807,443,2939,443,9783,5855,3928,22,122,11,11,0
50487,80,64502,80,13796,627,13169,20,30,8,12,0
49361,53,51044,53,184,94,90,2,31,1,1,0
54014,5228,26717,5228,2493,1541,952,16,3601,8,8,0
57089,445,0,0,70,70,0,1,0,1,0,2
58638,5900,0,0,62,62,0,1,0,1,0,1
64720,53,3807,53,216,102,114,2,30,1,1,0
58638,5900,0,0,62,62,0,1,0,1,0,1
43747,22114,0,0,66,66,0,1,0,1,0,1
44235,50265,0,0,145,145,0,1,0,1,0,1
61002,37965,0,0,145,145,0,1,0,1,0,1
56474,53,9698,53,209,110,99,2,29,1,1,0
59059,80,0,0,62,62,0,1,0,1,0,1
64417,445,0,0,66,66,0,1,0,1,0,2
27005,27015,32807,27015,1622,126,1496,4,30,2,2,0
50984,445,0,0,66,66,0,1,0,1,0,2
56595,80,43530,80,234,234,0,4,12,4,0,0
51121,445,0,0,66,66,0,1,0,1,0,2
56564,445,0,0,66,66,0,1,0,1,0,2
39096,443,59336,443,1268772,32833,1235939,1288,81,409,879,0
1534,54369,0,0,66,66,0,1,0,1,0,1
21502,44847,0,0,66,66,0,1,0,1,0,1
55598,53,62889,53,186,102,84,2,30,1,1,0
56979,80,46084,80,214,140,74,4,35,3,1,0
58744,80,31824,80,4635,1572,3063,12,15,7,5,0
0,0,0,0,98,98,0,1,0,1,0,1
26406,37965,0,0,66,66,0,1,0,1,0,1
49784,445,0,0,66,66,0,1,0,1,0,2
58445,17500,0,0,66,66,0,1,0,1,0,1
57022,80,30750,80,77115,5003,72112,110,35,56,54,0
49736,443,37577,443,378,192,186,7,15,4,3,0
59032,25174,0,0,66,66,0,1,0,1,0,1
27110,22114,0,0,60,60,0,1,0,1,0,1
52150,37603,63249,37603,70,70,0,1,5,1,0,0
49380,445,0,0,70,70,0,1,0,1,0,2
64300,445,0,0,70,70,0,1,0,1,0,2
54519,443,46768,443,70,70,0,1,5,1,0,0
50486,445,0,0,66,66,0,1,0,1,0,2
55204,53,12205,53,263,94,169,2,30,1,1,0
64758,445,0,0,70,70,0,1,0,1,0,2
39133,5223,14877,5223,4113,1213,2900,22,713,12,10,0
50107,445,0,0,70,70,0,1,0,1,0,2
61273,445,0,0,70,70,0,1,0,1,0,2
40905,443,30832,443,6982,1535,5447,30,26,15,15,0
46412,53,4555,53,164,78,86,2,31,1,1,0
55862,62413,0,0,66,66,0,1,0,1,0,1
62759,443,5744,443,9928,5183,4745,34,134,17,17,0
64787,53,33533,53,179,94,85,2,30,1,1,0
56494,3033,0,0,146,146,0,1,0,1,0,1
56127,35440,0,0,62,62,0,1,0,1,0,1
53462,443,47212,443,6384,1091,5293,18,30,10,8,0
64289,445,0,0,66,66,0,1,0,1,0,2
40781,443,17024,443,14327,1918,12409,37,270,17,20,0
35347,20238,0,0,66,66,0,1,0,1,0,1
9120,80,19755,80,326320,11951,314369,346,36,122,224,0
49311,445,0,0,66,66,0,1,0,1,0,2
53159,58710,30090,58710,698,320,378,10,18,6,4,0
51850,80,53740,80,2188,1421,767,11,61,7,4,0
57839,53,57631,53,231,231,0,4,47,4,0,0
51633,445,0,0,66,66,0,1,0,1,0,2
56645,80,11255,80,234,234,0,4,12,4,0,0
58759,443,21160,443,6012,873,5139,18,25,9,9,0
49574,53,41987,53,193,102,91,2,29,1,1,0
56795,53,22826,53,177,94,83,2,30,1,1,0
63385,25174,0,0,66,66,0,1,0,1,0,1
64515,53,64413,53,231,86,145,2,30,1,1,0
55533,53,56018,53,182,93,89,2,31,1,1,0
58654,53,55637,53,168,78,90,2,30,1,1,0
58196,445,0,0,70,70,0,1,0,1,0,2
46633,53,46633,53,237,91,146,2,32,1,1,0
49511,443,56126,443,1200,623,577,13,27,6,7,0
50223,53,39269,53,165,86,79,2,30,1,1,0
38058,443,33797,443,22970,12439,10531,61,98,32,29,0
33351,43890,0,0,146,146,0,1,0,1,0,1
63300,445,0,0,70,70,0,1,0,1,0,2
27910,53,18233,53,211,94,117,2,30,1,1,0
62185,53,27701,53,578,286,292,9,15,5,4,0
55350,53,18566,53,315,95,220,4,50,2,2,0
54440,26467,0,0,66,66,0,1,0,1,0,1
56587,53,37194,53,184,94,90,2,30,1,1,0
52699,25174,0,0,62,62,0,1,0,1,0,1
47832,50584,0,0,62,62,0,1,0,1,0,1
22150,6881,0,0,146,146,0,1,0,1,0,1
17251,10387,0,0,159,159,0,1,0,1,0,1
10669,49756,0,0,60,60,0,1,0,1,0,1
59523,37965,0,0,62,62,0,1,0,1,0,1
64798,53,2925,53,172,88,84,2,30,1,1,0
27005,23010,35544,23010,881,126,755,2,29,1,1,0
58598,50584,0,0,66,66,0,1,0,1,0,1
49497,445,0,0,70,70,0,1,0,1,0,2
41776,443,58103,443,3196404,47816,3148588,2668,147,469,2199,0
49656,53,53745,53,309,118,191,2,30,1,1,0
9264,80,28949,80,318,192,126,6,26,4,2,0
64867,445,0,0,70,70,0,1,0,1,0,2
30945,53,30945,53,237,91,146,2,32,1,1,0
42429,22114,0,0,62,62,0,1,0,1,0,1
51943,55464,52953,55464,70,70,0,1,5,1,0,0
8889,16991,8889,16991,124,60,64,2,31,1,1,0
49841,53,53641,53,751,95,656,2,30,1,1,0
51880,445,0,0,70,70,0,1,0,1,0,2
55577,53,26571,53,199,102,97,2,30,1,1,0
57330,53,61035,53,177,94,83,2,30,1,1,0
51699,445,0,0,66,66,0,1,0,1,0,2
50160,57470,0,0,146,146,0,1,0,1,0,1
55053,445,0,0,70,70,0,1,0,1,0,2
53121,8986,30082,8986,70,70,0,1,5,1,0,0
12694,12446,0,0,62,62,0,1,0,1,0,1
40685,80,25851,80,1278,774,504,12,360,7,5,0
58562,3389,58562,3389,5387,1909,3478,22,21,10,12,0
47362,443,49001,443,8263,2100,6163,34,255,16,18,0
45768,80,41776,80,2784,1804,980,17,20,9,8,0
49784,445,0,0,70,70,0,1,0,1,0,2
63980,443,5737,443,5237,2844,2393,14,135,7,7,0
40511,80,1880,80,1680,950,730,12,15,6,6,0
33109,443,18483,443,6749,1593,5156,23,123,12,11,0
58638,5900,0,0,62,62,0,1,0,1,0,1
59423,445,0,0,70,70,0,1,0,1,0,2
51102,80,31602,80,2794,2075,719,15,30,9,6,0
19634,64147,0,0,62,62,0,1,0,1,0,1
62397,445,0,0,66,66,0,1,0,1,0,2
51957,53,51957,53,825,99,726,2,31,1,1,0
54307,443,65534,443,5661,1444,4217,19,135,11,8,0
6721,37965,0,0,66,66,0,1,0,1,0,1
53218,56205,0,0,66,66,0,1,0,1,0,1
58415,443,47391,443,145249,142210,3039,143,185,106,37,0
48151,123,24928,123,184,94,90,2,30,1,1,0
41213,25174,0,0,62,62,0,1,0,1,0,1
59462,445,0,0,70,70,0,1,0,1,0,2
56256,445,0,0,70,70,0,1,0,1,0,2
18950,50584,0,0,62,62,0,1,0,1,0,1
58638,5900,0,0,62,62,0,1,0,1,0,1
51944,53,51944,53,832,106,726,2,30,1,1,0
63968,53,62729,53,200,102,98,2,30,1,1,0
53466,445,0,0,70,70,0,1,0,1,0,2
3478,61463,0,0,1292,1292,0,1,0,1,0,1
58369,53,5499,53,174,81,93,2,30,1,1,0
53347,443,16972,443,21456,6153,15303,120,491,46,74,0
54684,37965,0,0,62,62,0,1,0,1,0,1
36502,53,33412,53,168,78,90,2,30,1,1,0
55520,445,0,0,70,70,0,1,0,1,0,2
37952,80,16690,80,1372,868,504,13,35,8,5,0
59743,80,42514,80,815748,15896,799852,777,90,244,533,0
55848,445,0,0,70,70,0,1,0,1,0,2
53112,29258,48583,29258,70,70,0,1,5,1,0,0
49418,27054,42342,27054,272,78,194,2,30,1,1,0
53042,445,0,0,66,66,0,1,0,1,0,2
65266,53,11513,53,754,94,660,2,30,1,1,0
52455,445,0,0,66,66,0,1,0,1,0,2
6712,5060,0,0,410,410,0,1,0,1,0,1
55421,57470,0,0,74,74,0,1,0,1,0,1
993,54748,0,0,66,66,0,1,0,1,0,1
38385,443,54542,443,5304,1112,4192,19,31,10,9,0
42819,443,36580,443,10837,3411,7426,34,272,17,17,0
54181,443,63427,443,9283,2154,7129,22,15,12,10,0
64689,445,0,0,70,70,0,1,0,1,0,2
64684,445,0,0,70,70,0,1,0,1,0,2
56663,443,26392,443,9691,2221,7470,16,120,8,8,0
57030,53,58226,53,283,101,182,4,38,2,2,0
58316,445,0,0,70,70,0,1,0,1,0,2
52435,445,0,0,70,70,0,1,0,1,0,2
55337,53,41001,53,198,102,96,2,29,1,1,0
50892,80,51133,80,256436,14131,242305,283,141,111,172,0
56185,443,34268,443,5415,1730,3685,20,120,9,11,0
13120,25174,0,0,146,146,0,1,0,1,0,1
59055,11392,0,0,66,66,0,1,0,1,0,1
57043,53,5828,53,735,88,647,2,31,1,1,0
30580,50265,0,0,66,66,0,1,0,1,0,1
62768,445,0,0,70,70,0,1,0,1,0,2
49319,53,39564,53,199,102,97,2,29,1,1,0
26459,80,26459,80,490,264,226,8,32,5,3,0
51221,6881,43660,6881,479,150,329,2,1200,1,1,0
59757,53,47514,53,260,86,174,2,30,1,1,0
57853,64147,0,0,62,62,0,1,0,1,0,1
65228,53,0,0,88,88,0,1,0,1,0,1
40182,443,24953,443,1312,651,661,13,184,7,6,0
56482,80,53743,80,180583,6825,173758,188,136,68,120,0
40161,443,23210,443,13459,1604,11855,27,66,14,13,0
51052,50584,0,0,66,66,0,1,0,1,0,1
54032,53,0,0,195,79,116,2,31,1,1,0
64533,53,56074,53,183,102,81,2,29,1,1,0
57470,10714,2677,10714,132,132,0,3,1199,3,0,0
52462,25174,0,0,66,66,0,1,0,1,0,1
56590,53,44528,53,305,94,211,2,30,1,1,0
50427,445,0,0,66,66,0,1,0,1,0,2
58359,64147,0,0,72,72,0,1,0,1,0,1
50973,80,57219,80,314164,13077,301087,356,25,144,212,0
51674,445,0,0,70,70,0,1,0,1,0,2
56697,53,34605,53,198,102,96,2,30,1,1,0
32866,443,34870,443,23467,16522,6945,51,161,29,22,0
49917,443,56620,443,5899,732,5167,16,41,8,8,0
49632,53,26153,53,199,102,97,2,30,1,1,0
51046,53,51046,53,244,106,138,2,30,1,1,0
49533,53,65286,53,771,101,670,2,30,1,1,0
26722,11446,0,0,62,62,0,1,0,1,0,1
57340,53,43547,53,370,94,276,2,30,1,1,0
63139,53,20764,53,234,234,0,4,47,4,0,0
55341,39004,0,0,74,74,0,1,0,1,0,1
45525,53,45525,53,86,86,0,1,30,1,0,0
37567,443,42814,443,214,140,74,4,15,3,1,0
10115,52700,0,0,62,62,0,1,0,1,0,1
35570,22114,0,0,62,62,0,1,0,1,0,1
49737,443,48877,443,35419,29471,5948,42,31,27,15,0
39823,36237,0,0,66,66,0,1,0,1,0,1
17855,53,17855,53,240,98,142,2,30,1,1,0
51130,61689,0,0,66,66,0,1,0,1,0,1
44040,443,39447,443,11774,5465,6309,75,585,38,37,0
54148,445,0,0,70,70,0,1,0,1,0,2
53811,8999,57709,8999,1322,799,523,13,16,8,5,0
55353,53,1525,53,168,86,82,2,30,1,1,0
58638,5900,0,0,62,62,0,1,0,1,0,1
27005,27111,65327,27111,913,126,787,2,30,1,1,0
50550,443,42250,443,8123,1809,6314,22,71,12,10,0
52988,53567,0,0,62,62,0,1,0,1,0,1
47561,26467,0,0,62,62,0,1,0,1,0,1
56481,445,0,0,66,66,0,1,0,1,0,2
52625,53,52625,53,231,88,143,2,32,1,1,0
35654,80,35654,80,7040,5744,1296,16,158,9,7,0
64493,53,24989,53,280,97,183,4,59,2,2,0
17046,53,17046,53,220,90,130,2,30,1,1,0
60792,443,58920,443,5037,1343,3694,18,45,11,7,0
59507,445,0,0,70,70,0,1,0,1,0,2
56335,53,52497,53,193,102,91,2,30,1,1,0
50424,55777,0,0,62,62,0,1,0,1,0,1
45394,53,64814,53,199,94,105,2,30,1,1,0
55452,53,8362,53,184,94,90,2,29,1,1,0
56813,37092,33767,37092,70,70,0,1,5,1,0,0
58638,5900,0,0,62,62,0,1,0,1,0,1
47473,443,41796,443,11072,3983,7089,27,186,15,12,0
55178,80,55178,80,374,240,134,7,15,5,2,0
65516,445,0,0,70,70,0,1,0,1,0,2
57838,53,1470,53,70,70,0,1,29,1,0,0
43326,443,42679,443,10063,2126,7937,36,120,18,18,0
61286,443,41653,443,248071,7320,240751,269,268,89,180,0
36926,53,54098,53,164,78,86,2,30,1,1,0
58278,443,51446,443,7349712,213635,7136077,7600,192,2303,5297,0
62982,445,0,0,70,70,0,1,0,1,0,2
38957,443,58777,443,7457,1333,6124,18,200,10,8,0
55269,53,20584,53,186,95,91,2,31,1,1,0
59580,445,0,0,70,70,0,1,0,1,0,2
51806,443,40388,443,3182,1568,1614,8,121,4,4,0
49790,53,34832,53,195,102,93,2,30,1,1,0
50579,53,23674,53,179,94,85,2,30,1,1,0
55806,53,52811,53,200,102,98,2,33,1,1,0
38678,443,31559,443,484,210,274,8,26,4,4,0
61897,445,0,0,70,70,0,1,0,1,0,2
62913,445,0,0,70,70,0,1,0,1,0,2
50690,445,0,0,70,70,0,1,0,1,0,2
12285,61248,0,0,139,139,0,1,0,1,0,3
55912,53,4881,53,199,102,97,2,31,1,1,0
48852,443,7799,443,38886,2134,36752,55,16,24,31,0
51923,445,0,0,70,70,0,1,0,1,0,2
42705,80,6053,80,1222,782,440,11,15,6,5,0
49516,53,42173,53,183,94,89,2,30,1,1,0
55810,445,0,0,66,66,0,1,0,1,0,2
46587,57470,0,0,62,62,0,1,0,1,0,1
59298,443,18109,443,20971,2840,18131,52,89,24,28,0
53543,51819,43192,51819,70,70,0,2,7,2,0,0
39776,443,45893,443,6283,1439,4844,25,316,13,12,0
49654,53,49736,53,184,94,90,2,30,1,1,0
65487,53,62444,53,184,94,90,2,30,1,1,0
33725,53,33725,53,216,90,126,2,30,1,1,0
55217,443,55217,443,3239,740,2499,15,40,8,7,0
57057,445,0,0,70,70,0,1,0,1,0,2
64106,64147,0,0,66,66,0,1,0,1,0,1
50481,445,0,0,70,70,0,1,0,1,0,2
50283,445,0,0,70,70,0,1,0,1,0,2
47910,7461,0,0,60,60,0,1,0,1,0,1
57019,53,12115,53,186,95,91,2,30,1,1,0
55312,443,20877,443,7952,3638,4314,36,149,17,19,0
50730,443,7850,443,1323,738,585,10,16,6,4,0
38732,443,56897,443,9217,1548,7669,25,50,13,12,0
56779,53,5601,53,173,94,79,2,30,1,1,0
65359,53,19133,53,193,102,91,2,31,1,1,0
52405,53,59064,53,168,78,90,2,30,1,1,0
37308,43890,0,0,62,62,0,1,0,1,0,1
38011,443,43234,443,6900,4387,2513,37,98,19,18,0
50304,443,23238,443,3565,1947,1618,19,15,9,10,0
64694,53,22388,53,289,82,207,4,46,2,2,0
56090,53,62587,53,195,94,101,2,30,1,1,0
55565,64147,0,0,66,66,0,1,0,1,0,1
57470,43155,32052,43155,594,594,0,10,1199,10,0,0
53020,80,53020,80,134273,4066,130207,163,22,59,104,0
58638,5900,0,0,62,62,0,1,0,1,0,1
54742,50584,0,0,66,66,0,1,0,1,0,1
57268,443,29567,443,11546,3604,7942,38,120,20,18,0
37343,21247,0,0,62,62,0,1,0,1,0,1
3375,35253,0,0,66,66,0,1,0,1,0,1
58671,445,0,0,70,70,0,1,0,1,0,2
33240,443,43731,443,7375,4769,2606,24,16,14,10,0
56312,443,54503,443,564,292,272,9,25,5,4,0
60722,445,0,0,70,70,0,1,0,1,0,2
8160,80,8160,80,1670,1044,626,15,84,8,7,0
54523,445,0,0,70,70,0,1,0,1,0,2
57744,53,14767,53,198,93,105,2,31,1,1,0
57165,53,9169,53,216,102,114,2,30,1,1,0
55897,53,59750,53,733,85,648,2,30,1,1,0
50912,445,0,0,70,70,0,1,0,1,0,2
57763,52752,0,0,66,66,0,1,0,1,0,1
58037,80,32783,80,2339,1122,1217,11,20,6,5,0
37965,8999,40313,8999,491,150,341,2,1199,1,1,0
64725,445,0,0,70,70,0,1,0,1,0,2
10461,53,10461,53,220,90,130,2,30,1,1,0
53656,58624,15076,58624,70,70,0,2,8,2,0,0
64121,443,64564,443,1411,852,559,13,24,7,6,0
64313,53,9214,53,226,110,116,2,30,1,1,0
35924,443,41677,443,4310,1640,2670,22,159,10,12,0
64925,53,10435,53,338,110,228,2,30,1,1,0
56206,53,48081,53,711,87,624,2,30,1,1,0
49337,445,0,0,70,70,0,1,0,1,0,2
60786,51505,0,0,66,66,0,1,0,1,0,1
54324,27016,3441,27016,924,924,0,3,30,3,0,0
50182,445,0,0,66,66,0,1,0,1,0,2
52001,80,32528,80,7578,4652,2926,49,323,30,19,0
54136,443,48147,443,18716,8002,10714,100,945,51,49,0
63032,53,34881,53,304,86,218,2,30,1,1,0
1027,64147,0,0,62,62,0,1,0,1,0,1
39017,443,58610,443,5176,861,4315,16,26,9,7,0
63529,445,0,0,70,70,0,1,0,1,0,2
56629,53,45116,53,183,94,89,2,29,1,1,0
50883,80,64742,80,204646,11741,192905,240,141,104,136,0
123,123,14772,123,184,94,90,2,29,1,1,0
49905,80,54689,80,1173,672,501,8,31,5,3,0
52126,56057,15046,56057,70,70,0,2,8,2,0,0
56864,53,65006,53,200,102,98,2,31,1,1,0
56737,53,36153,53,817,98,719,2,31,1,1,0
49499,445,0,0,70,70,0,1,0,1,0,2
56820,53,40391,53,193,102,91,2,30,1,1,0
4041,50584,0,0,62,62,0,1,0,1,0,1
14175,10387,0,0,159,159,0,1,0,1,0,1
9476,443,21369,443,3999,905,3094,15,26,8,7,0
51986,41982,32620,41982,70,70,0,1,5,1,0,0
53607,51631,7980,51631,70,70,0,2,8,2,0,0
49714,53,21823,53,767,102,665,2,30,1,1,0
23406,443,23406,443,5368,1609,3759,21,75,12,9,0
53234,443,19776,443,21571,8604,12967,38,34,19,19,0
58638,5900,0,0,62,62,0,1,0,1,0,1
49876,53,33233,53,199,102,97,2,30,1,1,0
60922,445,0,0,70,70,0,1,0,1,0,2
60965,445,0,0,70,70,0,1,0,1,0,2
64990,55442,0,0,66,66,0,1,0,1,0,1
49490,53,6765,53,364,92,272,4,38,2,2,0
41210,23,0,0,60,60,0,1,0,1,0,1
64260,53,38791,53,211,78,133,2,30,1,1,0
63471,445,0,0,70,70,0,1,0,1,0,2
61858,445,0,0,70,70,0,1,0,1,0,2
55430,445,0,0,70,70,0,1,0,1,0,2
64181,53,25731,53,188,96,92,2,31,1,1,0
55051,443,30290,443,6975,1243,5732,29,254,14,15,0
56586,445,0,0,70,70,0,1,0,1,0,2
33432,5900,0,0,60,60,0,1,0,1,0,1
59771,445,0,0,66,66,0,1,0,1,0,2
63379,443,51286,443,2649,330,2319,12,134,5,7,0
49685,80,12171,80,1548,847,701,10,16,5,5,0
50857,3389,50857,3389,3613,1594,2019,19,18,10,9,0
61336,61689,0,0,66,66,0,1,0,1,0,1
52564,445,0,0,70,70,0,1,0,1,0,2
51781,445,0,0,70,70,0,1,0,1,0,1
57674,53,0,0,195,79,116,2,30,1,1,0
7521,20234,0,0,157,157,0,1,0,1,0,1
54773,50584,0,0,62,62,0,1,0,1,0,1
55831,53,12169,53,182,93,89,2,31,1,1,0
45184,80,27181,80,1718,1404,314,11,15,6,5,0
58744,443,37896,443,42954,12409,30545,154,319,67,87,0
18623,1,0,0,66,66,0,1,0,1,0,1
56308,53,37236,53,184,94,90,2,31,1,1,0
63776,445,0,0,70,70,0,1,0,1,0,2
65497,53,19517,53,490,111,379,4,54,2,2,0
50538,445,0,0,66,66,0,1,0,1,0,2
53791,16881,62073,16881,70,70,0,2,8,2,0,0
54276,39004,0,0,62,62,0,1,0,1,0,1
53986,445,0,0,70,70,0,1,0,1,0,2
55165,53,23562,53,193,102,91,2,29,1,1,0
62386,37965,0,0,66,66,0,1,0,1,0,1
56982,80,63526,80,214,140,74,4,35,3,1,0
60922,445,0,0,66,66,0,1,0,1,0,2
50730,443,12545,443,3514,1609,1905,30,51,16,14,0
57334,53,10038,53,184,94,90,2,30,1,1,0
59765,445,0,0,70,70,0,1,0,1,0,2
9294,443,62511,443,6356,979,5377,19,27,10,9,0
65526,28793,0,0,66,66,0,1,0,1,0,1
50967,443,62336,443,5841,1986,3855,19,17,11,8,0
47178,53,0,0,82,82,0,2,40,2,0,0
53513,443,7067,443,1625,1038,587,14,34,8,6,0
44062,443,39025,443,4614,853,3761,16,127,9,7,0
56534,53,47047,53,177,94,83,2,29,1,1,0
61508,443,13468,443,215490,8471,207019,194,45,45,149,0
54073,445,0,0,66,66,0,1,0,1,0,2
49853,443,20017,443,11534,2076,9458,43,60,21,22,0
38705,443,49826,443,1248170,26899,1221271,1212,16,382,830,0
54981,445,0,0,70,70,0,1,0,1,0,2
50915,80,27954,80,10548172,142265,10405907,9105,134,1982,7123,0
28007,443,65025,443,10168,968,9200,19,15,9,10,0
57295,443,4265,443,5614,733,4881,16,15,9,7,0
53031,445,0,0,66,66,0,1,0,1,0,2
60244,445,0,0,70,70,0,1,0,1,0,2
53252,443,20191,443,6053,974,5079,20,66,10,10,0
34355,80,5779,80,416,210,206,7,15,4,3,0
57013,53,17393,53,178,94,84,2,30,1,1,0
57044,53,19964,53,194,99,95,2,31,1,1,0
49369,443,29095,443,7165,1099,6066,16,15,9,7,0
58638,5900,0,0,62,62,0,1,0,1,0,1
64135,53,50232,53,192,98,94,2,31,1,1,0
57204,53,13761,53,183,94,89,2,30,1,1,0
64550,53,62266,53,221,94,127,2,29,1,1,0
64869,53,31516,53,195,94,101,2,30,1,1,0
50637,36237,0,0,66,66,0,1,0,1,0,1
52407,443,53495,443,100194,6406,93788,171,24,85,86,0
34527,443,29221,443,480624,56231,424393,860,196,427,433,0
27005,27015,37450,27015,879,126,753,2,31,1,1,0
53314,64097,0,0,66,66,0,1,0,1,0,1
52405,445,0,0,70,70,0,1,0,1,0,2
57416,66,12942,66,70,70,0,1,4,1,0,0
64366,443,7841,443,6205,1316,4889,27,301,14,13,0
56536,443,5996,443,210110,14803,195307,246,105,103,143,0
57203,445,0,0,66,66,0,1,0,1,0,2
49973,53,28904,53,747,93,654,2,30,1,1,0
30472,53,56482,53,223,86,137,2,30,1,1,0
24838,39828,0,0,60,60,0,1,0,1,0,1
57547,80,39933,80,32368,2187,30181,45,337,23,22,0
21588,52700,0,0,145,145,0,1,0,1,0,1
57034,445,0,0,70,70,0,1,0,1,0,2
65240,53,35636,53,755,102,653,2,30,1,1,0
57307,443,21158,443,8407,3013,5394,43,15,24,19,0
64559,53,6054,53,196,100,96,2,31,1,1,0
27063,25174,0,0,62,62,0,1,0,1,0,1
55160,443,10978,443,333522,14341,319181,347,129,109,238,0
57119,80,41470,80,5774,783,4991,17,75,10,7,0
54502,34729,0,0,66,66,0,1,0,1,0,1
57470,56098,25356,56098,1359,726,633,6,1199,3,3,0
43225,443,17321,443,3831584,85342,3746242,3246,110,597,2649,0
56047,443,45831,443,126,60,66,3,4,2,1,0
39820,443,15397,443,2642442,95056,2547386,2730,3629,999,1731,0
57339,57470,0,0,66,66,0,1,0,1,0,1
57277,5223,45346,5223,4339,1521,2818,23,3002,14,9,0
54063,443,37024,443,1313,652,661,13,185,7,6,0
37540,443,32914,443,6749,2315,4434,24,46,14,10,0
57033,53,22099,53,216,110,106,2,30,1,1,0
55125,53,57418,53,170,87,83,2,31,1,1,0
53771,53,15804,53,168,78,90,2,30,1,1,0
20508,57470,0,0,62,62,0,1,0,1,0,1
55157,7302,0,0,66,66,0,1,0,1,0,1
61323,23117,0,0,62,62,0,1,0,1,0,1
24731,51505,0,0,62,62,0,1,0,1,0,1
56630,80,55230,80,234,234,0,4,12,4,0,0
17676,23,0,0,60,60,0,1,0,1,0,1
62765,16933,0,0,66,66,0,1,0,1,0,1
61150,11392,0,0,62,62,0,1,0,1,0,1
54643,445,0,0,70,70,0,1,0,1,0,2
2904,44847,0,0,78,78,0,1,0,1,0,1
25595,2323,0,0,60,60,0,1,0,1,0,1
36562,443,34526,443,3452,1535,1917,18,82,10,8,0
59228,445,0,0,70,70,0,1,0,1,0,2
49248,35993,0,0,66,66,0,1,0,1,0,1
58638,5900,0,0,62,62,0,1,0,1,0,1
56765,53,27082,53,194,102,92,2,31,1,1,0
56648,445,0,0,66,66,0,1,0,1,0,2
50761,445,0,0,70,70,0,1,0,1,0,2
34316,53,37625,53,168,78,90,2,29,1,1,0
57098,1,0,0,78,78,0,1,0,1,0,1
26502,64147,0,0,62,62,0,1,0,1,0,1
60132,443,39833,443,350,210,140,6,25,4,2,0
35333,80,8364,80,1432,663,769,10,19,6,4,0
58829,64147,0,0,66,66,0,1,0,1,0,1
62709,57470,0,0,62,62,0,1,0,1,0,1
65192,53,33207,53,178,94,84,2,30,1,1,0
51077,445,0,0,70,70,0,1,0,1,0,2
55711,26467,0,0,66,66,0,1,0,1,0,1
39303,80,19010,80,3198,1493,1705,18,80,11,7,0
49340,53,57846,53,387,134,253,2,30,1,1,0
59652,443,50919,443,562,562,0,4,175,4,0,0
19204,56448,0,0,78,78,0,1,0,1,0,1
55978,445,0,0,70,70,0,1,0,1,0,2
50572,80,46272,80,62,62,0,1,5,1,0,0
49744,53,4877,53,211,102,109,2,30,1,1,0
64180,53,4267,53,180,94,86,2,30,1,1,0
63795,445,0,0,66,66,0,1,0,1,0,2
50052,53,19645,53,738,86,652,2,30,1,1,0
57342,53,37406,53,166,85,81,2,31,1,1,0
59270,445,0,0,70,70,0,1,0,1,0,2
18745,64147,0,0,66,66,0,1,0,1,0,1
51310,64147,0,0,66,66,0,1,0,1,0,1
50052,65008,0,0,60,60,0,1,0,1,0,1
48025,44847,0,0,62,62,0,1,0,1,0,1
18029,50584,0,0,66,66,0,1,0,1,0,1
57397,53,42342,53,256,93,163,2,31,1,1,0
54632,445,0,0,66,66,0,1,0,1,0,2
53698,8120,50996,8120,70,70,0,2,8,2,0,0
54389,28543,0,0,66,66,0,1,0,1,0,1
43671,17372,0,0,62,62,0,1,0,1,0,1
58279,443,21713,443,3878,1156,2722,14,136,7,7,0
50869,445,0,0,66,66,0,1,0,1,0,2
51655,445,0,0,66,66,0,1,0,1,0,2
34154,443,26354,443,45554,1695,43859,50,30,15,35,0
51776,8000,6250,8000,328,142,186,6,90,3,3,0
65388,55783,0,0,66,66,0,1,0,1,0,1
52811,44847,0,0,66,66,0,1,0,1,0,1
65266,53,57275,53,216,110,106,2,29,1,1,0
4019,50584,0,0,66,66,0,1,0,1,0,1
6416,22114,0,0,66,66,0,1,0,1,0,1
62566,35993,0,0,66,66,0,1,0,1,0,1
37579,443,43995,443,499,425,74,4,0,3,1,0
56180,53,56180,53,229,98,131,2,30,1,1,0
59147,25174,0,0,62,62,0,1,0,1,0,1
51300,445,0,0,70,70,0,1,0,1,0,2
58879,443,4460,443,5168,700,4468,16,15,7,9,0
56275,53,46209,53,166,86,80,2,30,1,1,0
60699,445,0,0,66,66,0,1,0,1,0,2
50998,445,0,0,70,70,0,1,0,1,0,2
49235,80,47953,80,1783342,58977,1724365,1613,162,445,1168,0
56269,445,0,0,70,70,0,1,0,1,0,2
64256,53,36499,53,211,78,133,2,29,1,1,0
26833,443,13799,443,21487,16430,5057,39,21,22,17,0
16693,53,16693,53,217,87,130,2,31,1,1,0
22683,39210,0,0,60,60,0,1,0,1,0,1
9472,443,45589,443,5699,505,5194,14,15,7,7,0
55671,53,24025,53,196,102,94,2,33,1,1,0
30188,55886,45541,55886,502,150,352,2,1200,1,1,0
58638,5900,0,0,62,62,0,1,0,1,0,1
50008,53,59037,53,359,95,264,4,46,2,2,0
59282,123,52231,123,184,94,90,2,30,1,1,0
53365,80,32049,80,405,285,120,5,15,3,2,0
53824,41482,38792,41482,70,70,0,2,8,2,0,0
37941,443,61204,443,69429,16478,52951,156,182,83,73,0
54783,445,0,0,70,70,0,1,0,1,0,2
33459,80,37833,80,1658,1344,314,10,14,5,5,0
54986,53,42487,53,214,110,104,2,30,1,1,0
55276,53,37772,53,215,94,121,2,30,1,1,0
8999,1,0,0,146,146,0,1,0,1,0,1
51362,445,0,0,66,66,0,1,0,1,0,2
49001,22114,0,0,62,62,0,1,0,1,0,1
53371,445,0,0,66,66,0,1,0,1,0,2
55525,53,3773,53,214,110,104,2,30,1,1,0
14693,64147,0,0,66,66,0,1,0,1,0,1
54848,445,0,0,70,70,0,1,0,1,0,2
58054,25,23956,25,1370,496,874,16,16,8,8,0
62261,445,0,0,70,70,0,1,0,1,0,2
53154,443,28335,443,3947,2796,1151,22,28,12,10,0
65327,445,0,0,70,70,0,1,0,1,0,2
27368,22114,0,0,62,62,0,1,0,1,0,1
6721,37965,0,0,66,66,0,1,0,1,0,1
56317,53,35779,53,183,94,89,2,31,1,1,0
54490,445,0,0,70,70,0,1,0,1,0,2
65236,53,5620,53,758,102,656,2,30,1,1,0
59698,445,0,0,70,70,0,1,0,1,0,2
57379,445,0,0,70,70,0,1,0,1,0,2
56534,53,33541,53,276,94,182,2,30,1,1,0
50463,445,0,0,70,70,0,1,0,1,0,2
64793,445,0,0,70,70,0,1,0,1,0,2
13285,29892,0,0,145,145,0,1,0,1,0,1
55696,445,0,0,70,70,0,1,0,1,0,2
1238,51505,0,0,62,62,0,1,0,1,0,1
53813,443,59809,443,499,425,74,4,0,3,1,0
52705,80,52705,80,7237,2578,4659,19,16,9,10,0
55705,53,13969,53,281,101,180,4,58,2,2,0
38420,80,16840,80,4535,1637,2898,23,2899,14,9,0
43674,53,36130,53,199,94,105,2,30,1,1,0
49345,443,4175,443,61954,10029,51925,114,82,50,64,0
11066,50584,0,0,66,66,0,1,0,1,0,1
60675,443,27643,443,1871,1235,636,13,31,8,5,0
60887,443,40935,443,3795,2679,1116,27,45,15,12,0
28286,22114,0,0,62,62,0,1,0,1,0,1
63578,35440,0,0,66,66,0,1,0,1,0,1
61275,445,0,0,70,70,0,1,0,1,0,2
58011,445,0,0,70,70,0,1,0,1,0,2
11317,53563,0,0,143,143,0,1,0,1,0,3
50275,443,24781,443,708,362,346,11,18,6,5,0
55733,445,0,0,66,66,0,1,0,1,0,2
0,0,0,0,74,74,0,1,0,1,0,1
51298,445,0,0,70,70,0,1,0,1,0,2
11450,57470,0,0,62,62,0,1,0,1,0,1
47879,443,13971,443,37598,2397,35201,53,239,22,31,0
63474,48817,0,0,62,62,0,1,0,1,0,1
27005,27016,51582,27016,1626,126,1500,4,30,2,2,0
38692,443,1550,443,1188751,17817,1170934,1053,16,255,798,0
40977,21247,0,0,62,62,0,1,0,1,0,1
49995,53,30507,53,197,102,95,2,33,1,1,0
11992,443,11992,443,12020,5977,6043,38,30,23,15,0
65329,445,0,0,70,70,0,1,0,1,0,2
39287,57470,0,0,62,62,0,1,0,1,0,1
55804,53,21847,53,193,102,91,2,30,1,1,0
39380,1,0,0,146,146,0,1,0,1,0,1
52035,36498,46508,36498,70,70,0,2,9,2,0,0
27005,27011,25017,27011,1622,126,1496,4,31,2,2,0
49393,30188,0,0,66,66,0,1,0,1,0,1
55176,80,55176,80,374,240,134,7,15,5,2,0
46273,5228,19288,5228,5239,1558,3681,27,4020,9,18,0
64116,53,50037,53,184,94,90,2,31,1,1,0
55286,53,17426,53,268,87,181,4,35,2,2,0
55236,443,64536,443,10293,2881,7412,25,45,14,11,0
11136,15503,0,0,62,62,0,1,0,1,0,1
45964,2666,0,0,60,60,0,1,0,1,0,1
49953,53,45166,53,214,110,104,2,30,1,1,0
60557,23117,0,0,66,66,0,1,0,1,0,1
50210,443,12154,443,6444,1320,5124,31,727,10,21,0
56204,53,48094,53,195,102,93,2,30,1,1,0
44847,17977,12872,17977,502,150,352,2,1200,1,1,0
53710,443,55386,443,499,425,74,4,0,3,1,0
58638,5900,0,0,62,62,0,1,0,1,0,1
62884,5223,41292,5223,11427,6608,4819,37,248,21,16,0
16522,26467,0,0,62,62,0,1,0,1,0,1
62608,445,0,0,70,70,0,1,0,1,0,2
57470,38871,35688,38871,545,166,379,2,1199,1,1,0
53929,60741,10876,60741,320,140,180,6,6,3,3,0
43271,50584,0,0,62,62,0,1,0,1,0,1
55352,53,46162,53,216,110,106,2,30,1,1,0
54504,445,0,0,66,66,0,1,0,1,0,2
10080,443,4270,443,130,70,60,3,5,2,1,0
55733,53,30284,53,177,94,83,2,30,1,1,0
55076,53,43465,53,183,94,89,2,30,1,1,0
62904,80,35309,80,1515,481,1034,11,16,6,5,0
54267,445,0,0,66,66,0,1,0,1,0,2
20133,2767,0,0,62,62,0,1,0,1,0,1
49181,53,15171,53,491,98,393,4,40,2,2,0
55467,53,17631,53,193,102,91,2,29,1,1,0
34351,443,4638,443,402051,17714,384337,520,83,228,292,0
63962,53,53078,53,188,96,92,2,31,1,1,0
64403,445,0,0,66,66,0,1,0,1,0,2
53710,80,64568,80,2499,531,1968,11,75,6,5,0
46505,443,50685,443,7072,1541,5531,27,271,12,15,0
56743,443,40694,443,7789,2275,5514,30,47,16,14,0
49607,53,13201,53,259,102,157,2,29,1,1,0
48817,63615,48817,63615,765,296,469,4,1200,2,2,0
49418,27018,13297,27018,259,78,181,2,30,1,1,0
44732,80,44732,80,369759,9557,360202,388,22,137,251,0
50266,443,41683,443,49981,15486,34495,269,138,136,133,0
55708,445,0,0,70,70,0,1,0,1,0,2
56772,53,47377,53,168,86,82,2,30,1,1,0
36413,443,33262,443,2064683,47545,2017138,1994,33,657,1337,0
62926,445,0,0,70,70,0,1,0,1,0,2
57613,42707,0,0,66,66,0,1,0,1,0,1
27005,27333,40989,27333,890,126,764,2,30,1,1,0
31061,23,0,0,60,60,0,1,0,1,0,1
57342,443,57537,443,10761,5724,5037,43,15,25,18,0
45908,3383,0,0,60,60,0,1,0,1,0,1
56029,445,0,0,70,70,0,1,0,1,0,2
7561,43890,0,0,62,62,0,1,0,1,0,1
55913,53,19739,53,177,94,83,2,30,1,1,0
55078,443,55078,443,4401,1494,2907,19,30,11,8,0
51163,445,0,0,70,70,0,1,0,1,0,2
12545,25174,0,0,62,62,0,1,0,1,0,1
57347,445,0,0,66,66,0,1,0,1,0,2
18796,443,17365,443,2227,1018,1209,17,15,8,9,0
40768,443,17418,443,3287,2049,1238,12,32,7,5,0
49323,445,0,0,70,70,0,1,0,1,0,2
60486,8999,61783,8999,70,70,0,2,8,2,0,0
57895,443,60971,443,10639,4680,5959,53,176,24,29,0
64803,53,24000,53,303,303,0,4,47,4,0,0
64889,53,50666,53,215,102,113,2,30,1,1,0
49978,53,38632,53,195,102,93,2,29,1,1,0
55596,53,61686,53,170,87,83,2,30,1,1,0
56603,53,24241,53,179,94,85,2,30,1,1,0
56563,443,19548,443,4528,884,3644,15,26,9,6,0
58148,43890,0,0,62,62,0,1,0,1,0,1
65335,445,0,0,66,66,0,1,0,1,0,2
65048,53,54954,53,754,94,660,2,31,1,1,0
50991,445,0,0,70,70,0,1,0,1,0,2
59295,445,0,0,70,70,0,1,0,1,0,2
61532,445,0,0,70,70,0,1,0,1,0,2
64503,53,37724,53,209,102,107,2,30,1,1,0
54779,445,0,0,70,70,0,1,0,1,0,2
9296,443,44194,443,3792,488,3304,14,16,7,7,0
61920,53,61920,53,298,114,184,2,30,1,1,0
58631,445,0,0,70,70,0,1,0,1,0,2
61015,445,0,0,66,66,0,1,0,1,0,2
57546,443,50936,443,34428,22220,12208,84,122,41,43,0
55554,22114,0,0,62,62,0,1,0,1,0,1
56402,53,29838,53,322,134,188,2,30,1,1,0
53170,20259,55641,20259,70,70,0,1,5,1,0,0
57134,445,0,0,70,70,0,1,0,1,0,2
56669,80,21282,80,234,234,0,4,12,4,0,0
29623,37807,0,0,62,62,0,1,0,1,0,1
55498,445,0,0,70,70,0,1,0,1,0,2
64190,445,0,0,66,66,0,1,0,1,0,2
443,64347,0,0,131,131,0,1,0,1,0,1
55310,50584,0,0,66,66,0,1,0,1,0,1
58904,445,0,0,66,66,0,1,0,1,0,2
28413,64147,0,0,62,62,0,1,0,1,0,1
53305,445,0,0,70,70,0,1,0,1,0,2
25237,53,25237,53,216,82,134,2,33,1,1,0
57492,443,47894,443,380975,82011,298964,804,171,343,461,0
11136,15503,0,0,62,62,0,1,0,1,0,1
61431,443,2753,443,1401,940,461,11,28,7,4,0
51263,443,47905,443,143597,6963,136634,206,439,103,103,0
26900,27017,65080,27017,422,164,258,6,30,3,3,0
40128,80,6000,80,2437,1277,1160,12,16,7,5,0
61013,41705,0,0,66,66,0,1,0,1,0,1
57727,443,62460,443,54944,4374,50570,88,361,44,44,0
37965,35771,32766,35771,481,150,331,2,1199,1,1,0
55018,53,31411,53,174,89,85,2,30,1,1,0
58856,443,16403,443,4005,1421,2584,14,136,7,7,0
64841,53,21377,53,173,94,79,2,30,1,1,0
49959,443,21643,443,102240,4349,97891,128,136,46,82,0
59945,443,18013,443,10477,3435,7042,34,20,18,16,0
54547,445,0,0,70,70,0,1,0,1,0,2
57894,443,52904,443,4544,1112,3432,21,176,12,9,0
16474,50584,0,0,146,146,0,1,0,1,0,1
49364,53,20144,53,183,94,89,2,30,1,1,0
60392,1134,52281,1134,70,70,0,2,8,2,0,0
57246,53,49639,53,183,94,89,2,31,1,1,0
46116,57470,0,0,74,74,0,1,0,1,0,1
53122,443,60812,443,12409,2224,10185,36,26,19,17,0
59485,80,39693,80,882,527,355,10,255,6,4,0
50271,445,0,0,70,70,0,1,0,1,0,2
50508,445,0,0,66,66,0,1,0,1,0,2
49505,443,2441,443,35158,5065,30093,53,42,18,35,0
65251,80,48445,80,6352,4052,2300,44,630,23,21,0
53833,53,46684,53,211,78,133,2,30,1,1,0
56620,443,2901,443,1327,918,409,10,25,6,4,0
25583,2323,0,0,60,60,0,1,0,1,0,1
58638,5900,0,0,62,62,0,1,0,1,0,1
63585,445,0,0,66,66,0,1,0,1,0,2
60744,40010,53059,40010,316,136,180,6,5,3,3,0
57375,53,63119,53,198,102,96,2,30,1,1,0
6889,55108,0,0,143,143,0,1,0,1,0,1
49968,445,0,0,70,70,0,1,0,1,0,2
65209,53,17107,53,212,102,110,2,30,1,1,0
64611,53,46299,53,189,102,87,2,30,1,1,0
65404,443,46166,443,63040,3063,59977,78,129,30,48,0
4447,35440,0,0,66,66,0,1,0,1,0,1
55152,53,31927,53,177,94,83,2,30,1,1,0
54973,53,49914,53,811,94,717,2,29,1,1,0
8040,44847,0,0,66,66,0,1,0,1,0,1
63285,445,0,0,66,66,0,1,0,1,0,2
51836,37753,57785,37753,70,70,0,1,4,1,0,0
49174,53,1263,53,166,86,80,2,31,1,1,0
54952,5228,14099,5228,12140,3028,9112,54,4653,28,26,0
53917,443,58017,443,499,425,74,4,0,3,1,0
49480,53,38554,53,428,96,332,4,52,2,2,0
53281,80,26227,80,124,64,60,3,5,2,1,0
55323,445,0,0,70,70,0,1,0,1,0,2
49289,53,16244,53,177,94,83,2,30,1,1,0
15333,44847,0,0,146,146,0,1,0,1,0,1
13559,57866,0,0,66,66,0,1,0,1,0,1
64092,445,0,0,66,66,0,1,0,1,0,2
64748,53,6781,53,183,94,89,2,30,1,1,0
50011,53,7545,53,766,102,664,2,30,1,1,0
55496,64097,0,0,66,66,0,1,0,1,0,1
35012,443,7162,443,1461,980,481,11,25,7,4,0
63037,445,0,0,66,66,0,1,0,1,0,2
45392,443,53669,443,1312,651,661,13,185,7,6,0
53563,35440,0,0,66,66,0,1,0,1,0,1
62658,445,0,0,70,70,0,1,0,1,0,2
54612,445,0,0,66,66,0,1,0,1,0,2
18472,5278,0,0,145,145,0,1,0,1,0,1
65209,57866,0,0,66,66,0,1,0,1,0,1
51414,22,0,0,60,60,0,1,0,1,0,1
16403,16386,26193,16386,308,128,180,6,30,3,3,0
50483,445,0,0,70,70,0,1,0,1,0,2
44847,20101,53137,20101,150,150,0,1,1200,1,0,0
64140,53,44344,53,184,94,90,2,31,1,1,0
53931,445,0,0,66,66,0,1,0,1,0,2
58308,445,0,0,66,66,0,1,0,1,0,2
55850,445,0,0,70,70,0,1,0,1,0,2
56625,443,59240,443,7888,1899,5989,20,15,11,9,0
45742,443,8175,443,8471,3275,5196,21,120,11,10,0
58808,80,14493,80,2295,1574,721,10,375,6,4,0
60774,40010,46436,40010,316,136,180,6,7,3,3,0
46585,443,60959,443,9439,3223,6216,27,137,13,14,0
53272,443,50136,443,5544,1703,3841,19,31,11,8,0
58891,445,0,0,70,70,0,1,0,1,0,2
59891,445,0,0,70,70,0,1,0,1,0,2
22357,6004,0,0,62,62,0,1,0,1,0,1
45132,443,57235,443,5398,3277,2121,30,80,16,14,0
54977,445,0,0,66,66,0,1,0,1,0,2
48676,53398,0,0,60,60,0,1,0,1,0,1
57654,35440,0,0,66,66,0,1,0,1,0,1
58072,445,0,0,70,70,0,1,0,1,0,2
49191,53,32868,53,186,95,91,2,31,1,1,0
50354,56205,0,0,66,66,0,1,0,1,0,1
65460,53,30831,53,197,102,95,2,30,1,1,0
64090,445,0,0,70,70,0,1,0,1,0,2
49516,53,32390,53,183,94,89,2,31,1,1,0
64056,51266,3673,51266,66,66,0,1,5,1,0,0
52015,25487,39642,25487,70,70,0,1,5,1,0,0
60029,443,40871,443,1057,590,467,11,142,6,5,0
65283,53,18469,53,732,89,643,2,30,1,1,0
51661,443,59276,443,11558,3964,7594,37,17,15,22,0
52107,11191,13712,11191,70,70,0,2,7,2,0,0
40204,40038,53758,40038,585,86,499,2,30,1,1,0
49350,80,49350,80,450,246,204,8,142,5,3,0
17101,25174,0,0,62,62,0,1,0,1,0,1
56454,445,0,0,70,70,0,1,0,1,0,2
60715,445,0,0,70,70,0,1,0,1,0,2
50293,443,61876,443,12677,3097,9580,37,26,19,18,0
31112,50584,0,0,66,66,0,1,0,1,0,1
28124,37965,0,0,145,145,0,1,0,1,0,1
56551,53,16307,53,458,188,270,6,30,3,3,0
53142,445,0,0,70,70,0,1,0,1,0,2
63550,80,63550,80,1232,481,751,10,15,5,5,0
51074,80,51074,80,168467,7348,161119,184,8,67,117,0
49380,53,10250,53,198,101,97,2,31,1,1,0
58296,445,0,0,66,66,0,1,0,1,0,2
55230,53,3013,53,183,94,89,2,30,1,1,0
53703,16426,38652,16426,70,70,0,1,4,1,0,0
61819,445,0,0,66,66,0,1,0,1,0,2
56617,80,63909,80,234,234,0,4,12,4,0,0
53874,43922,52145,43922,320,140,180,6,6,3,3,0
7701,80,7701,80,900,519,381,7,141,4,3,0
61102,445,0,0,70,70,0,1,0,1,0,2
52026,12523,4758,12523,70,70,0,1,4,1,0,0
59371,161,59371,161,2085,880,1205,10,31,5,5,0
26900,27017,39625,27017,422,164,258,6,30,3,3,0
31710,53,31710,53,233,90,143,2,32,1,1,0
64441,445,0,0,66,66,0,1,0,1,0,2
39380,46783,0,0,146,146,0,1,0,1,0,1
50699,443,40507,443,9382,3057,6325,35,1220,17,18,0
51790,46839,56676,46839,70,70,0,1,5,1,0,0
60031,443,5116,443,350,210,140,6,15,4,2,0
4788,53,4788,53,825,99,726,2,0,1,1,0
54135,445,0,0,66,66,0,1,0,1,0,2
51719,13715,5835,13715,70,70,0,2,8,2,0,0
49650,80,5839,80,318,192,126,6,41,4,2,0
50142,445,0,0,70,70,0,1,0,1,0,2
53130,10168,25089,10168,320,140,180,6,5,3,3,0
56181,53,2631,53,784,94,690,2,29,1,1,0
58325,53,35330,53,251,79,172,2,30,1,1,0
60295,445,0,0,70,70,0,1,0,1,0,2
1238,51505,0,0,62,62,0,1,0,1,0,1
60954,443,45270,443,62583,3743,58840,88,32,40,48,0
41156,53,41156,53,216,82,134,2,31,1,1,0
56464,53,12940,53,170,87,83,2,31,1,1,0
56268,44847,0,0,66,66,0,1,0,1,0,1
58638,5900,0,0,62,62,0,1,0,1,0,1
50176,443,54312,443,6081,844,5237,17,15,9,8,0
57470,24260,9692,24260,806,163,643,2,1201,1,1,0
61329,445,0,0,70,70,0,1,0,1,0,2
51492,80,15284,80,1517,481,1036,11,15,6,5,0
56434,53,6758,53,701,88,613,2,31,1,1,0
64202,53,3004,53,316,89,227,4,50,2,2,0
49879,443,31980,443,6121,1042,5079,21,53,11,10,0
6889,8970,0,0,143,143,0,1,0,1,0,3
45941,23388,0,0,60,60,0,1,0,1,0,1
26900,27017,8503,27017,422,164,258,6,29,3,3,0
63407,445,0,0,66,66,0,1,0,1,0,2
46772,80,10171,80,2068,1371,697,13,83,7,6,0
49435,53,45474,53,720,94,626,2,30,1,1,0
40512,57470,0,0,74,74,0,1,0,1,0,1
57694,445,0,0,70,70,0,1,0,1,0,2
5588,5588,0,0,3562,1936,1626,48,195,24,24,0
54302,53,4566,53,168,78,90,2,30,1,1,0
50069,53,27415,53,179,94,85,2,30,1,1,0
50958,53,30226,53,264,264,0,4,47,4,0,0
57543,445,0,0,70,70,0,1,0,1,0,2
64252,53,2072,53,199,102,97,2,30,1,1,0
53775,8999,38559,8999,320,140,180,6,5,3,3,0
51818,43942,37942,43942,258,70,188,4,8,2,2,0
51739,62163,31026,62163,70,70,0,2,8,2,0,0
53198,443,53198,443,4591,1684,2907,19,28,11,8,0
63240,445,0,0,66,66,0,1,0,1,0,2
42572,995,0,0,60,60,0,1,0,1,0,1
12318,41864,0,0,139,139,0,1,0,1,0,1
58014,443,11079,443,5528,3392,2136,31,80,16,15,0
63438,445,0,0,66,66,0,1,0,1,0,2
41974,443,41974,443,214163,29159,185004,242,20,108,134,0
50922,443,21315,443,6180,1241,4939,18,982,8,10,0
56659,53,59706,53,711,87,624,2,30,1,1,0
12668,42707,0,0,62,62,0,1,0,1,0,1
63108,443,56013,443,4609,2177,2432,11,120,6,5,0
58149,445,0,0,70,70,0,1,0,1,0,2
51479,25174,0,0,66,66,0,1,0,1,0,1
57239,161,0,0,82,82,0,1,0,1,0,1
64219,51050,0,0,66,66,0,1,0,1,0,1
26425,22114,0,0,62,62,0,1,0,1,0,1
53734,22051,14778,22051,70,70,0,1,5,1,0,0
55919,53,46329,53,177,94,83,2,31,1,1,0
58638,5900,0,0,62,62,0,1,0,1,0,1
49631,53,24676,53,184,102,82,2,30,1,1,0
57010,53,20752,53,198,101,97,2,30,1,1,0
32727,23,0,0,60,60,0,1,0,1,0,1
443,62451,0,0,199,199,0,1,0,1,0,1
57065,53,13982,53,182,102,80,2,29,1,1,0
58577,445,0,0,70,70,0,1,0,1,0,2
53274,445,0,0,70,70,0,1,0,1,0,2
54977,53,39208,53,275,93,182,4,31,2,2,0
58598,50584,0,0,66,66,0,1,0,1,0,1
14000,14914,0,0,157,157,0,1,0,1,0,1
27005,27019,52593,27019,1007,252,755,4,32,3,1,0
56582,23718,0,0,66,66,0,1,0,1,0,1
50328,22114,0,0,66,66,0,1,0,1,0,1
62896,993,54480,993,178,118,60,2,15,1,1,0
10088,37807,0,0,66,66,0,1,0,1,0,1
50280,445,0,0,66,66,0,1,0,1,0,2
49844,53,62050,53,368,118,250,2,30,1,1,0
64488,53,18852,53,291,102,189,2,29,1,1,0
51145,80,51145,80,33072,3959,29113,40,46,14,26,0
50326,80,17692,80,7979,802,7177,17,47,8,9,0
60385,59696,6029,59696,70,70,0,1,5,1,0,0
49663,53,65385,53,195,102,93,2,30,1,1,0
50654,80,39837,80,3728,1504,2224,13,21,7,6,0
51504,445,0,0,66,66,0,1,0,1,0,2
25237,57470,0,0,62,62,0,1,0,1,0,1
51823,80,56758,80,4456,1889,2567,11,39,6,5,0
56792,42155,44462,42155,70,70,0,1,5,1,0,0
35088,443,54099,443,800,452,348,12,94,7,5,0
50641,445,0,0,70,70,0,1,0,1,0,2
40099,23,0,0,60,60,0,1,0,1,0,1
55708,22094,3066,22094,564,318,246,9,15,5,4,0
38010,443,65428,443,5474,2239,3235,31,80,14,17,0
49707,53,0,0,82,82,0,1,31,1,0,0
49740,53,20655,53,793,101,692,2,31,1,1,0
49160,6881,22368,6881,490,150,340,2,1200,1,1,0
26900,27017,18355,27017,422,164,258,6,31,3,3,0
62961,445,0,0,70,70,0,1,0,1,0,2
55690,54233,5574,54233,320,140,180,6,6,3,3,0
59321,445,0,0,66,66,0,1,0,1,0,2
51676,23718,0,0,66,66,0,1,0,1,0,1
55168,53,23617,53,816,97,719,2,31,1,1,0
64935,53,54508,53,193,102,91,2,29,1,1,0
61676,443,64478,443,6353,1520,4833,20,17,12,8,0
58762,443,39294,443,318,192,126,6,25,4,2,0
53228,443,53228,443,4456,2436,2020,19,24,10,9,0
59846,443,17762,443,23856,3218,20638,40,18,16,24,0
55265,53,19057,53,740,93,647,2,31,1,1,0
20682,57470,0,0,62,62,0,1,0,1,0,1
49372,53,16928,53,210,110,100,2,30,1,1,0
1038,37965,0,0,62,62,0,1,0,1,0,1
37965,25180,40858,25180,858,858,0,14,1199,14,0,0
27005,27018,60808,27018,881,126,755,2,31,1,1,0
57094,445,0,0,66,66,0,1,0,1,0,2
60856,445,0,0,70,70,0,1,0,1,0,2
49756,53,22675,53,243,118,125,2,30,1,1,0
57448,53,10658,53,177,94,83,2,29,1,1,0
46707,443,23817,443,9723,1780,7943,35,120,17,18,0
443,56858,0,0,85,85,0,1,0,1,0,1
2874,53,2874,53,216,82,134,2,31,1,1,0
62499,443,53888,443,1332,876,456,11,26,6,5,0
56912,53,9519,53,198,101,97,2,31,1,1,0
49640,443,18216,443,8607,3608,4999,25,256,14,11,0
51142,445,0,0,70,70,0,1,0,1,0,2
40428,53,46586,53,168,78,90,2,30,1,1,0
26867,443,1450,443,11115,3034,8081,35,19,18,17,0
51098,80,4123,80,3378,1918,1460,33,131,18,15,0
57303,53,6094,53,177,94,83,2,30,1,1,0
51313,64147,0,0,66,66,0,1,0,1,0,1
57289,31573,0,0,66,66,0,1,0,1,0,1
54986,53,61995,53,214,110,104,2,30,1,1,0
50434,445,0,0,70,70,0,1,0,1,0,2
50074,53,31884,53,168,86,82,2,30,1,1,0
50367,37965,0,0,66,66,0,1,0,1,0,1
65000,445,0,0,70,70,0,1,0,1,0,2
57831,443,53060,443,1320606,47731,1272875,1454,294,552,902,0
49201,53,24647,53,243,86,157,2,30,1,1,0
62364,445,0,0,66,66,0,1,0,1,0,2
40808,53,41572,53,168,78,90,2,29,1,1,0
47918,443,24262,443,7936,2847,5089,15,120,7,8,0
50688,5222,59884,5222,402,342,60,2,15,1,1,0
60129,55442,0,0,66,66,0,1,0,1,0,1
55998,15503,0,0,146,146,0,1,0,1,0,1
36417,443,64743,443,8611,2046,6565,31,394,10,21,0
59660,445,0,0,70,70,0,1,0,1,0,2
55388,53,60267,53,170,87,83,2,31,1,1,0
57198,80,57198,80,6738,909,5829,14,20,7,7,0
26301,22114,0,0,62,62,0,1,0,1,0,1
61847,445,0,0,70,70,0,1,0,1,0,2
58439,445,0,0,66,66,0,1,0,1,0,2
49297,53,48060,53,183,94,89,2,30,1,1,0
55388,445,0,0,70,70,0,1,0,1,0,2
55352,53,47404,53,216,110,106,2,30,1,1,0
13525,51505,0,0,62,62,0,1,0,1,0,1
62791,443,22999,443,17411,8921,8490,98,291,41,57,0
59982,445,0,0,66,66,0,1,0,1,0,2
9133,80,26542,80,318,192,126,6,30,4,2,0
40547,24051,0,0,74,74,0,1,0,1,0,1
59147,445,0,0,66,66,0,1,0,1,0,2
59574,443,1442,443,2582500,86854,2495646,2678,84,986,1692,0
58906,445,0,0,70,70,0,1,0,1,0,2
57791,445,0,0,70,70,0,1,0,1,0,2
54339,23117,0,0,66,66,0,1,0,1,0,1
64089,53,43918,53,340,96,244,4,35,2,2,0
49384,53,22527,53,193,102,91,2,29,1,1,0
30039,7363,0,0,145,145,0,1,0,1,0,1
54858,445,0,0,70,70,0,1,0,1,0,2
53948,445,0,0,70,70,0,1,0,1,0,2
52121,443,41012,443,199757,7497,192260,216,45,80,136,0
42557,443,48761,443,123082,8734,114348,200,84,101,99,0
47037,80,10159,80,613,539,74,7,15,6,1,0
36881,56205,0,0,62,62,0,1,0,1,0,1
55664,53,60480,53,177,94,83,2,29,1,1,0
42895,443,18411,443,600,156,444,8,25,2,6,0
55332,53,52188,53,211,110,101,2,30,1,1,0
45304,64147,0,0,72,72,0,1,0,1,0,1
64030,445,0,0,70,70,0,1,0,1,0,2
56425,445,0,0,70,70,0,1,0,1,0,2
49199,53,34176,53,816,102,714,2,30,1,1,0
53867,60272,19562,60272,70,70,0,2,8,2,0,0
61718,445,0,0,70,70,0,1,0,1,0,2
53708,80,59470,80,2434,516,1918,12,76,6,6,0
50956,25174,0,0,146,146,0,1,0,1,0,1
57470,6881,1895,6881,528,528,0,9,1200,9,0,0
55556,53,12940,53,302,78,224,2,30,1,1,0
63328,445,0,0,70,70,0,1,0,1,0,2
64540,53,58172,53,174,89,85,2,30,1,1,0
46658,53,46658,53,216,98,118,2,30,1,1,0
49436,443,51591,443,784271,38715,745556,1017,183,465,552,0
13035,25174,0,0,146,146,0,1,0,1,0,1
31750,53,31750,53,200,90,110,2,30,1,1,0
53380,445,0,0,70,70,0,1,0,1,0,1
53486,443,39031,443,8879,2420,6459,32,255,17,15,0
56733,53,13870,53,170,87,83,2,30,1,1,0
49418,27015,38880,27015,78,78,0,1,30,1,0,0
20253,53,20253,53,404,259,145,3,33,2,1,0
36579,30188,0,0,66,66,0,1,0,1,0,1
55404,443,49426,443,70,70,0,1,5,1,0,0
1848,53,1848,53,832,106,726,2,29,1,1,0
64421,445,0,0,66,66,0,1,0,1,0,2
58046,53,58046,53,231,88,143,2,32,1,1,0
60854,443,16841,443,10447,2417,8030,26,16,15,11,0
64102,53,54377,53,619,102,517,4,43,2,2,0
55008,21247,0,0,66,66,0,1,0,1,0,1
57913,80,64220,80,6515,1210,5305,15,23,8,7,0
51007,445,0,0,70,70,0,1,0,1,0,2
36770,56205,0,0,62,62,0,1,0,1,0,1
49308,22114,0,0,62,62,0,1,0,1,0,1
50475,445,0,0,66,66,0,1,0,1,0,2
59937,37965,0,0,66,66,0,1,0,1,0,1
53971,55442,0,0,66,66,0,1,0,1,0,1
64231,445,0,0,70,70,0,1,0,1,0,2
50584,11888,51615,11888,1356,300,1056,6,1200,3,3,0
63930,443,21272,443,2940,669,2271,13,122,6,7,0
59964,443,4370,443,48525,4928,43597,111,660,55,56,0
62558,20170,0,0,145,145,0,1,0,1,0,1
7030,80,7030,80,115811,3862,111949,123,38,44,79,0
56678,443,37527,443,4099,2450,1649,36,2615,19,17,0
4760,44847,0,0,62,62,0,1,0,1,0,1
51861,53,51861,53,305,160,145,3,33,2,1,0
49509,443,14742,443,17660,7465,10195,44,201,23,21,0
58638,5900,0,0,62,62,0,1,0,1,0,1
52150,443,44913,443,5481,3086,2395,26,49,13,13,0
58936,443,15489,443,10014,6664,3350,28,17,14,14,0
49826,53,60102,53,466,192,274,6,83,3,3,0
49870,53,21637,53,188,96,92,2,31,1,1,0
56421,53,33128,53,177,94,83,2,29,1,1,0
64381,53,3642,53,198,102,96,2,30,1,1,0
50385,80,53379,80,28942,2526,26416,39,25,16,23,0
52725,445,0,0,66,66,0,1,0,1,0,2
60762,445,0,0,66,66,0,1,0,1,0,2
14914,443,14914,443,16960,1347,15613,28,17,10,18,0
49615,53,49539,53,199,102,97,2,30,1,1,0
50908,443,7886,443,124,64,60,2,15,1,1,0
37110,53,37110,53,247,98,149,2,33,1,1,0
57752,445,0,0,66,66,0,1,0,1,0,2
44558,443,44558,443,5480,2503,2977,20,15,11,9,0
58917,445,0,0,70,70,0,1,0,1,0,2
50116,22,50116,22,152,66,86,2,10,1,1,0
57987,56125,0,0,90,90,0,1,0,1,0,1
53257,443,51156,443,8715,1814,6901,26,29,15,11,0
56506,53,36137,53,227,102,125,2,30,1,1,0
55966,53,61391,53,86,86,0,1,29,1,0,0
46939,443,46939,443,4657,1750,2907,19,28,11,8,0
6881,63963,28408,63963,207,118,89,2,1200,1,1,0
54981,53,59429,53,757,102,655,2,29,1,1,0
42951,44847,0,0,66,66,0,1,0,1,0,1
49811,443,7864,443,7551,2453,5098,22,126,12,10,0
55913,53,2700,53,177,94,83,2,30,1,1,0
65263,80,27562,80,7440,4032,3408,48,629,25,23,0
56477,53,18413,53,386,101,285,4,31,2,2,0
51581,22114,0,0,66,66,0,1,0,1,0,1
58638,5900,0,0,62,62,0,1,0,1,0,1
51006,445,0,0,66,66,0,1,0,1,0,2
55032,62413,0,0,62,62,0,1,0,1,0,1
50367,443,43632,443,1630,916,714,12,25,7,5,0
50497,443,10813,443,1642025,26957,1615068,1478,17,406,1072,0
55374,25,55374,25,130,66,64,2,5,1,1,0
50045,443,64654,443,4551,2388,2163,16,120,8,8,0
1024,44847,0,0,62,62,0,1,0,1,0,1
64244,53,63345,53,199,102,97,2,31,1,1,0
58638,5900,0,0,62,62,0,1,0,1,0,1
49242,53,38872,53,167,86,81,2,29,1,1,0
49986,443,61933,443,25918,2247,23671,53,124,26,27,0
54267,53,33061,53,86,86,0,1,30,1,0,0
55605,53,24748,53,195,102,93,2,29,1,1,0
2531,30188,0,0,66,66,0,1,0,1,0,1
49585,53,59933,53,718,94,624,2,30,1,1,0
54488,445,0,0,70,70,0,1,0,1,0,2
55806,80,55806,80,424,198,226,7,142,4,3,0
52155,63867,51864,63867,70,70,0,2,7,2,0,0
50535,80,27169,80,36985,3992,32993,56,151,25,31,0
62849,62413,0,0,66,66,0,1,0,1,0,1
55902,53,8610,53,181,94,87,2,31,1,1,0
57026,445,0,0,70,70,0,1,0,1,0,2
51152,443,11725,443,44048,4441,39607,97,317,43,54,0
45780,443,35080,443,7847,1591,6256,23,186,13,10,0
64567,443,55637,443,272081,11032,261049,304,139,107,197,0
48744,443,35880,443,2098,1239,859,22,20,12,10,0
55083,53,43737,53,751,95,656,2,30,1,1,0
52923,443,55900,443,5581,1388,4193,19,15,9,10,0
50584,61867,27152,61867,166,166,0,1,1200,1,0,0
58887,15000,7750,15000,138,78,60,2,6,1,1,0
62840,445,0,0,70,70,0,1,0,1,0,2
68,67,0,0,346,346,0,1,0,1,0,1
57016,445,0,0,66,66,0,1,0,1,0,2
7524,23,0,0,60,60,0,1,0,1,0,1
49971,445,0,0,66,66,0,1,0,1,0,2
65106,53,60145,53,438,180,258,6,30,3,3,0
1663,30188,0,0,66,66,0,1,0,1,0,1
52214,27480,12479,27480,70,70,0,2,6,2,0,0
33856,443,15583,443,7298,2661,4637,21,21,11,10,0
38274,443,9313,443,600,156,444,8,25,2,6,0
5223,1210,0,0,103,103,0,1,0,1,0,1
42867,443,28433,443,15769,1619,14150,17,137,4,13,0
65143,53,22648,53,822,102,720,2,29,1,1,0
49456,445,0,0,66,66,0,1,0,1,0,2
6666,62078,0,0,60,60,0,1,0,1,0,1
51447,443,8869,443,202,70,132,3,11,1,2,0
52218,445,0,0,70,70,0,1,0,1,0,2
49402,53,18505,53,214,110,104,2,30,1,1,0
56929,53,55156,53,784,94,690,2,30,1,1,0
64460,53,62568,53,192,98,94,2,31,1,1,0
7968,2767,0,0,62,62,0,1,0,1,0,1
59481,41182,0,0,62,62,0,1,0,1,0,1
9291,80,9291,80,208056,7568,200488,227,39,88,139,0
52588,443,7205,443,3523,518,3005,12,15,6,6,0
56727,443,57540,443,7889,1900,5989,20,14,11,9,0
56913,53,30099,53,772,103,669,2,31,1,1,0
50964,445,0,0,70,70,0,1,0,1,0,2
50308,443,46748,443,44311,4535,39776,55,121,21,34,0
64366,53,57312,53,234,94,140,2,30,1,1,0
49591,80,27431,80,314,128,186,6,27,3,3,0
34247,48817,0,0,145,145,0,1,0,1,0,1
50222,443,25494,443,178347,31093,147254,290,446,140,150,0
35568,443,33534,443,5383,3710,1673,27,309,14,13,0
49355,53,16925,53,186,95,91,2,0,1,1,0
57382,53,16095,53,184,94,90,2,31,1,1,0
64886,445,0,0,70,70,0,1,0,1,0,2
56649,53,35726,53,152,78,74,2,30,1,1,0
49418,27017,57316,27017,262,78,184,2,30,1,1,0
53160,25174,0,0,62,62,0,1,0,1,0,1
50684,445,0,0,70,70,0,1,0,1,0,2
27005,27016,56293,27016,1640,126,1514,4,31,2,2,0
64592,443,64064,443,24682,1935,22747,36,17,17,19,0
64614,53,3783,53,168,86,82,2,30,1,1,0
65142,53,52457,53,167,86,81,2,30,1,1,0
52002,34348,46608,34348,66,66,0,1,5,1,0,0
49415,443,33045,443,29561,4857,24704,44,44,15,29,0
55631,16191,24420,16191,504,318,186,8,16,5,3,0
55726,32463,19971,32463,70,70,0,1,5,1,0,0
58079,445,0,0,66,66,0,1,0,1,0,2
53857,443,11803,443,499,425,74,4,1,3,1,0
49890,443,37248,443,9545,2433,7112,24,142,10,14,0
56928,53,10586,53,178,94,84,2,30,1,1,0
55640,53,50783,53,742,88,654,2,31,1,1,0
22036,44847,0,0,62,62,0,1,0,1,0,1
63095,445,0,0,70,70,0,1,0,1,0,2
59213,25174,0,0,66,66,0,1,0,1,0,1
49539,443,38043,443,5106,1861,3245,21,143,10,11,0
42108,23,0,0,60,60,0,1,0,1,0,1
49519,443,20384,443,7086,1913,5173,29,270,16,13,0
56543,443,26469,443,245527,10641,234886,322,405,136,186,0
7655,23,0,0,60,60,0,1,0,1,0,1
60353,80,51111,80,1679,1269,410,8,15,5,3,0
55166,53,19784,53,177,94,83,2,30,1,1,0
19570,50584,0,0,66,66,0,1,0,1,0,1
31780,11392,0,0,62,62,0,1,0,1,0,1
56803,53,20372,53,195,102,93,2,31,1,1,0
6881,50321,40130,50321,238,118,120,2,1199,1,1,0
55973,53,5208,53,939,678,261,2,30,1,1,0
54899,445,0,0,70,70,0,1,0,1,0,2
54118,6004,0,0,66,66,0,1,0,1,0,1
61018,443,61018,443,4400,1493,2907,19,29,11,8,0
27005,27015,61856,27015,888,126,762,2,30,1,1,0
49245,53,3951,53,190,97,93,2,31,1,1,0
49416,53,16616,53,185,102,83,2,30,1,1,0
53839,15000,61295,15000,130,70,60,2,5,1,1,0
62109,443,64847,443,21219,1329,19890,32,122,13,19,0
62571,445,0,0,66,66,0,1,0,1,0,2
56088,53,23327,53,256,93,163,2,31,1,1,0
58840,443,27383,443,5108,700,4408,15,15,7,8,0
49986,443,64470,443,11626,1206,10420,31,74,13,18,0
62213,445,0,0,70,70,0,1,0,1,0,2
1036,64147,0,0,62,62,0,1,0,1,0,1
56812,443,34534,443,8073,2053,6020,20,15,11,9,0
57941,445,0,0,66,66,0,1,0,1,0,2
64161,53,62669,53,261,102,159,2,30,1,1,0
61945,48817,0,0,62,62,0,1,0,1,0,1
55889,53,65516,53,168,86,82,2,30,1,1,0
54364,445,0,0,70,70,0,1,0,1,0,2
12128,37965,0,0,62,62,0,1,0,1,0,1
49204,54530,41547,54530,316,136,180,6,6,3,3,0
60030,443,28456,443,711172,27430,683742,812,104,342,470,0
55642,53,4187,53,711,87,624,2,30,1,1,0
23537,35253,0,0,66,66,0,1,0,1,0,1
53469,445,0,0,70,70,0,1,0,1,0,2
49972,53,25100,53,328,110,218,4,57,2,2,0
61616,23,0,0,60,60,0,1,0,1,0,1
46991,53,46991,53,262,106,156,2,31,1,1,0
50584,51413,16088,51413,475,150,325,2,1200,1,1,0
50153,80,50079,80,41846,1261,40585,45,75,13,32,0
58638,5900,58638,5900,62,62,0,1,5,1,0,0
64677,53,6467,53,195,102,93,2,30,1,1,0
36368,80,58408,80,78,78,0,1,5,1,0,0
50127,64147,0,0,66,66,0,1,0,1,0,1
49257,445,0,0,70,70,0,1,0,1,0,2
9482,443,2770,443,5657,487,5170,14,15,7,7,0
57236,53733,0,0,66,66,0,1,0,1,0,1
55221,443,37010,443,12954,2333,10621,20,120,9,11,0
56559,53,54013,53,177,94,83,2,30,1,1,0
55368,53,50855,53,760,97,663,2,31,1,1,0
55013,53,33517,53,821,102,719,2,30,1,1,0
55056,53,20306,53,209,110,99,2,30,1,1,0
64602,53,26542,53,185,102,83,2,30,1,1,0
65437,53,48894,53,1386,85,1301,4,53,2,2,0
64361,53,3934,53,194,94,100,2,30,1,1,0
59734,445,0,0,70,70,0,1,0,1,0,2
53776,445,0,0,70,70,0,1,0,1,0,2
49891,53,31414,53,243,94,149,2,30,1,1,0
65204,53,43316,53,183,94,89,2,30,1,1,0
53500,1,0,0,66,66,0,1,0,1,0,1
2828,35253,0,0,66,66,0,1,0,1,0,1
65449,53,65266,53,507,193,314,6,57,3,3,0
11983,57470,0,0,62,62,0,1,0,1,0,1
64587,53,63035,53,167,86,81,2,30,1,1,0
36838,443,43654,443,9381,1457,7924,21,31,11,10,0
57258,53,33746,53,215,102,113,2,30,1,1,0
12709,51505,0,0,62,62,0,1,0,1,0,1
63915,445,0,0,70,70,0,1,0,1,0,2
63569,62413,0,0,66,66,0,1,0,1,0,1
51356,22114,0,0,66,66,0,1,0,1,0,1
51283,80,60981,80,1114,534,580,12,16,7,5,0
53952,26973,7961,26973,70,70,0,1,4,1,0,0
49155,443,35211,443,8941,1776,7165,22,136,12,10,0
60386,80,35408,80,214,140,74,4,15,3,1,0
9687,57470,0,0,78,78,0,1,0,1,0,1
44912,80,52893,80,1602,1282,320,10,15,5,5,0
61406,443,11878,443,12588,4915,7673,28,94,15,13,0
19610,9571,0,0,62,62,0,1,0,1,0,1
52533,53,8262,53,242,78,164,2,30,1,1,0
50561,80,50561,80,1695,995,700,11,21,6,5,0
64678,445,0,0,66,66,0,1,0,1,0,2
51163,443,48007,443,9466,2602,6864,41,185,20,21,0
57471,62413,0,0,62,62,0,1,0,1,0,1
27005,32065,28721,32065,877,126,751,2,31,1,1,0
27005,27015,32214,27015,878,126,752,2,30,1,1,0
65460,53,42143,53,194,99,95,2,31,1,1,0
59617,445,0,0,66,66,0,1,0,1,0,2
50573,22114,0,0,62,62,0,1,0,1,0,1
3270,35440,0,0,66,66,0,1,0,1,0,1
42384,443,3442,443,101952,6925,95027,143,333,72,71,0
49788,1433,0,0,60,60,0,1,0,1,0,1
65189,27241,23433,27241,235,71,164,2,31,1,1,0
57134,53,30351,53,190,97,93,2,30,1,1,0
55422,445,0,0,70,70,0,1,0,1,0,2
52181,1038,23058,1038,70,70,0,2,8,2,0,0
35615,443,10957,443,6179,1242,4937,22,42,11,11,0
49871,443,47130,443,615040,25597,589443,704,54,245,459,0
65452,53,31972,53,365,102,263,2,30,1,1,0
62386,37965,0,0,62,62,0,1,0,1,0,1
35112,8635,35112,8635,138,78,60,2,5,1,1,0
64070,53,45355,53,337,89,248,4,38,2,2,0
57757,445,0,0,70,70,0,1,0,1,0,2
443,45940,0,0,85,85,0,1,0,1,0,1
56367,445,0,0,70,70,0,1,0,1,0,2
64724,53,45753,53,336,110,226,2,30,1,1,0
60384,64147,0,0,62,62,0,1,0,1,0,1
61516,445,0,0,66,66,0,1,0,1,0,2
56314,53,22045,53,183,94,89,2,30,1,1,0
59874,22114,0,0,66,66,0,1,0,1,0,1
56237,26467,0,0,66,66,0,1,0,1,0,1
27005,27025,22813,27025,887,126,761,2,31,1,1,0
52007,37732,20807,37732,70,70,0,1,4,1,0,0
54444,443,57397,443,9802,2594,7208,25,360,10,15,0
37000,443,57961,443,280,140,140,5,130,3,2,0
53527,445,0,0,70,70,0,1,0,1,0,2
42385,443,44650,443,26481,1832,24649,40,330,18,22,0
2073,7000,2073,7000,3566,1999,1567,16,15,8,8,0
62055,443,14508,443,11694,4947,6747,34,48,19,15,0
15503,48319,24114,48319,481,150,331,2,1199,1,1,0
52001,12514,64945,12514,70,70,0,2,7,2,0,0
21759,51505,0,0,66,66,0,1,0,1,0,1
63701,46824,0,0,66,66,0,1,0,1,0,1
50105,53,29739,53,969,86,883,2,30,1,1,0
19594,23117,0,0,66,66,0,1,0,1,0,1
49830,443,7649,443,6131,1960,4171,18,15,10,8,0
37710,443,47259,443,13986,9199,4787,59,94,24,35,0
55826,53,30050,53,86,86,0,1,31,1,0,0
49898,53,38099,53,184,94,90,2,31,1,1,0
50265,13302,54682,13302,2118,858,1260,28,1267,14,14,0
6666,44818,0,0,60,60,0,1,0,1,0,1
49418,27015,33694,27015,246,78,168,2,31,1,1,0
64723,53,29424,53,165,86,79,2,31,1,1,0
21542,57470,0,0,74,74,0,1,0,1,0,1
56062,53,55511,53,196,102,94,2,30,1,1,0
37907,443,63465,443,9227,2999,6228,64,616,35,29,0
58638,5900,0,0,62,62,0,1,0,1,0,1
22636,30188,0,0,66,66,0,1,0,1,0,1
40811,80,13530,80,31286,2032,29254,50,30,26,24,0
63567,445,0,0,70,70,0,1,0,1,0,2
56297,445,0,0,70,70,0,1,0,1,0,2
52112,22114,0,0,66,66,0,1,0,1,0,1
56919,445,0,0,66,66,0,1,0,1,0,2
63578,35440,0,0,66,66,0,1,0,1,0,1
22539,53,19206,53,86,86,0,1,30,1,0,0
27005,27015,31216,27015,939,126,813,2,30,1,1,0
64326,445,0,0,70,70,0,1,0,1,0,2
53724,64923,63918,64923,70,70,0,1,5,1,0,0
49324,445,0,0,70,70,0,1,0,1,0,2
33070,80,34842,80,3483,1578,1905,17,186,10,7,0
51072,445,0,0,70,70,0,1,0,1,0,2
49960,445,0,0,70,70,0,1,0,1,0,2
1446,35440,0,0,62,62,0,1,0,1,0,1
9524,443,1427,443,1313,876,437,11,26,6,5,0
443,60746,0,0,60,60,0,1,90,1,0,0
53662,443,56042,443,7471,2800,4671,21,76,13,8,0
52169,80,44471,80,362,240,122,7,17,5,2,0
27055,25174,0,0,62,62,0,1,0,1,0,1
54966,53,59029,53,255,88,167,4,32,2,2,0
49260,80,56058,80,2013987,64000,1949987,1818,160,504,1314,0
54975,445,0,0,70,70,0,1,0,1,0,2
2267,53,42129,53,204,118,86,2,31,1,1,0
55718,445,0,0,70,70,0,1,0,1,0,2
28085,36237,0,0,66,66,0,1,0,1,0,1
50949,445,0,0,70,70,0,1,0,1,0,2
31410,25174,0,0,146,146,0,1,0,1,0,1
443,1785,0,0,97,97,0,1,0,1,0,1
44014,53,29782,53,199,94,105,2,30,1,1,0
54874,445,0,0,70,70,0,1,0,1,0,2
53871,37965,0,0,66,66,0,1,0,1,0,1
20844,64147,0,0,66,66,0,1,0,1,0,1
63852,35440,0,0,66,66,0,1,0,1,0,1
20198,17372,0,0,62,62,0,1,0,1,0,1
49160,46824,0,0,146,146,0,1,0,1,0,1
49502,445,0,0,70,70,0,1,0,1,0,2
59196,34962,0,0,148,148,0,1,0,1,0,1
6881,9074,0,0,143,143,0,1,0,1,0,1
57413,445,0,0,66,66,0,1,0,1,0,2
64707,445,0,0,70,70,0,1,0,1,0,2
56679,51505,0,0,62,62,0,1,0,1,0,1
41959,443,65186,443,5838,1840,3998,20,80,12,8,0
57282,53,23204,53,199,102,97,2,29,1,1,0
15105,25174,0,0,146,146,0,1,0,1,0,1
5462,21247,0,0,66,66,0,1,0,1,0,1
12794,35440,0,0,146,146,0,1,0,1,0,1
42298,40013,38063,40013,209,87,122,4,29,2,2,0
57287,53,44650,53,752,93,659,2,30,1,1,0
51221,51413,20920,51413,459,149,310,2,1200,1,1,0
64583,53,34573,53,179,94,85,2,30,1,1,0
26092,23,0,0,60,60,0,1,0,1,0,1
3478,61463,0,0,159,159,0,1,0,1,0,1
56747,80,7383,80,194,128,66,4,25,3,1,0
55674,53,14625,53,744,89,655,2,31,1,1,0
60499,51413,3005,51413,70,70,0,2,8,2,0,0
49436,53,61599,53,718,94,624,2,30,1,1,0
39223,80,40485,80,1052,612,440,10,15,5,5,0
51775,57887,37993,57887,66,66,0,1,5,1,0,0
52393,445,0,0,66,66,0,1,0,1,0,2
55840,53,9224,53,170,87,83,2,30,1,1,0
61461,443,31107,443,9073,2899,6174,36,94,19,17,0
51002,443,58115,443,3536,2198,1338,18,332,9,9,0
51843,45702,23719,45702,1261,637,624,9,30,5,4,0
64877,53,24917,53,182,93,89,2,31,1,1,0
56424,53,21857,53,177,94,83,2,30,1,1,0
16689,53,15770,53,199,94,105,2,30,1,1,0
55078,53,15054,53,246,94,152,2,30,1,1,0
63486,445,0,0,70,70,0,1,0,1,0,2
50584,61467,32483,61467,1377,300,1077,6,1200,3,3,0
62051,11392,0,0,62,62,0,1,0,1,0,1
59778,443,59778,443,4580,1673,2907,19,28,11,8,0
54080,443,47688,443,1173681,52597,1121084,1428,177,642,786,0
37737,443,61948,443,190013,14784,175229,238,206,101,137,0
49929,53,53934,53,214,110,104,2,30,1,1,0
64586,80,64586,80,123115,6863,116252,160,29,76,84,0
51221,31285,26575,31285,2274,924,1350,30,3293,15,15,0
9421,443,1496,443,5699,505,5194,14,15,7,7,0
56375,445,0,0,66,66,0,1,0,1,0,2
55951,53,4112,53,197,102,95,2,30,1,1,0
52068,80,54676,80,362,240,122,7,25,5,2,0
65189,27015,42181,27015,262,78,184,2,29,1,1,0
53707,443,35476,443,350,210,140,6,25,4,2,0
51645,80,57006,80,318,192,126,6,38,4,2,0
5859,11392,0,0,66,66,0,1,0,1,0,1
65316,445,0,0,70,70,0,1,0,1,0,2
50707,53,59770,53,181,86,95,2,30,1,1,0
50542,445,0,0,66,66,0,1,0,1,0,2
9234,80,38036,80,318,192,126,6,26,4,2,0
58940,443,24448,443,5108,700,4408,15,15,7,8,0
57432,53,57432,53,247,98,149,2,34,1,1,0
55233,443,14491,443,10226,3230,6996,28,47,16,12,0
56037,53,56792,53,168,94,74,2,29,1,1,0
60470,51413,5081,51413,741,435,306,10,16,5,5,0
65194,53,62268,53,298,102,196,2,29,1,1,0
55248,67,0,0,60,60,0,1,0,1,0,1
57470,47099,22688,47099,330,330,0,6,1199,6,0,0
46669,80,58799,80,1802,1488,314,11,16,6,5,0
63344,53,0,0,73,73,0,1,0,1,0,1
51045,25174,0,0,66,66,0,1,0,1,0,1
36851,53,52640,53,404,261,143,3,30,2,1,0
56141,53,30553,53,184,94,90,2,30,1,1,0
48728,443,2946,443,2437,1321,1116,15,83,9,6,0
42307,443,58231,443,101673,5966,95707,121,178,47,74,0
43680,53,64871,53,271,102,169,2,30,1,1,0
59449,445,0,0,70,70,0,1,0,1,0,2
50586,443,6357,443,2756,1594,1162,20,27,11,9,0
62288,445,0,0,66,66,0,1,0,1,0,2
5222,7493,0,0,66,66,0,1,0,1,0,1
56561,53,57177,53,183,94,89,2,30,1,1,0
55005,53,64520,53,183,94,89,2,30,1,1,0
53565,445,0,0,66,66,0,1,0,1,0,2
61692,445,0,0,70,70,0,1,0,1,0,2
56523,445,0,0,66,66,0,1,0,1,0,2
3980,63710,0,0,62,62,0,1,0,1,0,1
42936,53,47625,53,199,94,105,2,30,1,1,0
42298,40007,10253,40007,273,73,200,4,29,2,2,0
62799,25174,0,0,146,146,0,1,0,1,0,1
39796,443,27327,443,7425,2276,5149,24,16,12,12,0
49808,53,25125,53,268,102,166,2,29,1,1,0
56019,53,28168,53,194,102,92,2,31,1,1,0
56785,53,64900,53,186,95,91,2,31,1,1,0
64898,53,46183,53,209,94,115,2,29,1,1,0
55462,53,13103,53,188,96,92,2,30,1,1,0
53527,5228,55667,5228,9674,1776,7898,29,3764,11,18,0
38568,53,38568,53,247,98,149,2,33,1,1,0
49523,80,32458,80,1399,826,573,11,38,6,5,0
38085,443,1147,443,78,78,0,1,5,1,0,0
52182,443,4685,443,237151,13019,224132,251,42,90,161,0
57090,53,28237,53,198,102,96,2,30,1,1,0
42034,28189,0,0,62,62,0,1,0,1,0,1
53833,26467,0,0,62,62,0,1,0,1,0,1
51126,445,0,0,70,70,0,1,0,1,0,2
57131,35776,0,0,145,145,0,1,0,1,0,1
53815,44847,0,0,66,66,0,1,0,1,0,1
51511,443,55401,443,213140,10321,202819,260,33,108,152,0
27005,27017,10039,27017,891,126,765,2,30,1,1,0
64687,53,30992,53,495,109,386,4,53,2,2,0
50471,80,51148,80,1658,1247,411,8,15,5,3,0
56913,53,31255,53,193,102,91,2,29,1,1,0
61544,53,18551,53,325,86,239,2,30,1,1,0
55877,6380,28997,6380,149,149,0,2,1200,2,0,0
49692,53,19952,53,208,106,102,2,30,1,1,0
46593,28678,34181,28678,1806,1806,0,22,224,22,0,0
56678,53,61385,53,760,97,663,2,30,1,1,0
61738,2767,0,0,66,66,0,1,0,1,0,1
49514,53,50895,53,780,93,687,2,30,1,1,0
56505,445,0,0,70,70,0,1,0,1,0,2
59703,445,0,0,70,70,0,1,0,1,0,2
54703,53,49581,53,168,78,90,2,30,1,1,0
64967,445,0,0,70,70,0,1,0,1,0,2
58768,17,58768,17,66,66,0,1,30,1,0,0
49839,445,0,0,70,70,0,1,0,1,0,1
65430,80,47649,80,306,180,126,6,29,4,2,0
59844,445,0,0,70,70,0,1,0,1,0,2
56695,443,49657,443,3874,2523,1351,18,17,10,8,0
45654,67,0,0,60,60,0,1,0,1,0,1
50748,445,0,0,70,70,0,1,0,1,0,2
63694,445,0,0,66,66,0,1,0,1,0,2
63813,445,0,0,70,70,0,1,0,1,0,2
60351,50584,0,0,66,66,0,1,0,1,0,1
64534,53,37006,53,214,110,104,2,30,1,1,0
10639,11392,0,0,62,62,0,1,0,1,0,1
49418,33098,30068,33098,78,78,0,1,30,1,0,0
58766,443,24380,443,6031,770,5261,18,15,8,10,0
29682,44847,0,0,62,62,0,1,0,1,0,1
56860,49991,48987,49991,70,70,0,1,5,1,0,0
59286,445,0,0,70,70,0,1,0,1,0,2
60049,445,0,0,66,66,0,1,0,1,0,2
61711,445,0,0,70,70,0,1,0,1,0,2
60768,40010,23273,40010,316,136,180,6,7,3,3,0
55057,53,28179,53,889,404,485,10,30,5,5,0
44320,443,12809,443,7244,1861,5383,26,330,14,12,0
55934,53,48489,53,196,102,94,2,30,1,1,0
49194,443,50497,443,159850,5338,154512,179,200,64,115,0
62080,54532,0,0,60,60,0,1,0,1,0,1
10144,62609,0,0,148,148,0,1,0,1,0,1
51970,443,63530,443,17072,6138,10934,33,85,18,15,0
55655,53,48004,53,304,110,194,4,35,2,2,0
61315,48817,0,0,62,62,0,1,0,1,0,1
49935,53,45170,53,168,86,82,2,30,1,1,0
64494,443,46008,443,2872,717,2155,14,135,6,8,0
51757,54657,24157,54657,66,66,0,1,5,1,0,0
58638,5900,58638,5900,66,66,0,1,4,1,0,0
65516,443,35348,443,451899,13130,438769,463,16,162,301,0
55894,53,40691,53,216,102,114,2,30,1,1,0
42298,40012,32444,40012,148,86,62,2,29,1,1,0
61985,445,0,0,70,70,0,1,0,1,0,2
52178,445,0,0,70,70,0,1,0,1,0,2
18085,26467,0,0,66,66,0,1,0,1,0,1
51675,443,51675,443,4539,1632,2907,19,27,11,8,0
53817,445,0,0,70,70,0,1,0,1,0,2
53791,53,19031,53,102,102,0,1,30,1,0,0
61385,80,34601,80,30257,2427,27830,45,255,22,23,0
56857,53,15955,53,195,102,93,2,30,1,1,0
33288,53,0,0,86,86,0,1,30,1,0,0
58638,5900,0,0,62,62,0,1,0,1,0,1
2837,25174,0,0,62,62,0,1,0,1,0,1
50188,80,44459,80,1746,780,966,19,56,7,12,0
47495,443,53611,443,490,210,280,8,28,4,4,0
64986,445,0,0,70,70,0,1,0,1,0,2
49231,445,0,0,70,70,0,1,0,1,0,2
50663,445,0,0,70,70,0,1,0,1,0,2
36536,53,36536,53,414,268,146,3,32,2,1,0
51617,15000,54264,15000,130,70,60,2,5,1,1,0
1143,25174,0,0,62,62,0,1,0,1,0,1
26921,57470,0,0,62,62,0,1,0,1,0,1
57813,443,65376,443,6163,925,5238,18,109,10,8,0
64507,53,28479,53,382,102,280,2,29,1,1,0
51221,40624,20030,40624,594,594,0,10,1200,10,0,0
65248,53,20664,53,208,106,102,2,30,1,1,0
9150,443,24673,443,16023,3677,12346,42,37,21,21,0
65346,53,19469,53,183,94,89,2,30,1,1,0
56922,53,64459,53,168,86,82,2,30,1,1,0
54134,64147,0,0,66,66,0,1,0,1,0,1
6889,25975,0,0,143,143,0,1,0,1,0,1
51835,443,19929,443,48635,5346,43289,83,151,38,45,0
61000,15503,0,0,146,146,0,1,0,1,0,1
6881,6881,48136,6881,238,118,120,2,1200,1,1,0
56005,64147,0,0,62,62,0,1,0,1,0,1
4760,44847,0,0,62,62,0,1,0,1,0,1
54305,26467,0,0,66,66,0,1,0,1,0,1
51954,57470,0,0,66,66,0,1,0,1,0,1
45624,443,55280,443,6697,1606,5091,23,17,13,10,0
16570,25174,0,0,62,62,0,1,0,1,0,1
18837,53,18837,53,233,90,143,2,32,1,1,0
59696,57470,0,0,62,62,0,1,0,1,0,1
63404,445,0,0,66,66,0,1,0,1,0,2
31404,36841,0,0,100,100,0,1,0,1,0,1
62344,445,0,0,66,66,0,1,0,1,0,2
49337,53,52249,53,199,102,97,2,30,1,1,0
55049,443,34090,443,13661,4451,9210,32,46,18,14,0
56665,80,42041,80,234,234,0,4,12,4,0,0
57353,443,32586,443,150,150,0,1,5,1,0,0
56366,53,46809,53,754,94,660,2,31,1,1,0
63390,445,0,0,70,70,0,1,0,1,0,2
22220,25174,0,0,146,146,0,1,0,1,0,1
65212,53,45804,53,196,102,94,2,30,1,1,0
62071,22114,0,0,62,62,0,1,0,1,0,1
9463,443,40374,443,8952,5576,3376,35,38,21,14,0
50518,445,0,0,70,70,0,1,0,1,0,2
59394,445,0,0,70,70,0,1,0,1,0,2
58759,445,0,0,70,70,0,1,0,1,0,2
57379,443,26122,443,7211,823,6388,16,15,10,6,0
64191,53,1179,53,212,102,110,2,30,1,1,0
52941,443,58388,443,14630,5941,8689,52,115,26,26,0
27005,27017,51500,27017,901,126,775,2,30,1,1,0
9262,80,26310,80,378,192,186,7,26,4,3,0
49399,80,18487,80,4382,2084,2298,18,66,10,8,0
53481,445,0,0,70,70,0,1,0,1,0,2
55365,53,47603,53,184,94,90,2,31,1,1,0
52339,26467,0,0,66,66,0,1,0,1,0,1
56611,443,65034,443,1473,868,605,10,25,6,4,0
64406,25174,0,0,66,66,0,1,0,1,0,1
54446,443,54881,443,2782,1778,1004,20,33,10,10,0
53663,80,16666,80,149148,7515,141633,197,20,95,102,0
443,48346,0,0,81,81,0,1,0,1,0,1
56793,53,12485,53,196,102,94,2,30,1,1,0
56587,445,0,0,70,70,0,1,0,1,0,2
49701,53,55177,53,197,102,95,2,30,1,1,0
48634,443,39947,443,448,78,370,6,25,1,5,0
33931,50584,0,0,62,62,0,1,0,1,0,1
53614,8999,9856,8999,928,541,387,8,17,5,3,0
53481,443,12218,443,5913,4482,1431,30,30,20,10,0
55634,58846,20945,58846,70,70,0,1,5,1,0,0
55211,445,0,0,66,66,0,1,0,1,0,2
51120,53,11316,53,168,78,90,2,30,1,1,0
2745,53,2745,53,244,98,146,2,32,1,1,0
62586,445,0,0,70,70,0,1,0,1,0,2
65487,53,62751,53,204,104,100,2,31,1,1,0
57447,443,62052,443,7847,1377,6470,27,15,12,15,0
64888,53,40321,53,767,102,665,2,30,1,1,0
57470,43323,55435,43323,2292,332,1960,11,1200,5,6,0
50584,54157,4800,54157,1377,300,1077,6,1200,3,3,0
56754,53,26868,53,182,93,89,2,31,1,1,0
52663,443,53022,443,4416,1702,2714,19,126,9,10,0
42044,60043,0,0,62,62,0,1,0,1,0,1
49750,443,8728,443,7370,1474,5896,19,128,10,9,0
27005,27015,28808,27015,873,126,747,2,30,1,1,0
56903,53,50850,53,232,94,138,2,30,1,1,0
48368,443,5888,443,9157,3805,5352,39,100,18,21,0
55076,53,44619,53,760,97,663,2,30,1,1,0
51771,19103,1964,19103,70,70,0,1,5,1,0,0
50652,80,2519,80,97934,5018,92916,124,20,55,69,0
37384,443,22279,443,416,210,206,7,29,4,3,0
63280,445,0,0,70,70,0,1,0,1,0,2
53644,445,0,0,70,70,0,1,0,1,0,2
47461,50584,0,0,62,62,0,1,0,1,0,1
64575,53,7510,53,182,102,80,2,30,1,1,0
49476,53,2698,53,200,94,106,2,30,1,1,0
56987,445,0,0,70,70,0,1,0,1,0,2
50064,443,49945,443,4118,2209,1909,36,239,21,15,0
59218,445,0,0,70,70,0,1,0,1,0,2
53646,445,0,0,70,70,0,1,0,1,0,2
1903,43890,0,0,62,62,0,1,0,1,0,1
51803,33973,32167,33973,66,66,0,1,5,1,0,0
55045,443,7851,443,4660,3048,1612,31,81,15,16,0
49907,445,0,0,70,70,0,1,0,1,0,2
51971,80,13099,80,60753,2612,58141,76,46,34,42,0
56523,443,56096,443,28479,3138,25341,42,42,17,25,0
53198,443,2334,443,1462,965,497,13,18,7,6,0
48020,443,61756,443,33481,5635,27846,73,287,32,41,0
46370,443,36990,443,11035,8438,2597,39,95,23,16,0
56218,43890,0,0,62,62,0,1,0,1,0,1
56713,25174,0,0,62,62,0,1,0,1,0,1
55940,53,33630,53,742,88,654,2,30,1,1,0
14309,56205,0,0,62,62,0,1,0,1,0,1
9335,443,4512,443,674,128,546,12,45,3,9,0
56379,53,59317,53,166,86,80,2,30,1,1,0
65011,53,38944,53,182,93,89,2,30,1,1,0
61488,445,0,0,70,70,0,1,0,1,0,2
50354,443,29554,443,1786,172,1614,7,120,3,4,0
55423,53,61643,53,711,87,624,2,31,1,1,0
65185,27126,57830,27126,268,78,190,2,30,1,1,0
59128,44847,0,0,62,62,0,1,0,1,0,1
56858,445,0,0,70,70,0,1,0,1,0,2
49632,443,26348,443,3618,961,2657,13,121,6,7,0
64557,445,0,0,70,70,0,1,0,1,0,2
10248,21247,0,0,146,146,0,1,0,1,0,1
53678,443,40421,443,6697,1606,5091,23,24,13,10,0
56171,445,0,0,70,70,0,1,0,1,0,2
49768,80,40790,80,254,128,126,5,15,3,2,0
58638,5900,0,0,62,62,0,1,0,1,0,1
49300,443,26110,443,8282,3240,5042,40,255,20,20,0
65424,53,39053,53,210,110,100,2,31,1,1,0
12364,80,12364,80,7282,653,6629,16,16,8,8,0
58226,52848,0,0,62,62,0,1,0,1,0,1
51830,80,53910,80,486,300,186,9,31,6,3,0
53459,443,23457,443,88210,4564,83646,115,46,50,65,0
63782,6969,48433,6969,70,70,0,1,5,1,0,0
65059,53,30320,53,168,86,82,2,31,1,1,0
44791,443,29863,443,3181,1647,1534,18,31,10,8,0
56106,53,18399,53,193,102,91,2,30,1,1,0
56629,80,58427,80,234,234,0,4,12,4,0,0
56541,53,2371,53,294,142,152,2,30,1,1,0
1054,15503,0,0,62,62,0,1,0,1,0,1
63718,80,18056,80,314,192,122,6,15,4,2,0
56750,80,10595,80,194,128,66,4,25,3,1,0
50321,48817,0,0,143,143,0,1,0,1,0,1
25179,62609,0,0,148,148,0,1,0,1,0,1
49920,445,0,0,70,70,0,1,0,1,0,2
60706,443,17990,443,4974,836,4138,16,40,8,8,0
60376,58302,44068,58302,624,318,306,10,15,5,5,0
50,64147,0,0,62,62,0,1,0,1,0,1
2075,19473,0,0,62,62,0,1,0,1,0,1
49857,53,15096,53,173,94,79,2,30,1,1,0
49761,80,49761,80,2937,703,2234,13,142,6,7,0
56317,53,56317,53,216,82,134,2,32,1,1,0
50072,443,58353,443,827,484,343,8,15,5,3,0
59060,50584,0,0,62,62,0,1,0,1,0,1
33651,36237,0,0,62,62,0,1,0,1,0,1
60818,37965,0,0,66,66,0,1,0,1,0,1
56719,37807,0,0,66,66,0,1,0,1,0,1
33399,443,27816,443,3603,2013,1590,21,42,12,9,0
52676,53733,0,0,62,62,0,1,0,1,0,1
60408,443,33443,443,7282,1596,5686,21,79,11,10,0
64945,53,47640,53,292,126,166,2,29,1,1,0
30135,37965,0,0,62,62,0,1,0,1,0,1
58305,445,0,0,70,70,0,1,0,1,0,2
52459,5555,0,0,60,60,0,1,0,1,0,1
56889,53,35698,53,177,94,83,2,30,1,1,0
5588,5588,0,0,3562,1936,1626,48,193,24,24,0
51269,36983,59727,36983,70,70,0,1,5,1,0,0
58925,25174,0,0,66,66,0,1,0,1,0,1
53945,445,0,0,70,70,0,1,0,1,0,2
58711,53,20725,53,277,78,199,2,30,1,1,0
65525,445,0,0,70,70,0,1,0,1,0,2
27144,25174,0,0,66,66,0,1,0,1,0,1
51753,445,0,0,70,70,0,1,0,1,0,2
50579,53,55360,53,174,89,85,2,31,1,1,0
22683,39210,0,0,60,60,0,1,0,1,0,1
55262,53,22053,53,193,102,91,2,30,1,1,0
49393,443,42342,443,62,62,0,1,5,1,0,0
56249,55442,0,0,66,66,0,1,0,1,0,1
55794,443,55794,443,4578,1671,2907,19,28,11,8,0
7322,80,9945,80,950,485,465,9,16,5,4,0
44847,6882,30467,6882,502,150,352,2,1200,1,1,0
56468,80,52689,80,214,140,74,4,26,3,1,0
49295,53,11197,53,280,96,184,4,36,2,2,0
49655,53,32746,53,209,110,99,2,30,1,1,0
60942,445,0,0,70,70,0,1,0,1,0,2
50415,443,63011,443,2542,1504,1038,16,20,9,7,0
52323,445,0,0,70,70,0,1,0,1,0,2
64049,445,0,0,70,70,0,1,0,1,0,2
54927,443,30686,443,7148,1924,5224,35,364,19,16,0
33705,80,63150,80,1288,496,792,8,43,5,3,0
47210,50584,0,0,146,146,0,1,0,1,0,1
60280,445,0,0,70,70,0,1,0,1,0,2
49635,53,38499,53,210,110,100,2,29,1,1,0
34413,443,27966,443,8107,2200,5907,34,255,16,18,0
42576,30188,0,0,146,146,0,1,0,1,0,1
49480,53,49480,53,213,79,134,2,32,1,1,0
50361,80,40866,80,318,192,126,6,28,4,2,0
57911,443,43527,443,9662,4079,5583,66,194,30,36,0
40848,8434,40848,8434,156,156,0,3,8,3,0,0
45964,3111,0,0,60,60,0,1,0,1,0,1
56478,53,14582,53,200,102,98,2,30,1,1,0
50839,445,0,0,70,70,0,1,0,1,0,2
26053,33720,0,0,160,160,0,1,0,1,0,1
49762,53,65280,53,184,94,90,2,30,1,1,0
56816,12523,45890,12523,70,70,0,1,5,1,0,0
56070,53,12726,53,193,102,91,2,30,1,1,0
53456,443,13197,443,25555,2220,23335,44,30,20,24,0
62961,53,49359,53,209,102,107,2,30,1,1,0
64842,443,46917,443,5467,2738,2729,23,137,11,12,0
56658,53,32323,53,193,102,91,2,30,1,1,0
59629,80,40534,80,1652,1264,388,10,17,4,6,0
65186,53,51165,53,521,90,431,4,43,2,2,0
27005,30008,53621,30008,890,126,764,2,31,1,1,0
53323,35253,0,0,62,62,0,1,0,1,0,1
47856,443,54908,443,7816,2371,5445,34,255,18,16,0
45941,23386,0,0,60,60,0,1,0,1,0,1
54336,443,1774,443,172701,6397,166304,202,246,72,130,0
55835,62413,0,0,66,66,0,1,0,1,0,1
0,0,0,0,110,110,0,1,0,1,0,1
64021,53,21293,53,190,97,93,2,30,1,1,0
39868,55839,0,0,137,137,0,1,0,1,0,1
45074,443,48285,443,4493,2566,1927,40,130,21,19,0
58194,443,27436,443,3108,1047,2061,14,136,7,7,0
55013,53,27966,53,198,102,96,2,30,1,1,0
19302,443,26733,443,2227,1018,1209,17,15,8,9,0
55375,44847,0,0,62,62,0,1,0,1,0,1
50984,443,27569,443,8023,3352,4671,19,80,11,8,0
56633,53,60296,53,197,102,95,2,30,1,1,0
7686,25174,0,0,62,62,0,1,0,1,0,1
41764,53,7946,53,168,78,90,2,29,1,1,0
16013,35253,0,0,66,66,0,1,0,1,0,1
64380,53,5955,53,193,102,91,2,30,1,1,0
52213,80,42925,80,5022,1422,3600,16,135,8,8,0
65387,443,41173,443,2289,1583,706,14,18,8,6,0
49218,53,40400,53,195,102,93,2,30,1,1,0
1262,23,0,0,60,60,0,1,0,1,0,1
65080,53,41733,53,193,102,91,2,29,1,1,0
7720,44847,0,0,66,66,0,1,0,1,0,1
13372,50584,0,0,66,66,0,1,0,1,0,1
49498,53,4790,53,245,102,143,2,30,1,1,0
50578,445,0,0,66,66,0,1,0,1,0,2
62059,443,14919,443,11903,6327,5576,48,15,27,21,0
57000,53,25419,53,188,96,92,2,31,1,1,0
57189,53,13765,53,78,78,0,1,30,1,0,0
16905,57866,0,0,66,66,0,1,0,1,0,1
2432,11392,0,0,62,62,0,1,0,1,0,1
49675,5900,49675,5900,124,60,64,2,5,1,1,0
64582,445,0,0,70,70,0,1,0,1,0,2
50239,53,26724,53,183,94,89,2,30,1,1,0
64828,445,0,0,66,66,0,1,0,1,0,2
15503,62336,46736,62336,127653507,122661116,4992391,161030,2162,82907,78123,0
50376,53,40722,53,196,102,94,2,30,1,1,0
17489,50584,0,0,146,146,0,1,0,1,0,1
29972,50584,0,0,62,62,0,1,0,1,0,1
19623,25174,0,0,62,62,0,1,0,1,0,1
60863,443,14093,443,134,60,74,3,5,2,1,0
61867,445,0,0,70,70,0,1,0,1,0,2
56038,53,33876,53,177,94,83,2,30,1,1,0
56938,445,0,0,70,70,0,1,0,1,0,2
51179,53,60232,53,86,86,0,1,30,1,0,0
57470,32517,51554,32517,166,166,0,1,1199,1,0,0
59510,445,0,0,70,70,0,1,0,1,0,2
52051,29868,56419,29868,70,70,0,2,8,2,0,0
10307,53,10307,53,213,87,126,2,30,1,1,0
55767,445,0,0,70,70,0,1,0,1,0,2
48742,443,3234,443,4801,2138,2663,23,15,12,11,0
9518,3855,0,0,100,100,0,1,0,1,0,1
26496,80,26496,80,160989,10162,150827,189,31,81,108,0
50935,80,12497,80,40645,6133,34512,66,274,33,33,0
56375,53,48204,53,177,94,83,2,30,1,1,0
35507,15503,0,0,62,62,0,1,0,1,0,1
10886,51505,0,0,62,62,0,1,0,1,0,1
55334,53,36263,53,199,102,97,2,30,1,1,0
53493,445,0,0,70,70,0,1,0,1,0,2
54708,443,18474,443,5702,1143,4559,21,41,12,9,0
52426,443,20298,443,8760,1218,7542,25,15,14,11,0
55286,53,22881,53,268,87,181,4,35,2,2,0
49730,53,40205,53,194,102,92,2,30,1,1,0
56543,443,22323,443,1323,616,707,18,120,9,9,0
65096,53,51459,53,216,94,122,2,30,1,1,0
57254,443,6263,443,3948,1290,2658,13,120,6,7,0
65275,53,60428,53,807,94,713,2,30,1,1,0
62105,445,0,0,70,70,0,1,0,1,0,2
48681,11392,0,0,146,146,0,1,0,1,0,1
62152,56205,0,0,66,66,0,1,0,1,0,1
64461,53,47213,53,177,94,83,2,31,1,1,0
54216,64147,0,0,66,66,0,1,0,1,0,1
56553,53,56242,53,199,102,97,2,30,1,1,0
55056,56205,0,0,66,66,0,1,0,1,0,1
65468,443,32669,443,421329,12430,408899,433,16,152,281,0
56492,53,39207,53,177,94,83,2,30,1,1,0
52122,43073,9475,43073,70,70,0,2,8,2,0,0
50944,443,50944,443,1210,637,573,14,25,7,7,0
50279,445,0,0,66,66,0,1,0,1,0,2
28007,443,40494,443,31586,15587,15999,213,884,105,108,0
49837,443,60962,443,9634,2232,7402,24,123,12,12,0
64110,53,20636,53,215,102,113,2,30,1,1,0
16092,50265,0,0,62,62,0,1,0,1,0,1
53782,445,0,0,70,70,0,1,0,1,0,2
14341,80,14341,80,3360,2260,1100,19,61,11,8,0
50717,445,0,0,66,66,0,1,0,1,0,2
443,21255,0,0,66,66,0,1,0,1,0,1
63449,445,0,0,70,70,0,1,0,1,0,2
58396,22114,0,0,66,66,0,1,0,1,0,1
55196,445,0,0,70,70,0,1,0,1,0,2
63329,445,0,0,66,66,0,1,0,1,0,2
52180,20121,7972,20121,70,70,0,1,5,1,0,0
54221,443,30270,443,8327,4890,3437,23,316,12,11,0
38581,22114,0,0,62,62,0,1,0,1,0,1
55744,445,0,0,66,66,0,1,0,1,0,2
49428,53,34747,53,267,94,173,2,31,1,1,0
50584,53,19282,53,738,86,652,2,30,1,1,0
63973,53,57018,53,346,98,248,4,31,2,2,0
59083,445,0,0,66,66,0,1,0,1,0,2
56769,11155,5156,11155,66,66,0,1,5,1,0,0
49606,80,25049,80,454,262,192,8,41,5,3,0
48551,443,15020,443,7433,2086,5347,26,316,12,14,0
55090,53,59676,53,196,102,94,2,29,1,1,0
60439,47783,16622,47783,70,70,0,2,8,2,0,0
51682,443,60633,443,5060,2867,2193,26,398,9,17,0
63428,445,0,0,70,70,0,1,0,1,0,2
65474,53,12902,53,198,94,104,2,30,1,1,0
54991,53,13574,53,177,94,83,2,29,1,1,0
61128,445,0,0,66,66,0,1,0,1,0,2
57403,53,33479,53,764,99,665,2,31,1,1,0
40597,443,45954,443,11101,4498,6603,35,430,20,15,0
55963,53,27489,53,755,93,662,2,30,1,1,0
61248,445,0,0,70,70,0,1,0,1,0,2
123,123,5546,123,184,94,90,2,29,1,1,0
59245,445,0,0,70,70,0,1,0,1,0,2
37420,44847,0,0,62,62,0,1,0,1,0,1
65504,53,23026,53,193,102,91,2,30,1,1,0
49774,443,43328,443,8130,2220,5910,23,16,13,10,0
41164,443,60993,443,8949,1938,7011,21,17,12,9,0
44265,80,44265,80,22407,7251,15156,35,23,16,19,0
46893,443,27910,443,622,70,552,10,180,2,8,0
56704,53,2427,53,318,94,224,2,30,1,1,0
58835,445,0,0,70,70,0,1,0,1,0,2
56167,53,17314,53,178,94,84,2,30,1,1,0
53864,53,19118,53,168,78,90,2,30,1,1,0
52836,36829,0,0,66,66,0,1,0,1,0,1
63515,445,0,0,66,66,0,1,0,1,0,2
57512,443,32314,443,4265,2639,1626,34,31,16,18,0
38496,5228,27256,5228,3397,1506,1891,26,640,8,18,0
38976,46824,0,0,62,62,0,1,0,1,0,1
37579,443,40926,443,7982,2392,5590,25,26,14,11,0
52762,445,0,0,70,70,0,1,0,1,0,2
49531,53,39343,53,289,94,195,4,31,2,2,0
51425,37450,0,0,62,62,0,1,0,1,0,1
5938,37145,0,0,60,60,0,1,90,1,0,0
56168,53,62337,53,745,93,652,2,30,1,1,0
49595,80,13926,80,1285,772,513,11,53,6,5,0
30114,65151,0,0,60,60,0,1,0,1,0,1
56543,53,0,0,82,82,0,1,31,1,0,0
65082,53,4469,53,718,94,624,2,29,1,1,0
59246,445,0,0,70,70,0,1,0,1,0,2
40802,443,39888,443,3321,1297,2024,13,32,7,6,0
11552,44847,0,0,62,62,0,1,0,1,0,1
49233,443,34014,443,9622,3524,6098,59,916,29,30,0
46277,443,48047,443,15670,12575,3095,51,37,30,21,0
443,48056,0,0,135,135,0,1,0,1,0,1
59617,443,31345,443,5682,1565,4117,23,66,13,10,0
65249,53,14438,53,1579,94,1485,4,36,2,2,0
51559,443,32426,443,254,70,184,5,21,2,3,0
64104,445,0,0,70,70,0,1,0,1,0,2
60762,445,0,0,70,70,0,1,0,1,0,2
65074,53,29931,53,284,118,166,2,30,1,1,0
64835,53,56147,53,200,102,98,2,31,1,1,0
49608,53,10158,53,170,87,83,2,31,1,1,0
49797,53,51758,53,718,94,624,2,30,1,1,0
58638,5900,0,0,62,62,0,1,0,1,0,1
8191,51221,0,0,62,62,0,1,0,1,0,1
56845,53,56845,53,825,99,726,2,30,1,1,0
443,62732,0,0,332,332,0,1,0,1,0,1
57987,3478,61463,3478,60483,25857,34626,136,47,63,73,0
58764,53,65299,53,268,94,174,2,30,1,1,0
51913,52188,58050,52188,66,66,0,1,5,1,0,0
56834,46513,28288,46513,70,70,0,1,5,1,0,0
42298,40030,5035,40030,146,84,62,2,31,1,1,0
57351,53,48992,53,177,94,83,2,30,1,1,0
49406,443,41618,443,7808,2879,4929,36,186,19,17,0
57470,43611,57055,43611,3960,3960,0,61,3411,61,0,0
55597,445,0,0,70,70,0,1,0,1,0,2
27005,27016,18981,27016,884,126,758,2,30,1,1,0
27005,27018,14110,27018,881,126,755,2,30,1,1,0
62765,445,0,0,66,66,0,1,0,1,0,2
51690,445,0,0,70,70,0,1,0,1,0,2
49502,53,5291,53,193,102,91,2,30,1,1,0
64980,27047,61209,27047,735,462,273,2,30,1,1,0
37087,80,29544,80,946,531,415,11,296,6,5,0
56625,53,59531,53,186,95,91,2,31,1,1,0
55893,53,44273,53,267,94,173,4,55,2,2,0
64856,53,25050,53,451,124,327,4,45,2,2,0
64127,53,25934,53,177,94,83,2,30,1,1,0
56081,445,0,0,70,70,0,1,0,1,0,2
14260,36829,0,0,62,62,0,1,0,1,0,1
5222,27389,0,0,66,66,0,1,0,1,0,1
56152,56205,0,0,66,66,0,1,0,1,0,1
61204,445,0,0,70,70,0,1,0,1,0,2
55525,445,0,0,70,70,0,1,0,1,0,2
65304,53,18529,53,209,110,99,2,30,1,1,0
57268,443,5467,443,1617,1073,544,16,15,9,7,0
55875,445,0,0,66,66,0,1,0,1,0,2
57964,445,0,0,70,70,0,1,0,1,0,2
26385,53,26385,53,235,90,145,2,33,1,1,0
55408,64147,0,0,66,66,0,1,0,1,0,1
51914,445,0,0,70,70,0,1,0,1,0,2
57444,443,62310,443,7975,1742,6233,24,81,14,10,0
56581,443,17747,443,4884,1015,3869,17,25,9,8,0
49662,53,31424,53,268,93,175,4,58,2,2,0
52295,53,54282,53,322,102,220,2,30,1,1,0
58638,5900,0,0,62,62,0,1,0,1,0,1
49869,53,29655,53,209,110,99,2,30,1,1,0
46000,53,44521,53,164,78,86,2,31,1,1,0
49195,8108,11315,8108,70,70,0,2,8,2,0,0
64626,50584,0,0,66,66,0,1,0,1,0,1
49525,80,7498,80,454,262,192,8,38,5,3,0
64974,27054,45428,27054,3142,1386,1756,8,31,4,4,0
50102,17546,0,0,66,66,0,1,0,1,0,1
62449,443,11939,443,9977,4364,5613,19,121,9,10,0
50386,443,59778,443,1346,918,428,10,26,6,4,0
52518,35440,0,0,62,62,0,1,0,1,0,1
54998,53,21655,53,198,102,96,2,31,1,1,0
59778,443,33771,443,6723,1014,5709,19,29,10,9,0
54601,26467,0,0,66,66,0,1,0,1,0,1
55878,7302,0,0,62,62,0,1,0,1,0,1
0,0,0,0,98,98,0,1,0,1,0,1
59534,53,0,0,627,72,555,2,30,1,1,0
51718,55003,38571,55003,70,70,0,2,8,2,0,0
59592,37965,0,0,62,62,0,1,0,1,0,1
53677,445,0,0,66,66,0,1,0,1,0,2
55651,53,31474,53,198,101,97,2,30,1,1,0
55090,53,47013,53,192,98,94,2,30,1,1,0
3225,64147,0,0,66,66,0,1,0,1,0,1
52859,445,0,0,66,66,0,1,0,1,0,2
56769,11155,9985,11155,70,70,0,2,8,2,0,0
64714,445,0,0,70,70,0,1,0,1,0,2
1036,64147,0,0,62,62,0,1,0,1,0,1
51442,443,61245,443,4591,3237,1354,18,271,10,8,0
65398,53,61803,53,212,108,104,2,30,1,1,0
33912,443,41888,443,6288,3354,2934,9,122,5,4,0
50052,65008,0,0,60,60,0,1,0,1,0,1
49271,53,54358,53,186,102,84,2,30,1,1,0
56684,443,53117,443,7907,1918,5989,20,15,11,9,0
51320,37965,0,0,62,62,0,1,0,1,0,1
55335,445,0,0,70,70,0,1,0,1,0,2
16387,16862,0,0,60,60,0,1,0,1,0,1
51954,12380,62025,12380,70,70,0,2,7,2,0,0
54999,443,63007,443,6430,1513,4917,26,40,14,12,0
65514,53,50854,53,170,87,83,2,30,1,1,0
50328,53,20316,53,783,96,687,2,30,1,1,0
55802,445,0,0,70,70,0,1,0,1,0,2
35065,443,35065,443,5537,2290,3247,22,39,13,9,0
50270,443,3425,443,868,514,354,13,18,8,5,0
49858,443,16431,443,2027955,75406,1952549,2104,60,564,1540,0
34357,443,9724,443,33131,26333,6798,49,121,28,21,0
25237,57470,0,0,62,62,0,1,0,1,0,1
23843,26467,0,0,62,62,0,1,0,1,0,1
49302,443,8225,443,3182,1568,1614,8,120,4,4,0
52732,445,0,0,66,66,0,1,0,1,0,2
64109,53,30318,53,225,102,123,2,30,1,1,0
64074,53,3754,53,202,103,99,2,31,1,1,0
56901,53,23977,53,710,89,621,2,31,1,1,0
57956,443,29445,443,7842,2164,5678,48,5441,20,28,0
24208,53,24208,53,231,88,143,2,32,1,1,0
5774,37965,0,0,66,66,0,1,0,1,0,1
53768,19067,41942,19067,70,70,0,2,8,2,0,0
58209,445,0,0,70,70,0,1,0,1,0,2
45549,443,52830,443,7951,1449,6502,22,125,12,10,0
60881,443,31300,443,31109,2922,28187,54,52,26,28,0
9442,443,1324,443,6100,777,5323,17,25,9,8,0
60052,445,0,0,66,66,0,1,0,1,0,2
64145,53,59140,53,177,94,83,2,30,1,1,0
10248,21247,0,0,62,62,0,1,0,1,0,1
63940,3389,63940,3389,3347,1458,1889,15,17,8,7,0
55699,443,1921,443,4170,1901,2269,14,120,7,7,0
57410,53,64082,53,711,87,624,2,30,1,1,0
27005,27018,55202,27018,881,126,755,2,30,1,1,0
5222,48709,0,0,66,66,0,1,0,1,0,1
443,28417,0,0,82,82,0,1,0,1,0,1
53092,443,35345,443,7676,1577,6099,28,395,9,19,0
64934,53,52297,53,197,102,95,2,33,1,1,0
56495,53,29192,53,198,101,97,2,30,1,1,0
49424,443,6642,443,77408,4295,73113,106,271,52,54,0
60455,443,23230,443,25055,5440,19615,65,84,35,30,0
50541,53,14016,53,458,188,270,6,30,3,3,0
52247,51505,0,0,146,146,0,1,0,1,0,1
63727,61557,39781,61557,312,132,180,6,6,3,3,0
45941,23386,0,0,60,60,0,1,0,1,0,1
38805,443,57310,443,6686,1197,5489,23,16,12,11,0
36628,80,54402,80,78,78,0,2,8,2,0,0
64283,53,27743,53,193,102,91,2,30,1,1,0
50265,16082,44635,16082,858,858,0,14,1200,14,0,0
50823,80,36399,80,35970,11674,24296,108,265,55,53,0
49537,53,59309,53,269,96,173,4,59,2,2,0
29291,48983,0,0,150,150,0,1,0,1,0,1
40301,8696,0,0,60,60,0,1,0,1,0,1
32137,44512,0,0,62,62,0,1,0,1,0,1
56952,53,29584,53,193,102,91,2,30,1,1,0
7444,57470,0,0,66,66,0,1,0,1,0,1
50596,53,52895,53,168,86,82,2,29,1,1,0
60539,445,0,0,70,70,0,1,0,1,0,2
55023,53,43972,53,216,102,114,2,30,1,1,0
64798,53,18186,53,177,94,83,2,29,1,1,0
55923,53,53051,53,177,94,83,2,30,1,1,0
57007,80,33678,80,214,140,74,4,31,3,1,0
56552,53,34046,53,195,102,93,2,30,1,1,0
51582,48817,0,0,66,66,0,1,0,1,0,1
2980,53,2980,53,216,90,126,2,30,1,1,0
0,0,0,0,156,156,0,2,0,2,0,0
58638,5900,0,0,62,62,0,1,0,1,0,1
51376,445,0,0,70,70,0,1,0,1,0,2
50888,445,0,0,70,70,0,1,0,1,0,2
53073,32468,0,0,66,66,0,1,0,1,0,1
55504,53,5700,53,711,87,624,2,30,1,1,0
59902,53,0,0,220,83,137,2,30,1,1,0
58989,445,0,0,70,70,0,1,0,1,0,2
65511,53,22579,53,545,136,409,4,56,2,2,0
52069,80,30929,80,362,240,122,7,25,5,2,0
49752,50584,0,0,62,62,0,1,0,1,0,1
49569,53,26958,53,821,102,719,2,30,1,1,0
41279,443,39948,443,8119,1411,6708,20,200,11,9,0
48755,53,17288,53,168,78,90,2,30,1,1,0
56684,53,5087,53,194,94,100,2,30,1,1,0
65342,53,40557,53,183,94,89,2,30,1,1,0
1025,64147,0,0,62,62,0,1,0,1,0,1
44901,443,19443,443,11891,6219,5672,35,174,16,19,0
27160,64147,0,0,62,62,0,1,0,1,0,1
50306,80,39882,80,182517,10761,171756,265,352,130,135,0
65209,57866,0,0,62,62,0,1,0,1,0,1
55042,53,54765,53,782,105,677,2,30,1,1,0
51987,443,55315,443,134,60,74,3,5,2,1,0
41234,443,28858,443,1741,1048,693,15,25,8,7,0
58830,443,23946,443,5168,700,4468,16,15,7,9,0
60294,30188,0,0,66,66,0,1,0,1,0,1
6832,51505,0,0,66,66,0,1,0,1,0,1
52978,445,0,0,70,70,0,1,0,1,0,2
65463,53,50986,53,177,94,83,2,30,1,1,0
56718,443,49535,443,7940,1951,5989,20,15,11,9,0
21133,54322,33050,54322,480,149,331,2,1200,1,1,0
44746,37965,0,0,62,62,0,1,0,1,0,1
53165,443,14639,443,7434,1695,5739,23,27,12,11,0
50456,80,33099,80,4473,3398,1075,14,34,8,6,0
50560,80,54497,80,318,192,126,6,26,4,2,0
13980,23,0,0,60,60,0,1,0,1,0,1
50049,445,0,0,70,70,0,1,0,1,0,2
49806,53,63116,53,242,118,124,2,30,1,1,0
55416,445,0,0,66,66,0,1,0,1,0,2
58821,443,62939,443,16200,10803,5397,42,18,24,18,0
52210,51505,0,0,62,62,0,1,0,1,0,1
49488,53,29306,53,194,102,92,2,30,1,1,0
57051,53,27315,53,170,87,83,2,31,1,1,0
29025,53,29025,53,235,90,145,2,31,1,1,0
49931,25174,0,0,66,66,0,1,0,1,0,1
52143,33283,63927,33283,70,70,0,2,8,2,0,0
56951,53,31350,53,199,102,97,2,30,1,1,0
55377,53,19699,53,1428,103,1325,4,32,2,2,0
56949,22,0,0,60,60,0,1,0,1,0,1
65514,53,17473,53,177,94,83,2,29,1,1,0
61864,80,52616,80,9747,537,9210,14,16,6,8,0
49431,53,23067,53,353,94,259,2,30,1,1,0
4232,50584,0,0,62,62,0,1,0,1,0,1
33822,57470,0,0,66,66,0,1,0,1,0,1
49916,53,52400,53,395,111,284,2,31,1,1,0
443,48346,0,0,81,81,0,1,0,1,0,1
53993,6881,30701,6881,70,70,0,2,8,2,0,0
58889,445,0,0,70,70,0,1,0,1,0,2
20487,50584,0,0,62,62,0,1,0,1,0,1
55006,53,7313,53,711,87,624,2,30,1,1,0
27005,27021,13743,27021,1616,126,1490,4,30,2,2,0
26462,80,26462,80,490,264,226,8,32,5,3,0
49815,53,0,0,166,73,93,2,30,1,1,0
60476,80,59400,80,613,539,74,7,15,6,1,0
11402,11119,0,0,145,145,0,1,0,1,0,1
55211,445,0,0,70,70,0,1,0,1,0,2
56316,53,62474,53,733,93,640,2,31,1,1,0
54467,80,25502,80,17572,1518,16054,30,255,16,14,0
65514,53,61722,53,291,98,193,4,33,2,2,0
63657,445,0,0,70,70,0,1,0,1,0,2
54998,53,24555,53,168,78,90,2,30,1,1,0
11006,23117,0,0,146,146,0,1,0,1,0,1
44757,53,59516,53,179,86,93,2,30,1,1,0
56578,64147,0,0,66,66,0,1,0,1,0,1
57404,445,0,0,70,70,0,1,0,1,0,2
51854,13923,55002,13923,136,136,0,3,13,3,0,0
57038,53,16760,53,188,96,92,2,30,1,1,0
56068,53,21388,53,214,102,112,2,30,1,1,0
57371,53,64674,53,214,110,104,2,30,1,1,0
50753,445,0,0,66,66,0,1,0,1,0,2
52275,445,0,0,70,70,0,1,0,1,0,2
41781,443,5729,443,1820,1101,719,18,82,10,8,0
59841,445,0,0,70,70,0,1,0,1,0,2
65528,445,0,0,70,70,0,1,0,1,0,2
53172,56013,19244,56013,70,70,0,2,8,2,0,0
64399,53,50659,53,230,110,120,2,29,1,1,0
55114,53,53852,53,392,100,292,4,33,2,2,0
5223,59023,0,0,66,66,0,1,0,1,0,1
65027,445,0,0,70,70,0,1,0,1,0,2
50939,443,38504,443,8058,1136,6922,19,126,9,10,0
0,0,0,0,98,98,0,1,0,1,0,1
58056,443,24409,443,6821,1076,5745,21,38,12,9,0
49165,5938,24586,5938,143727,72050,71677,1106,10824,655,451,0
27777,80,27777,80,12281469,369857,11911612,13837,31,5536,8301,0
43840,50265,0,0,72,72,0,1,0,1,0,1
64695,53,52435,53,193,102,91,2,30,1,1,0
13257,53,13257,53,227,88,139,2,31,1,1,0
60587,443,60587,443,4572,1665,2907,19,27,11,8,0
65284,445,0,0,70,70,0,1,0,1,0,2
57942,443,1661,443,2791,1800,991,26,185,15,11,0
50724,443,63657,443,3171,1369,1802,9,120,5,4,0
52190,443,16680,443,7942,870,7072,22,15,10,12,0
57323,443,4968,443,5613,733,4880,16,14,9,7,0
58952,445,0,0,66,66,0,1,0,1,0,2
41636,123,47665,123,184,94,90,2,30,1,1,0
23296,23,0,0,60,60,0,1,0,1,0,1
65215,445,0,0,66,66,0,1,0,1,0,2
22547,23,0,0,60,60,0,1,0,1,0,1
56812,445,0,0,70,70,0,1,0,1,0,2
49367,51505,0,0,66,66,0,1,0,1,0,1
45396,53,7036,53,168,78,90,2,30,1,1,0
65187,53,19736,53,392,86,306,2,30,1,1,0
54308,445,0,0,70,70,0,1,0,1,0,2
38258,443,9287,443,5714,1536,4178,24,21,13,11,0
60466,64337,52523,64337,70,70,0,2,8,2,0,0
49418,27021,53913,27021,232,71,161,2,30,1,1,0
59447,445,0,0,70,70,0,1,0,1,0,2
37965,6881,46281,6881,479,150,329,2,1199,1,1,0
1027,25174,0,0,62,62,0,1,0,1,0,1
51837,445,0,0,70,70,0,1,0,1,0,2
33589,23,0,0,60,60,0,1,0,1,0,1
56246,53,1913,53,209,110,99,2,30,1,1,0
49932,53,19133,53,237,86,151,2,30,1,1,0
55261,445,0,0,70,70,0,1,0,1,0,2
64995,53,14595,53,210,110,100,2,30,1,1,0
58910,445,0,0,70,70,0,1,0,1,0,2
52214,443,59996,443,10898,3170,7728,33,331,14,19,0
49418,28002,23648,28002,271,78,193,2,30,1,1,0
57165,34101,0,0,62,62,0,1,0,1,0,1
51149,445,0,0,70,70,0,1,0,1,0,2
58386,443,63968,443,15705,3421,12284,53,360,23,30,0
52781,443,23345,443,1581,924,657,15,125,7,8,0
51414,22,0,0,60,60,0,1,0,1,0,1
63902,445,0,0,66,66,0,1,0,1,0,2
61580,53,48820,53,275,94,181,2,29,1,1,0
40299,443,53474,443,9574,2600,6974,29,136,16,13,0
64835,445,0,0,66,66,0,1,0,1,0,2
58959,445,0,0,70,70,0,1,0,1,0,2
59965,36237,0,0,66,66,0,1,0,1,0,1
60720,23718,0,0,66,66,0,1,0,1,0,1
55345,53,38199,53,255,102,153,2,30,1,1,0
57377,53,26653,53,2235,93,2142,4,30,2,2,0
45682,1,0,0,62,62,0,1,0,1,0,1
64471,53,53728,53,264,110,154,2,30,1,1,0
56549,443,22340,443,13979,2593,11386,29,114,11,18,0
1114,37965,0,0,62,62,0,1,0,1,0,1
47342,20541,0,0,66,66,0,1,0,1,0,1
64294,64147,0,0,62,62,0,1,0,1,0,1
49907,53,54297,53,199,102,97,2,29,1,1,0
49310,53,42489,53,816,102,714,2,30,1,1,0
54476,443,29193,443,48303,3997,44306,69,271,30,39,0
51497,443,14907,443,8939,3462,5477,25,263,12,13,0
48978,25174,0,0,62,62,0,1,0,1,0,1
7744,32480,0,0,62,62,0,1,0,1,0,1
63075,53,54531,53,571,166,405,2,29,1,1,0
61497,445,0,0,70,70,0,1,0,1,0,2
58342,445,0,0,70,70,0,1,0,1,0,2
58638,5900,0,0,62,62,0,1,0,1,0,1
39328,80,5790,80,78,78,0,1,5,1,0,0
49418,30010,58880,30010,238,71,167,2,30,1,1,0
61232,443,38058,443,1786,172,1614,7,120,3,4,0
10036,44847,0,0,66,66,0,1,0,1,0,1
4862,37965,0,0,66,66,0,1,0,1,0,1
62905,445,0,0,70,70,0,1,0,1,0,2
9528,44847,0,0,62,62,0,1,0,1,0,1
1264,26296,0,0,143,143,0,1,0,1,0,1
55820,53,12238,53,184,94,90,2,30,1,1,0
50817,443,46052,443,17161,1619,15542,18,153,4,14,0
65049,53,16377,53,210,110,100,2,30,1,1,0
53900,443,15989,443,499,425,74,4,0,3,1,0
56798,40759,43301,40759,70,70,0,1,5,1,0,0
27005,27052,57707,27052,1948,378,1570,6,33,4,2,0
55728,53,24572,53,195,102,93,2,31,1,1,0
49688,443,44354,443,318,192,126,6,53,4,2,0
64380,53,30464,53,196,102,94,2,32,1,1,0
50563,37965,0,0,66,66,0,1,0,1,0,1
51646,37965,0,0,62,62,0,1,0,1,0,1
59843,445,0,0,70,70,0,1,0,1,0,2
51880,8000,15502,8000,750,360,390,10,60,5,5,0
63626,443,34704,443,15769,1619,14150,17,138,4,13,0
56792,443,43093,443,8074,2054,6020,20,15,11,9,0
63030,445,0,0,66,66,0,1,0,1,0,2
10014,40026,21058,40026,156,94,62,2,30,1,1,0
58186,443,61282,443,5086,3296,1790,36,56,18,18,0
58815,445,0,0,70,70,0,1,0,1,0,2
56655,53,54773,53,86,86,0,1,29,1,0,0
55727,43736,4643,43736,70,70,0,2,8,2,0,0
62877,445,0,0,66,66,0,1,0,1,0,2
59745,25174,0,0,62,62,0,1,0,1,0,1
58638,5900,0,0,62,62,0,1,0,1,0,1
59830,445,0,0,70,70,0,1,0,1,0,2
49761,53,36428,53,373,99,274,4,41,2,2,0
36483,80,36483,80,1015966,37923,978043,1167,205,468,699,0
51043,445,0,0,70,70,0,1,0,1,0,2
60364,445,0,0,66,66,0,1,0,1,0,2
53905,50130,9021,50130,552,306,246,9,16,5,4,0
44127,30188,0,0,146,146,0,1,0,1,0,1
55423,53,51640,53,177,94,83,2,30,1,1,0
9742,80,9742,80,1384,648,736,9,15,5,4,0
55343,445,0,0,66,66,0,1,0,1,0,2
52473,445,0,0,66,66,0,1,0,1,0,2
56808,53,41016,53,90,90,0,1,30,1,0,0
58638,5900,0,0,62,62,0,1,0,1,0,1
47722,80,12273,80,1720,1406,314,10,15,5,5,0
49803,80,1813,80,2553,1621,932,13,126,8,5,0
34531,23117,0,0,62,62,0,1,0,1,0,1
49699,53,7442,53,266,89,177,4,58,2,2,0
6666,2001,0,0,60,60,0,1,0,1,0,1
55597,7485,9099,7485,70,70,0,2,8,2,0,0
51423,80,51423,80,7610,2737,4873,23,26,12,11,0
33845,443,64577,443,6495,1547,4948,19,318,10,9,0
54279,443,54279,443,4699,1792,2907,19,28,11,8,0
36936,443,13188,443,490,210,280,8,131,4,4,0
55572,445,0,0,70,70,0,1,0,1,0,2
56659,53,34690,53,199,94,105,2,30,1,1,0
65084,53,19424,53,215,102,113,2,29,1,1,0
50482,80,36252,80,314,192,122,6,25,4,2,0
57159,53,30985,53,292,94,198,2,30,1,1,0
54351,23,0,0,60,60,0,1,0,1,0,1
49349,445,0,0,66,66,0,1,0,1,0,2
34726,53,62948,53,168,78,90,2,30,1,1,0
64276,53,63257,53,398,105,293,4,46,2,2,0
443,9986,0,0,669,669,0,1,0,1,0,1
38330,44847,0,0,66,66,0,1,0,1,0,1
56832,23900,53161,23900,130,70,60,2,5,1,1,0
54276,37628,0,0,66,66,0,1,0,1,0,1
58085,57470,0,0,66,66,0,1,0,1,0,1
49891,80,47196,80,1376,946,430,8,86,5,3,0
47893,443,63291,443,172,172,0,2,4,2,0,0
50652,445,0,0,70,70,0,1,0,1,0,2
55466,53,26661,53,177,94,83,2,29,1,1,0
50554,80,7103,80,378,192,186,7,26,4,3,0
63174,445,0,0,70,70,0,1,0,1,0,2
57362,53,9411,53,346,102,244,2,31,1,1,0
58715,57470,0,0,66,66,0,1,0,1,0,1
39325,443,37130,443,1396,735,661,14,80,8,6,0
51765,80,50481,80,5569,3270,2299,21,74,13,8,0
59583,53,59583,53,229,89,140,2,31,1,1,0
7184,15503,0,0,66,66,0,1,0,1,0,1
57168,53,20859,53,760,96,664,2,30,1,1,0
54849,22448,0,0,66,66,0,1,90,1,0,0
50681,80,59849,80,318,192,126,6,26,4,2,0
50584,6889,59579,6889,161,161,0,2,1200,2,0,0
57073,53,22592,53,197,102,95,2,33,1,1,0
50054,445,0,0,70,70,0,1,0,1,0,2
50572,445,0,0,70,70,0,1,0,1,0,2
57302,443,55784,443,5614,733,4881,16,15,9,7,0
63895,43729,7105,43729,70,70,0,1,4,1,0,0
49626,53,39799,53,969,86,883,2,30,1,1,0
55146,445,0,0,70,70,0,1,0,1,0,2
59352,37965,0,0,66,66,0,1,0,1,0,1
49385,53,9929,53,843,285,558,8,56,4,4,0
52957,53,50377,53,168,78,90,2,29,1,1,0
45345,443,9986,443,2438,1442,996,21,27,12,9,0
56785,39004,0,0,145,145,0,1,0,1,0,1
42843,53,7011,53,168,78,90,2,30,1,1,0
56191,53,1757,53,177,94,83,2,30,1,1,0
0,0,0,0,480,244,236,4,0,2,2,0
49778,53,5798,53,319,98,221,4,53,2,2,0
9103,443,27886,443,7876,1511,6365,29,42,14,15,0
50692,80,30484,80,5727,3584,2143,15,31,8,7,0
53625,445,0,0,66,66,0,1,0,1,0,2
55869,53,8327,53,196,102,94,2,31,1,1,0
52455,443,34682,443,7356,1014,6342,20,75,10,10,0
2267,53,54801,53,204,118,86,2,30,1,1,0
51179,443,22561,443,13708,1734,11974,25,31,12,13,0
60779,80,5237,80,1248,516,732,9,15,4,5,0
57986,80,14489,80,1898,1524,374,14,15,8,6,0
50673,443,61982,443,14723,2606,12117,54,19,22,32,0
1773,11392,0,0,62,62,0,1,0,1,0,1
58638,5900,0,0,62,62,0,1,0,1,0,1
54713,445,0,0,70,70,0,1,0,1,0,2
56626,443,37778,443,45304,28614,16690,82,41,45,37,0
60896,53,29321,53,168,78,90,2,31,1,1,0
57001,53,50963,53,210,110,100,2,30,1,1,0
56324,445,0,0,66,66,0,1,0,1,0,2
60076,445,0,0,70,70,0,1,0,1,0,2
49635,53,55370,53,204,104,100,2,30,1,1,0
52925,443,23150,443,5582,1388,4194,19,15,9,10,0
63948,445,0,0,70,70,0,1,0,1,0,2
49786,443,41630,443,10079,2855,7224,23,126,12,11,0
65091,53,53299,53,212,102,110,2,29,1,1,0
2717,31573,0,0,62,62,0,1,0,1,0,1
50650,443,2408,443,9741,7503,2238,24,32,14,10,0
53500,445,0,0,66,66,0,1,0,1,0,2
26900,27017,9336,27017,422,164,258,6,30,3,3,0
39317,443,31071,443,2045,1025,1020,17,80,9,8,0
49988,443,12921,443,214,82,132,4,5,2,2,0
55715,53,18469,53,168,86,82,2,30,1,1,0
49354,53,30111,53,192,98,94,2,31,1,1,0
6881,6881,0,0,146,146,0,1,0,1,0,1
60805,443,29197,443,7983,4398,3585,17,121,8,9,0
63645,445,0,0,66,66,0,1,0,1,0,2
65123,53,24943,53,307,110,197,2,29,1,1,0
56119,445,0,0,70,70,0,1,0,1,0,2
37641,443,55231,443,8423,2244,6179,32,15,17,15,0
61320,53,0,0,194,80,114,2,30,1,1,0
41389,443,45580,443,280,140,140,5,131,3,2,0
5223,14446,0,0,220,220,0,1,0,1,0,1
57271,53,1300,53,228,102,126,2,30,1,1,0
60479,53928,50197,53928,70,70,0,2,8,2,0,0
3478,61463,0,0,156,156,0,1,0,1,0,1
57301,443,1829,443,5614,733,4881,16,15,9,7,0
56501,53,62547,53,711,87,624,2,31,1,1,0
51502,445,0,0,70,70,0,1,0,1,0,2
64490,445,0,0,70,70,0,1,0,1,0,2
49354,443,56660,443,4379,2565,1814,24,81,11,13,0
53472,17,0,0,60,60,0,1,0,1,0,1
51491,445,0,0,70,70,0,1,0,1,0,2
59128,44847,0,0,66,66,0,1,0,1,0,1
56381,53,14303,53,196,102,94,2,31,1,1,0
56744,53,53021,53,274,110,164,2,30,1,1,0
46475,80,46475,80,8300,966,7334,14,20,6,8,0
43921,443,8788,443,8324,1658,6666,24,83,14,10,0
27005,27015,5411,27015,887,126,761,2,30,1,1,0
34388,443,29047,443,7002,1252,5750,28,258,15,13,0
60414,80,46472,80,5124,3499,1625,14,121,8,6,0
64379,53,61307,53,333,94,239,2,30,1,1,0
63811,443,59225,443,25707,7559,18148,53,121,24,29,0
55816,53,3790,53,214,110,104,2,31,1,1,0
2731,25174,0,0,146,146,0,1,0,1,0,1
65067,53,58003,53,214,110,104,2,30,1,1,0
50172,443,51694,443,3756,1914,1842,19,361,9,10,0
55679,1024,59914,1024,70,70,0,2,8,2,0,0
29706,50584,0,0,66,66,0,1,0,1,0,1
63749,445,0,0,70,70,0,1,0,1,0,2
58564,50432,0,0,66,66,0,1,0,1,0,1
50627,443,16215,443,8256,1674,6582,31,75,15,16,0
55057,53,53863,53,211,110,101,2,30,1,1,0
56907,53,30481,53,186,95,91,2,30,1,1,0
61185,54532,0,0,62,62,0,1,0,1,0,1
53457,443,28376,443,26693,2059,24634,42,30,18,24,0
63461,51505,0,0,66,66,0,1,0,1,0,1
55024,445,0,0,70,70,0,1,0,1,0,2
49538,53,45151,53,748,94,654,2,30,1,1,0
37965,15357,58016,15357,481,150,331,2,1200,1,1,0
45535,25174,0,0,66,66,0,1,0,1,0,1
60423,35440,0,0,62,62,0,1,0,1,0,1
54277,22114,0,0,62,62,0,1,0,1,0,1
19004,51505,0,0,62,62,0,1,0,1,0,1
57173,44847,0,0,62,62,0,1,0,1,0,1
56569,53,52915,53,94,94,0,1,30,1,0,0
53419,28189,0,0,60,60,0,1,0,1,0,1
53739,443,35645,443,499,425,74,4,0,3,1,0
52131,28980,48915,28980,70,70,0,2,8,2,0,0
65295,445,0,0,70,70,0,1,0,1,0,2
63087,443,39607,443,448,166,282,2,31,1,1,0
51776,14645,41362,14645,70,70,0,2,8,2,0,0
51041,445,0,0,70,70,0,1,0,1,0,2
58381,57470,0,0,66,66,0,1,0,1,0,1
40834,50584,0,0,62,62,0,1,0,1,0,1
13090,36237,0,0,66,66,0,1,0,1,0,1
49364,53,30235,53,183,94,89,2,30,1,1,0
60701,443,27691,443,5166,1989,3177,15,122,7,8,0
3478,61463,0,0,1345,1345,0,1,0,1,0,1
55874,445,0,0,70,70,0,1,0,1,0,2
48831,443,51436,443,10129,5016,5113,18,120,9,9,0
48706,23393,0,0,60,60,0,1,0,1,0,1
57360,53,29113,53,231,110,121,2,30,1,1,0
54489,80,6564,80,2828,1710,1118,10,255,6,4,0
65440,53,38806,53,240,86,154,2,29,1,1,0
65438,443,60459,443,572,320,252,10,28,6,4,0
64164,445,0,0,66,66,0,1,0,1,0,2
49418,27015,22086,27015,78,78,0,1,30,1,0,0
59075,445,0,0,70,70,0,1,0,1,0,2
50523,443,53596,443,6676,1074,5602,22,84,12,10,0
58836,44847,0,0,74,74,0,1,0,1,0,1
49974,445,0,0,66,66,0,1,0,1,0,2
56759,53,10512,53,177,94,83,2,30,1,1,0
60011,443,4713,443,11061,2230,8831,40,109,23,17,0
56667,53,19814,53,244,94,150,2,30,1,1,0
65392,445,0,0,66,66,0,1,0,1,0,2
64297,445,0,0,70,70,0,1,0,1,0,2
59977,443,64573,443,7971,2647,5324,38,15,24,14,0
62332,53,0,0,170,75,95,2,29,1,1,0
61420,445,0,0,66,66,0,1,0,1,0,2
50908,445,0,0,66,66,0,1,0,1,0,2
50828,443,8189,443,178483,7778,170705,219,218,90,129,0
53010,445,0,0,70,70,0,1,0,1,0,2
63765,51221,0,0,62,62,0,1,0,1,0,1
443,18368,0,0,60,60,0,1,0,1,0,1
49367,445,0,0,66,66,0,1,0,1,0,2
20280,30188,0,0,146,146,0,1,0,1,0,1
54587,445,0,0,66,66,0,1,0,1,0,2
41328,53,51462,53,198,93,105,2,30,1,1,0
19136,64147,0,0,62,62,0,1,0,1,0,1
51401,443,9077,443,130,70,60,2,4,1,1,0
64859,53,0,0,220,81,139,2,30,1,1,0
56101,53,38415,53,194,102,92,2,31,1,1,0
13859,53,13859,53,215,98,117,2,30,1,1,0
38653,21247,0,0,62,62,0,1,0,1,0,1
48710,22,48710,22,11002,3445,7557,60,42,26,34,0
54293,445,0,0,70,70,0,1,0,1,0,2
56458,445,0,0,70,70,0,1,0,1,0,2
56414,53,14395,53,178,94,84,2,30,1,1,0
49879,445,0,0,70,70,0,1,0,1,0,2
61053,44847,0,0,66,66,0,1,0,1,0,1
27005,27013,37862,27013,869,126,743,2,30,1,1,0
55936,53,1988,53,177,94,83,2,29,1,1,0
55893,53,24260,53,267,94,173,4,55,2,2,0
2170,43227,0,0,62,62,0,1,0,1,0,1
51931,445,0,0,70,70,0,1,0,1,0,2
58061,80,39603,80,5571,2637,2934,23,75,12,11,0
53709,15000,7812,15000,320,140,180,6,7,3,3,0
64383,443,47790,443,4017,978,3039,14,53,8,6,0
64306,445,0,0,70,70,0,1,0,1,0,2
64428,53,23839,53,621,196,425,6,59,3,3,0
55123,64097,0,0,66,66,0,1,0,1,0,1
50491,443,45806,443,1304,878,426,12,78,7,5,0
6889,65473,0,0,143,143,0,1,0,1,0,1
50195,445,0,0,70,70,0,1,0,1,0,2
16980,53,16980,53,197,90,107,2,30,1,1,0
50661,443,13443,443,298067,6719,291348,307,17,98,209,0
49938,80,5232,80,1130,613,517,11,15,6,5,0
49691,443,33512,443,1183,659,524,13,56,7,6,0
42216,53,45740,53,199,94,105,2,30,1,1,0
56698,443,19362,443,106055,8460,97595,168,26,79,89,0
26869,53,19844,53,290,110,180,2,30,1,1,0
26900,27017,31665,27017,254,82,172,4,30,2,2,0
58230,64147,0,0,66,66,0,1,0,1,0,1
57470,1,59410,1,132,132,0,3,1199,3,0,0
49907,53,22787,53,199,102,97,2,30,1,1,0
50994,445,0,0,66,66,0,1,0,1,0,2
56538,443,45521,443,7760,1599,6161,23,80,13,10,0
42096,80,4456,80,1711,698,1013,14,17,6,8,0
49662,80,35388,80,6753,3135,3618,17,41,8,9,0
60438,53,64563,53,78,78,0,1,30,1,0,0
63595,51050,0,0,62,62,0,1,0,1,0,1
59731,443,62257,443,7236,827,6409,17,25,8,9,0
65402,53,33102,53,297,110,187,2,30,1,1,0
64865,53,49871,53,305,97,208,4,53,2,2,0
55372,53,41205,53,271,93,178,4,43,2,2,0
62678,57470,0,0,62,62,0,1,0,1,0,1
64122,53,40984,53,214,110,104,2,30,1,1,0
16059,22114,0,0,62,62,0,1,0,1,0,1
65049,53,22516,53,210,110,100,2,30,1,1,0
62361,445,0,0,66,66,0,1,0,1,0,2
63385,25174,0,0,66,66,0,1,0,1,0,1
59968,445,0,0,70,70,0,1,0,1,0,2
53548,443,53548,443,1386,751,635,15,181,8,7,0
49418,33071,57943,33071,78,78,0,1,30,1,0,0
44037,5223,40215,5223,5096,1030,4066,25,1751,9,16,0
5223,32965,0,0,220,220,0,1,0,1,0,1
60026,445,0,0,70,70,0,1,0,1,0,2
51900,80,40398,80,366,240,126,7,29,5,2,0
49342,53,2621,53,200,102,98,2,30,1,1,0
56459,53,48405,53,177,94,83,2,30,1,1,0
61465,22114,0,0,62,62,0,1,0,1,0,1
55716,445,0,0,70,70,0,1,0,1,0,2
60824,445,0,0,66,66,0,1,0,1,0,2
65504,443,39358,443,92275,4799,87476,107,16,43,64,0
56196,53,30280,53,214,110,104,2,29,1,1,0
55754,53,48167,53,177,94,83,2,29,1,1,0
54549,445,0,0,66,66,0,1,0,1,0,2
49586,443,54181,443,5879,870,5009,18,53,9,9,0
56327,53,49632,53,172,88,84,2,31,1,1,0
55324,445,0,0,70,70,0,1,0,1,0,2
57432,66,6875,66,70,70,0,2,8,2,0,0
51788,443,22272,443,3679,1712,1967,14,135,7,7,0
39094,443,50838,443,828718,43410,785308,1071,347,479,592,0
52776,80,21861,80,432,240,192,8,101,5,3,0
57870,445,0,0,66,66,0,1,0,1,0,2
63583,37965,0,0,62,62,0,1,0,1,0,1
60661,445,0,0,70,70,0,1,0,1,0,2
59097,2767,0,0,66,66,0,1,0,1,0,1
49254,53,47857,53,173,94,79,2,30,1,1,0
5588,5588,0,0,3354,1792,1562,46,194,23,23,0
65466,53,9762,53,298,102,196,4,39,2,2,0
53589,3389,53589,3389,3407,1518,1889,16,16,9,7,0
53176,445,0,0,70,70,0,1,0,1,0,2
65209,53,43414,53,585,206,379,6,79,3,3,0
56586,53,54269,53,177,94,83,2,30,1,1,0
56621,443,45506,443,7981,1961,6020,20,15,11,9,0
49885,445,0,0,70,70,0,1,0,1,0,2
57655,56205,0,0,66,66,0,1,0,1,0,1
53052,443,60187,443,8476,2030,6446,38,91,19,19,0
52294,445,0,0,66,66,0,1,0,1,0,2
49429,53,2752,53,194,102,92,2,30,1,1,0
50880,80,50880,80,163985,6578,157407,188,26,72,116,0
11859,64147,0,0,62,62,0,1,0,1,0,1
50460,443,12819,443,1346,918,428,10,31,6,4,0
52321,443,52321,443,6727,762,5965,15,25,8,7,0
56784,443,32848,443,7957,1968,5989,20,15,11,9,0
49843,445,0,0,66,66,0,1,0,1,0,2
60521,445,0,0,66,66,0,1,0,1,0,2
63734,28221,28610,28221,70,70,0,1,4,1,0,0
51500,443,12798,443,49843,3506,46337,77,16,39,38,0
57374,53,45450,53,733,86,647,2,31,1,1,0
53029,445,0,0,70,70,0,1,0,1,0,2
53730,443,15340,443,499,425,74,4,0,3,1,0
53147,26330,24592,26330,70,70,0,1,5,1,0,0
56260,53,30984,53,177,94,83,2,31,1,1,0
58774,443,43846,443,5167,700,4467,16,15,7,9,0
56188,445,0,0,70,70,0,1,0,1,0,2
49664,37965,0,0,66,66,0,1,0,1,0,1
52682,22114,0,0,66,66,0,1,0,1,0,1
50471,53,24459,53,168,78,90,2,30,1,1,0
55099,445,0,0,70,70,0,1,0,1,0,2
50638,80,16658,80,21873,2252,19621,27,21,10,17,0
55220,80,9309,80,1146,606,540,8,45,5,3,0
39742,62413,0,0,62,62,0,1,0,1,0,1
59018,443,37679,443,1786,172,1614,7,120,3,4,0
49367,51505,0,0,62,62,0,1,0,1,0,1
64346,51505,0,0,66,66,0,1,0,1,0,1
49364,53,61056,53,779,86,693,2,30,1,1,0
38100,53,30457,53,168,78,90,2,30,1,1,0
50534,53,50534,53,216,88,128,2,30,1,1,0
57613,445,0,0,70,70,0,1,0,1,0,2
34066,36829,0,0,146,146,0,1,0,1,0,1
64820,53,3092,53,195,102,93,2,30,1,1,0
52044,5824,26075,5824,70,70,0,1,5,1,0,0
50511,80,14463,80,318,192,126,6,25,4,2,0
56411,50584,0,0,62,62,0,1,0,1,0,1
56736,80,11534,80,194,128,66,4,25,3,1,0
45964,2225,0,0,60,60,0,1,0,1,0,1
56274,53,38501,53,177,94,83,2,30,1,1,0
58786,445,0,0,70,70,0,1,0,1,0,2
42354,443,60503,443,4181,998,3183,14,27,7,7,0
34772,15503,0,0,146,146,0,1,0,1,0,1
59723,443,10674,443,70,70,0,2,5,2,0,0
59314,443,58564,443,16862,7584,9278,97,8912,60,37,0
57850,3389,57850,3389,3347,1458,1889,15,18,8,7,0
51872,48108,27950,48108,70,70,0,1,5,1,0,0
3978,35440,0,0,62,62,0,1,0,1,0,1
33324,42873,0,0,62,62,0,1,0,1,0,1
49900,443,21992,443,6896,2139,4757,31,33,15,16,0
57898,445,0,0,66,66,0,1,0,1,0,2
51670,443,38480,443,1203,703,500,14,38,8,6,0
27005,27207,59346,27207,875,126,749,2,29,1,1,0
55715,53,57381,53,168,86,82,2,30,1,1,0
65221,53,62850,53,199,102,97,2,30,1,1,0
5222,7493,0,0,66,66,0,1,0,1,0,1
6881,47488,39178,47488,150,150,0,2,1200,2,0,0
50741,445,0,0,70,70,0,1,0,1,0,2
50973,445,0,0,66,66,0,1,0,1,0,2
54559,445,0,0,70,70,0,1,0,1,0,2
23769,53,45289,53,334,226,108,3,30,2,1,0
61026,445,0,0,66,66,0,1,0,1,0,2
56330,53,30393,53,198,101,97,2,31,1,1,0
4483,53,4483,53,213,87,126,2,31,1,1,0
59192,25174,0,0,66,66,0,1,0,1,0,1
24066,25174,0,0,146,146,0,1,0,1,0,1
59863,443,54710,443,12809,7765,5044,95,84,55,40,0
64160,53,55275,53,258,110,148,2,30,1,1,0
52042,80,17014,80,70,70,0,2,8,2,0,0
43394,53,50886,53,168,78,90,2,31,1,1,0
31521,57470,0,0,145,145,0,1,0,1,0,1
57326,53,16719,53,180,94,86,2,35,1,1,0
49690,50265,0,0,66,66,0,1,0,1,0,1
62914,11392,0,0,62,62,0,1,0,1,0,1
61738,2767,0,0,66,66,0,1,0,1,0,1
65052,53,39393,53,200,94,106,2,30,1,1,0
27005,50019,16642,50019,877,126,751,2,30,1,1,0
56037,53,29985,53,168,94,74,2,31,1,1,0
58034,443,53963,443,10192,3621,6571,24,36,12,12,0
52754,445,0,0,70,70,0,1,0,1,0,2
52135,445,0,0,66,66,0,1,0,1,0,2
60214,80,20902,80,8317,6126,2191,23,151,14,9,0
59340,80,59340,80,24437,12718,11719,41,15,16,25,0
56078,53,11255,53,168,86,82,2,30,1,1,0
54110,445,0,0,70,70,0,1,0,1,0,2
59736,445,0,0,70,70,0,1,0,1,0,2
45964,3111,0,0,60,60,0,1,0,1,0,1
54661,445,0,0,70,70,0,1,0,1,0,2
55632,445,0,0,70,70,0,1,0,1,0,2
49422,445,0,0,70,70,0,1,0,1,0,2
56072,445,0,0,70,70,0,1,0,1,0,2
55444,443,64554,443,13284,3562,9722,38,26,21,17,0
37826,23,0,0,60,60,0,1,0,1,0,1
50966,443,44457,443,7975,3304,4671,19,86,11,8,0
46518,44847,0,0,146,146,0,1,0,1,0,1
53964,443,1978,443,152,78,74,2,5,1,1,0
13084,53,13084,53,224,88,136,2,30,1,1,0
61589,21247,0,0,62,62,0,1,0,1,0,1
9377,56205,0,0,66,66,0,1,0,1,0,1
55616,56205,0,0,62,62,0,1,0,1,0,1
64019,445,0,0,66,66,0,1,0,1,0,2
56968,53,34326,53,762,97,665,2,30,1,1,0
49325,443,26750,443,5749,3401,2348,29,76,15,14,0
62210,445,0,0,70,70,0,1,0,1,0,2
55052,53,42687,53,198,102,96,2,30,1,1,0
57173,44847,0,0,62,62,0,1,0,1,0,1
60964,443,25466,443,2080,1376,704,17,30,9,8,0
56240,80,56240,80,101524,1673,99851,94,15,24,70,0
19245,64147,0,0,62,62,0,1,0,1,0,1
2691,64147,0,0,62,62,0,1,0,1,0,1
55396,26467,0,0,62,62,0,1,0,1,0,1
57837,443,41125,443,17236,1691,15545,19,146,5,14,0
46202,443,10482,443,19149,2846,16303,41,25,20,21,0
47894,443,64449,443,70,70,0,2,5,2,0,0
53105,445,0,0,70,70,0,1,0,1,0,2
3407,57866,0,0,66,66,0,1,0,1,0,1
57678,445,0,0,70,70,0,1,0,1,0,2
55469,445,0,0,70,70,0,1,0,1,0,2
6881,1707,0,0,146,146,0,1,0,1,0,1
52049,445,0,0,70,70,0,1,0,1,0,2
443,54507,0,0,82,82,0,1,0,1,0,1
57396,53,17014,53,212,102,110,2,30,1,1,0
59400,22114,0,0,62,62,0,1,0,1,0,1
62668,445,0,0,70,70,0,1,0,1,0,2
56533,443,15782,443,306579,19447,287132,335,105,129,206,0
53363,445,0,0,70,70,0,1,0,1,0,2
57035,53,5245,53,199,102,97,2,30,1,1,0
51609,37807,0,0,66,66,0,1,0,1,0,1
52578,445,0,0,70,70,0,1,0,1,0,2
44847,6881,11410,6881,502,150,352,2,1200,1,1,0
60742,20010,30698,20010,70,70,0,1,5,1,0,0
43308,443,4843,443,120,120,0,2,5,2,0,0
50629,443,10461,443,1048,1048,0,9,17,9,0,0
64088,53,9032,53,434,108,326,4,51,2,2,0
28470,80,28470,80,355544,12402,343142,378,26,134,244,0
60354,445,0,0,70,70,0,1,0,1,0,2
39807,443,25771,443,1684,1031,653,16,92,9,7,0
49418,27333,30238,27333,254,78,176,2,30,1,1,0
51852,445,0,0,70,70,0,1,0,1,0,2
57726,445,0,0,70,70,0,1,0,1,0,2
54161,443,65319,443,3157,1827,1330,23,15,11,12,0
49547,53,1649,53,186,95,91,2,31,1,1,0
52572,80,52572,80,1899,1310,589,12,48,6,6,0
51045,25174,0,0,66,66,0,1,0,1,0,1
56664,53,62279,53,774,101,673,2,31,1,1,0
45899,53,19119,53,168,78,90,2,30,1,1,0
49804,445,0,0,70,70,0,1,0,1,0,2
3914,37965,0,0,62,62,0,1,0,1,0,1
56445,53,19322,53,374,94,280,2,30,1,1,0
53879,445,0,0,66,66,0,1,0,1,0,2
55569,443,40443,443,8867,3511,5356,20,120,9,11,0
49493,445,0,0,70,70,0,1,0,1,0,2
39322,443,56925,443,7450,2503,4947,21,977,11,10,0
40731,2323,0,0,60,60,0,1,0,1,0,1
34809,57470,0,0,66,66,0,1,0,1,0,1
38565,51505,0,0,66,66,0,1,0,1,0,1
59107,25174,0,0,66,66,0,1,0,1,0,1
33149,5228,22043,5228,15651,3559,12092,63,6557,28,35,0
64041,53,58555,53,200,102,98,2,31,1,1,0
64978,53,11316,53,198,102,96,2,30,1,1,0
55835,443,26347,443,10087,3968,6119,32,271,17,15,0
52278,443,55005,443,7196,1791,5405,18,31,11,7,0
63743,46081,59158,46081,66,66,0,2,7,2,0,0
59798,443,49371,443,1887,1152,735,18,28,9,9,0
443,28417,0,0,82,82,0,1,0,1,0,1
56713,443,29098,443,373053,9725,363328,374,45,129,245,0
65218,53,11039,53,188,96,92,2,30,1,1,0
60427,80,8033,80,186,64,122,4,28,2,2,0
51854,80,4415,80,5438,1822,3616,17,38,11,6,0
49598,80,32079,80,372,192,180,7,41,4,3,0
54248,443,24435,443,499,425,74,4,0,3,1,0
50019,80,29484,80,814,674,140,6,28,4,2,0
11136,15503,0,0,62,62,0,1,0,1,0,1
56078,80,65466,80,2458,531,1927,11,75,6,5,0
62170,53,16163,53,234,94,140,2,29,1,1,0
64439,53,36419,53,359,134,225,2,30,1,1,0
60320,443,1355,443,4679,2232,2447,15,136,7,8,0
49730,53,58094,53,767,102,665,2,30,1,1,0
49921,443,56889,443,11831,1466,10365,24,135,11,13,0
49177,54532,0,0,60,60,0,1,0,1,0,1
57470,46772,63151,46772,528,528,0,9,1201,9,0,0
60044,445,0,0,66,66,0,1,0,1,0,2
58724,443,33462,443,10179,4285,5894,60,272,31,29,0
52537,443,37723,443,132577,21019,111558,348,236,142,206,0
13413,44847,0,0,62,62,0,1,0,1,0,1
51298,57470,0,0,66,66,0,1,0,1,0,1
24910,64147,0,0,66,66,0,1,0,1,0,1
51805,15298,11456,15298,70,70,0,2,8,2,0,0
64952,445,0,0,70,70,0,1,0,1,0,2
61369,64147,0,0,66,66,0,1,0,1,0,1
49886,443,58788,443,77867,2411,75456,82,87,27,55,0
64992,53,63333,53,170,87,83,2,30,1,1,0
50377,445,0,0,70,70,0,1,0,1,0,2
58638,5900,0,0,62,62,0,1,0,1,0,1
55141,53,13525,53,184,94,90,2,31,1,1,0
0,0,0,0,98,98,0,1,0,1,0,1
58605,443,40025,443,3301,1240,2061,14,135,7,7,0
54104,445,0,0,70,70,0,1,0,1,0,2
58906,80,61612,80,742,350,392,12,28,6,6,0
50584,56209,14402,56209,166,166,0,1,1200,1,0,0
49644,30188,0,0,66,66,0,1,0,1,0,1
49899,443,2357,443,26284,21857,4427,72,83,39,33,0
14489,25174,0,0,62,62,0,1,0,1,0,1
10552,25174,0,0,62,62,0,1,0,1,0,1
50404,8080,50404,8080,11938,4533,7405,33,98,20,13,0
63546,445,0,0,66,66,0,1,0,1,0,2
59638,445,0,0,70,70,0,1,0,1,0,2
55031,53,63225,53,756,95,661,2,31,1,1,0
49480,53,47457,53,184,94,90,2,30,1,1,0
61419,445,0,0,66,66,0,1,0,1,0,2
64298,443,45877,443,115035,5282,109753,128,120,44,84,0
52853,445,0,0,66,66,0,1,0,1,0,2
60010,443,42426,443,4795,2875,1920,19,143,10,9,0
40474,23117,0,0,62,62,0,1,0,1,0,1
49932,53,55615,53,195,102,93,2,30,1,1,0
32805,80,38439,80,7450,2372,5078,26,24,15,11,0
60130,80,60130,80,23216,1806,21410,40,28,20,20,0
58574,21247,0,0,66,66,0,1,0,1,0,1
58008,80,56721,80,2549,1595,954,21,75,11,10,0
56173,37807,0,0,62,62,0,1,0,1,0,1
51665,443,64553,443,8783,4321,4462,39,94,19,20,0
55088,445,0,0,70,70,0,1,0,1,0,2
65348,53,57406,53,214,102,112,2,31,1,1,0
52240,445,0,0,70,70,0,1,0,1,0,2
64360,445,0,0,70,70,0,1,0,1,0,2
53562,445,0,0,70,70,0,1,0,1,0,2
50596,53,57766,53,168,86,82,2,30,1,1,0
10126,57470,0,0,62,62,0,1,0,1,0,1
64776,50584,0,0,66,66,0,1,0,1,0,1
53585,43611,54963,43611,612,306,306,10,15,5,5,0
60899,25174,0,0,62,62,0,1,0,1,0,1
50674,35440,0,0,62,62,0,1,0,1,0,1
1024,57470,0,0,72,72,0,1,0,1,0,1
49842,80,44778,80,70094,1629,68465,63,89,16,47,0
55308,445,0,0,70,70,0,1,0,1,0,1
64426,53,39298,53,669,200,469,6,49,3,3,0
65343,53,9995,53,197,102,95,2,30,1,1,0
54131,57866,0,0,66,66,0,1,0,1,0,1
49313,53,30091,53,199,102,97,2,30,1,1,0
62327,443,62327,443,1210,637,573,14,51,7,7,0
64160,445,0,0,66,66,0,1,0,1,0,2
31683,35440,0,0,146,146,0,1,0,1,0,1
54816,445,0,0,70,70,0,1,0,1,0,2
53840,443,34687,443,499,425,74,4,0,3,1,0
57418,443,57418,443,4736,1759,2977,20,26,11,9,0
57590,80,57590,80,1165239,13055,1152184,977,149,193,784,0
55912,53,3506,53,184,94,90,2,30,1,1,0
26497,64147,0,0,66,66,0,1,0,1,0,1
57097,443,3043,443,3578432,133577,3444855,4291,426,1634,2657,0
57987,56125,0,0,90,90,0,1,0,1,0,1
56375,53,53548,53,184,102,82,2,30,1,1,0
49206,53,61280,53,174,89,85,2,31,1,1,0
55530,445,0,0,70,70,0,1,0,1,0,2
55991,53,9133,53,199,102,97,2,30,1,1,0
52236,15313,26526,15313,70,70,0,1,5,1,0,0
59400,22114,0,0,66,66,0,1,0,1,0,1
60970,20541,0,0,66,66,0,1,0,1,0,1
25101,50584,0,0,62,62,0,1,0,1,0,1
65231,53,2677,53,200,102,98,2,30,1,1,0
53237,80,8152,80,194,128,66,4,55,3,1,0
63849,16632,35962,16632,66,66,0,2,8,2,0,0
26900,27017,1081,27017,422,164,258,6,29,3,3,0
10016,443,37717,443,6575,1263,5312,22,315,12,10,0
11076,53,11076,53,832,106,726,2,30,1,1,0
64135,53,37160,53,196,102,94,2,30,1,1,0
1038,37965,0,0,62,62,0,1,0,1,0,1
14309,56205,0,0,146,146,0,1,0,1,0,1
49388,53,27609,53,215,102,113,2,30,1,1,0
50583,80,64336,80,630930,27504,603426,812,74,381,431,0
49237,53,49518,53,216,110,106,2,30,1,1,0
57867,27019,40046,27019,2338,634,1704,10,30,6,4,0
49577,53,58264,53,389,134,255,2,29,1,1,0
54278,53,0,0,82,82,0,1,30,1,0,0
49160,445,0,0,70,70,0,1,0,1,0,2
51862,27758,53526,27758,70,70,0,1,5,1,0,0
48024,443,44709,443,9194,1066,8128,21,27,12,9,0
11688,23718,0,0,62,62,0,1,0,1,0,1
64661,53,48759,53,216,102,114,2,30,1,1,0
50767,57470,0,0,66,66,0,1,0,1,0,1
55359,445,0,0,70,70,0,1,0,1,0,2
57409,53,41368,53,232,94,138,2,30,1,1,0
51897,57057,43684,57057,70,70,0,1,5,1,0,0
46883,443,30067,443,40443,5300,35143,88,134,38,50,0
55720,51610,5460,51610,70,70,0,1,5,1,0,0
52215,445,0,0,66,66,0,1,0,1,0,1
56250,36237,0,0,66,66,0,1,0,1,0,1
57460,445,0,0,66,66,0,1,0,1,0,2
50237,443,44543,443,2994,1521,1473,15,83,9,6,0
51244,14984,0,0,100,100,0,1,0,1,0,1
49875,445,0,0,70,70,0,1,0,1,0,2
44847,46972,13667,46972,150,150,0,1,1200,1,0,0
41004,5000,0,0,60,60,0,1,0,1,0,1
56472,80,20215,80,45108,2309,42799,60,134,28,32,0
51964,80,61928,80,306,120,186,6,25,3,3,0
52459,5555,0,0,60,60,0,1,0,1,0,1
57228,8525,57228,8525,138,78,60,2,5,1,1,0
60432,445,0,0,70,70,0,1,0,1,0,2
49502,44847,0,0,66,66,0,1,0,1,0,1
50442,80,8641,80,378,192,186,7,19,4,3,0
55828,53,17599,53,181,94,87,2,30,1,1,0
65080,445,0,0,70,70,0,1,0,1,0,2
49863,443,52855,443,7280,1441,5839,17,89,9,8,0
39098,443,35056,443,5519,1493,4026,20,121,9,11,0
27005,27016,28994,27016,880,126,754,2,30,1,1,0
53110,445,0,0,66,66,0,1,0,1,0,2
56397,26467,0,0,66,66,0,1,0,1,0,1
6881,13929,23344,13929,502,150,352,2,1200,1,1,0
44514,443,59227,443,448741,15805,432936,491,109,181,310,0
50490,80,51282,80,318,192,126,6,25,4,2,0
2815,62413,0,0,66,66,0,1,0,1,0,1
50728,27029,42888,27029,269,78,191,2,31,1,1,0
26531,25174,0,0,62,62,0,1,0,1,0,1
18461,19473,0,0,66,66,0,1,0,1,0,1
56717,53,57782,53,183,94,89,2,29,1,1,0
58638,5900,0,0,62,62,0,1,0,1,0,1
49940,53,16387,53,257,110,147,2,29,1,1,0
44774,22114,0,0,62,62,0,1,0,1,0,1
53818,15337,26034,15337,164,70,94,2,4,1,1,0
58207,443,31795,443,10209,2530,7679,33,223,17,16,0
18398,21247,0,0,66,66,0,1,0,1,0,1
56612,53,28216,53,178,94,84,2,30,1,1,0
51090,80,51090,80,19837,2061,17776,30,21,14,16,0
52151,53,52151,53,198,89,109,2,31,1,1,0
52759,445,0,0,70,70,0,1,0,1,0,2
52217,22114,0,0,62,62,0,1,0,1,0,1
50231,445,0,0,70,70,0,1,0,1,0,2
53225,443,9099,443,6597,1798,4799,28,80,12,16,0
43381,443,3948,443,9551,2173,7378,33,25,17,16,0
62442,445,0,0,66,66,0,1,0,1,0,2
62729,445,0,0,66,66,0,1,0,1,0,2
19473,12345,64156,12345,478,149,329,2,1200,1,1,0
58799,30188,0,0,66,66,0,1,0,1,0,1
49634,53,57122,53,718,94,624,2,30,1,1,0
9158,443,59645,443,5727,491,5236,14,15,7,7,0
50237,53,33615,53,183,94,89,2,30,1,1,0
58638,5900,0,0,62,62,0,1,0,1,0,1
41476,53,41476,53,235,90,145,2,33,1,1,0
52208,47300,20128,47300,70,70,0,2,9,2,0,0
34671,443,52492,443,8904,1058,7846,18,31,9,9,0
56380,53,55619,53,170,87,83,2,31,1,1,0
63708,445,0,0,70,70,0,1,0,1,0,2
20724,19750,0,0,78,78,0,1,0,1,0,1
52973,57470,0,0,74,74,0,1,0,1,0,1
56202,15503,0,0,146,146,0,1,0,1,0,1
44783,443,27769,443,4173582,66515,4107067,3494,129,510,2984,0
48756,80,48756,80,560,264,296,9,44,5,4,0
50252,445,0,0,66,66,0,1,0,1,0,2
53843,443,32315,443,499,425,74,4,0,3,1,0
53621,445,0,0,70,70,0,1,0,1,0,2
34111,53,34111,53,213,87,126,2,30,1,1,0
48305,443,59833,443,572565,17274,555291,546,147,124,422,0
61400,64147,0,0,66,66,0,1,0,1,0,1
60806,51050,0,0,62,62,0,1,0,1,0,1
50671,445,0,0,66,66,0,1,0,1,0,2
38643,443,11641,443,1468,893,575,15,62,8,7,0
64335,35440,0,0,62,62,0,1,0,1,0,1
26921,37965,0,0,62,62,0,1,0,1,0,1
53090,59356,0,0,66,66,0,1,0,1,0,1
49492,53,41002,53,199,102,97,2,31,1,1,0
64755,31573,0,0,66,66,0,1,0,1,0,1
65316,80,11827,80,2430,531,1899,10,133,6,4,0
64758,53,44548,53,311,102,209,2,30,1,1,0
58297,445,0,0,70,70,0,1,0,1,0,2
52802,56205,0,0,62,62,0,1,0,1,0,1
7844,22114,0,0,66,66,0,1,0,1,0,1
59008,443,16532,443,10214,2669,7545,30,170,14,16,0
64593,53,46361,53,258,102,156,2,30,1,1,0
64519,53,20237,53,277,94,183,4,60,2,2,0
27761,53,27761,53,832,106,726,2,30,1,1,0
45019,53,52189,53,168,78,90,2,30,1,1,0
60155,23718,0,0,66,66,0,1,0,1,0,1
56536,443,5996,443,6044,3444,2600,49,501,25,24,0
64381,445,0,0,70,70,0,1,0,1,0,2
37568,443,50535,443,214,140,74,4,15,3,1,0
64167,53,3978,53,211,102,109,2,29,1,1,0
57892,445,0,0,70,70,0,1,0,1,0,2
55968,56205,0,0,66,66,0,1,0,1,0,1
57137,53,36481,53,279,96,183,4,31,2,2,0
65343,53,12324,53,194,99,95,2,30,1,1,0
55562,50584,0,0,66,66,0,1,0,1,0,1
60764,445,0,0,66,66,0,1,0,1,0,2
30188,23453,55935,23453,502,150,352,2,1200,1,1,0
43688,22114,0,0,66,66,0,1,0,1,0,1
65165,445,0,0,66,66,0,1,0,1,0,2
53447,44847,0,0,66,66,0,1,0,1,0,1
38861,443,38861,443,90303,5838,84465,140,103,68,72,0
38383,51221,0,0,66,66,0,1,0,1,0,1
50917,445,0,0,70,70,0,1,0,1,0,2
60217,80,16783,80,4050,2838,1212,14,16,7,7,0
59599,62413,0,0,62,62,0,1,0,1,0,1
50191,53,9113,53,734,94,640,2,30,1,1,0
50799,445,0,0,66,66,0,1,0,1,0,2
60815,443,60815,443,1320,685,635,14,181,7,7,0
34183,443,44472,443,10459,2529,7930,31,375,13,18,0
38474,443,30004,443,53562,2314,51248,64,31,24,40,0
65126,443,41319,443,958,384,574,14,34,7,7,0
59845,44847,0,0,66,66,0,1,0,1,0,1
55219,53,51728,53,181,94,87,2,32,1,1,0
37875,55108,0,0,148,148,0,1,0,1,0,1
60780,28080,48359,28080,70,70,0,1,5,1,0,0
59942,80,31955,80,2241,1549,692,9,15,5,4,0
40480,30317,0,0,146,146,0,1,0,1,0,1
443,49988,0,0,82,82,0,1,0,1,0,1
53124,443,9153,443,64407,55712,8695,92,364,58,34,0
27321,25174,0,0,146,146,0,1,0,1,0,1
65204,53,50425,53,183,94,89,2,29,1,1,0
55580,53,22194,53,788,108,680,2,30,1,1,0
30129,37965,0,0,72,72,0,1,0,1,0,1
13285,29892,0,0,145,145,0,1,0,1,0,1
50655,26467,0,0,66,66,0,1,0,1,0,1
1462,41599,5098,41599,70,70,0,1,5,1,0,0
62739,445,0,0,70,70,0,1,0,1,0,2
55251,445,0,0,70,70,0,1,0,1,0,2
55602,53,61633,53,711,87,624,2,30,1,1,0
36663,22114,0,0,62,62,0,1,0,1,0,1
64192,445,0,0,66,66,0,1,0,1,0,2
61563,37807,0,0,66,66,0,1,0,1,0,1
50113,51505,0,0,66,66,0,1,0,1,0,1
59680,445,0,0,70,70,0,1,0,1,0,2
26900,27017,41644,27017,422,164,258,6,30,3,3,0
32486,443,32486,443,5497,2520,2977,20,16,11,9,0
56745,53,50042,53,900,110,790,2,30,1,1,0
55727,53,48303,53,177,94,83,2,30,1,1,0
28580,64147,0,0,62,62,0,1,0,1,0,1
50106,30317,0,0,66,66,0,1,0,1,0,1
65398,53,49816,53,214,110,104,2,30,1,1,0
62333,443,30059,443,3170,1556,1614,7,121,3,4,0
63438,445,0,0,70,70,0,1,0,1,0,2
58700,445,0,0,66,66,0,1,0,1,0,2
55039,445,0,0,70,70,0,1,0,1,0,2
53177,8595,28264,8595,70,70,0,2,9,2,0,0
65446,53,21925,53,210,110,100,2,30,1,1,0
2049,32480,0,0,62,62,0,1,0,1,0,1
63938,26204,59342,26204,70,70,0,1,4,1,0,0
42298,40036,28327,40036,205,83,122,4,29,2,2,0
58666,53,58666,53,235,90,145,2,32,1,1,0
51356,22114,0,0,66,66,0,1,0,1,0,1
31130,30188,0,0,66,66,0,1,0,1,0,1
57470,32251,57534,32251,132,132,0,3,1199,3,0,0
49671,53,34167,53,242,110,132,2,30,1,1,0
58826,445,0,0,70,70,0,1,0,1,0,2
56112,53,63692,53,199,102,97,2,29,1,1,0
57430,53,16018,53,200,102,98,2,29,1,1,0
61899,445,0,0,70,70,0,1,0,1,0,2
58638,5900,0,0,62,62,0,1,0,1,0,1
40216,50265,0,0,62,62,0,1,0,1,0,1
43029,443,37384,443,6053,1321,4732,19,980,9,10,0
38885,21247,0,0,62,62,0,1,0,1,0,1
45627,443,47069,443,7092,1883,5209,21,21,12,9,0
61990,445,0,0,70,70,0,1,0,1,0,2
50025,53,43960,53,536,120,416,4,59,2,2,0
55068,445,0,0,70,70,0,1,0,1,0,2
53171,445,0,0,66,66,0,1,0,1,0,2
62910,993,51747,993,9108,4045,5063,84,72,39,45,0
53016,443,53016,443,4787,1880,2907,19,27,11,8,0
64799,445,0,0,70,70,0,1,0,1,0,2
62524,445,0,0,70,70,0,1,0,1,0,2
26800,22,0,0,60,60,0,1,0,1,0,1
34152,11119,0,0,148,148,0,1,0,1,0,1
36307,53,54070,53,200,86,114,2,30,1,1,0
65264,445,0,0,66,66,0,1,0,1,0,2
12471,31573,0,0,62,62,0,1,0,1,0,1
51071,445,0,0,66,66,0,1,0,1,0,2
51751,445,0,0,70,70,0,1,0,1,0,2
47457,41615,0,0,145,145,0,1,0,1,0,1
48287,443,53104,443,416,210,206,7,96,4,3,0
57706,445,0,0,70,70,0,1,0,1,0,2
64534,53,43156,53,212,108,104,2,31,1,1,0
7664,2149,0,0,66,66,0,1,0,1,0,1
61474,443,20361,443,114674,4457,110217,127,48,46,81,0
37998,49152,32246,49152,156,156,0,3,8,3,0,0
13699,53,13699,53,194,87,107,2,30,1,1,0
62514,37807,0,0,66,66,0,1,0,1,0,1
10265,64147,0,0,66,66,0,1,0,1,0,1
50313,53,50313,53,202,91,111,2,30,1,1,0
443,54507,0,0,82,82,0,1,0,1,0,1
61448,445,0,0,66,66,0,1,0,1,0,2
39054,443,15031,443,7772,4119,3653,31,17,16,15,0
50518,53,60220,53,802,104,698,2,31,1,1,0
51398,53,51398,53,197,90,107,2,30,1,1,0
6778,50584,0,0,66,66,0,1,0,1,0,1
49907,445,0,0,70,70,0,1,0,1,0,2
60875,443,60875,443,1092,645,447,10,34,6,4,0
56824,443,13725,443,18356,13354,5002,47,34,29,18,0
19068,37965,0,0,62,62,0,1,0,1,0,1
57210,8525,57210,8525,138,78,60,2,5,1,1,0
55416,445,0,0,70,70,0,1,0,1,0,2
54692,445,0,0,70,70,0,1,0,1,0,2
45964,5333,0,0,60,60,0,1,0,1,0,1
48783,53,0,0,86,86,0,1,30,1,0,0
43888,64147,0,0,62,62,0,1,0,1,0,1
52153,12673,40206,12673,316,136,180,6,6,3,3,0
45472,8168,0,0,62,62,0,1,0,1,0,1
55111,39004,0,0,66,66,0,1,0,1,0,1
58060,445,0,0,66,66,0,1,0,1,0,2
63772,445,0,0,66,66,0,1,0,1,0,2
58398,44847,0,0,62,62,0,1,0,1,0,1
57093,26467,0,0,62,62,0,1,0,1,0,1
55808,445,0,0,66,66,0,1,0,1,0,2
55180,53,29558,53,209,110,99,2,30,1,1,0
48219,55442,0,0,62,62,0,1,0,1,0,1
25222,37965,0,0,62,62,0,1,0,1,0,1
58638,5900,0,0,62,62,0,1,0,1,0,1
49449,53,12310,53,216,110,106,2,30,1,1,0
55487,53,40739,53,199,102,97,2,30,1,1,0
60660,445,0,0,70,70,0,1,0,1,0,2
55639,53,59060,53,196,102,94,2,30,1,1,0
58638,5900,0,0,62,62,0,1,0,1,0,1
57539,445,0,0,66,66,0,1,0,1,0,2
54945,445,0,0,70,70,0,1,0,1,0,2
1171,18375,0,0,146,146,0,1,0,1,0,1
54518,25174,0,0,62,62,0,1,0,1,0,1
25469,57470,0,0,62,62,0,1,0,1,0,1
53885,50379,49864,50379,492,306,186,8,15,5,3,0
59227,11392,0,0,62,62,0,1,0,1,0,1
62081,445,0,0,70,70,0,1,0,1,0,2
49860,53,63227,53,184,102,82,2,30,1,1,0
49315,53,15991,53,94,94,0,1,30,1,0,0
52658,445,0,0,70,70,0,1,0,1,0,2
52921,443,13055,443,5581,1388,4193,19,15,9,10,0
44314,443,36123,443,1268867,60489,1208378,1558,141,557,1001,0
65030,53,52927,53,785,110,675,2,30,1,1,0
55295,53,52273,53,779,86,693,2,30,1,1,0
64279,23718,0,0,62,62,0,1,0,1,0,1
57424,53,59355,53,197,102,95,2,29,1,1,0
56586,53,17774,53,177,94,83,2,29,1,1,0
64730,53,52714,53,1152,86,1066,2,29,1,1,0
59541,445,0,0,70,70,0,1,0,1,0,2
58911,443,55607,443,5168,700,4468,16,16,7,9,0
51703,3010,58034,3010,70,70,0,1,5,1,0,0
55630,53,58025,53,194,99,95,2,31,1,1,0
49234,80,29641,80,1103248,36317,1066931,1001,162,276,725,0
50265,5554,7404,5554,472,150,322,2,1200,1,1,0
49630,22,49630,22,295,126,169,4,1,2,2,1
49767,53,4502,53,177,94,83,2,30,1,1,0
50512,445,0,0,70,70,0,1,0,1,0,2
51641,445,0,0,66,66,0,1,0,1,0,2
9246,35440,0,0,66,66,0,1,0,1,0,1
62410,445,0,0,66,66,0,1,0,1,0,2
65075,53,3072,53,278,100,178,4,31,2,2,0
49632,53,3027,53,199,102,97,2,31,1,1,0
56670,443,55495,443,8308,3589,4719,25,19,15,10,0
62911,993,63006,993,8753,4199,4554,76,54,41,35,0
33227,443,20860,443,8888,1757,7131,26,174,15,11,0
62541,445,0,0,70,70,0,1,0,1,0,2
57431,53,12541,53,181,94,87,2,29,1,1,0
49201,53,35149,53,200,102,98,2,30,1,1,0
55963,443,55963,443,8882,1866,7016,24,148,13,11,0
50919,443,16242,443,5962,1621,4341,16,75,9,7,0
36561,2767,0,0,62,62,0,1,0,1,0,1
57411,443,31872,443,214,140,74,4,15,3,1,0
53717,445,0,0,70,70,0,1,0,1,0,2
49894,443,43523,443,5597,1462,4135,21,86,11,10,0
54346,44847,0,0,66,66,0,1,0,1,0,1
56423,80,12556,80,33937,628,33309,31,104,6,25,0
50445,445,0,0,70,70,0,1,0,1,0,2
51407,443,57078,443,202,70,132,3,11,1,2,0
16387,44427,0,0,60,60,0,1,0,1,0,1
53779,51505,0,0,66,66,0,1,0,1,0,1
34750,80,47643,80,111678,5254,106424,150,240,71,79,0
49963,53,58470,53,564,191,373,6,62,3,3,0
53992,445,0,0,66,66,0,1,0,1,0,2
58726,443,45284,443,39202,21598,17604,72,20,39,33,0
54419,445,0,0,70,70,0,1,0,1,0,2
58149,443,24568,443,153,93,60,2,5,1,1,0
52668,51221,0,0,66,66,0,1,0,1,0,1
443,10120,443,10120,64,64,0,1,5,1,0,0
28139,22114,0,0,62,62,0,1,0,1,0,1
54590,443,20540,443,12094,4159,7935,21,135,10,11,0
60232,443,3016,443,1868,1229,639,18,151,11,7,0
62738,443,30177,443,126,60,66,3,10,2,1,0
60815,445,0,0,70,70,0,1,0,1,0,2
2348,3389,2348,3389,4145,1976,2169,22,19,13,9,0
51989,80,9142,80,1344,899,445,8,15,6,2,0
55600,22,0,0,60,60,0,1,0,1,0,1
57589,445,0,0,66,66,0,1,0,1,0,2
49731,443,10101,443,4484,1063,3421,15,25,7,8,0
57289,31573,0,0,66,66,0,1,0,1,0,1
56803,53,10846,53,195,102,93,2,30,1,1,0
43597,443,44647,443,47048,9293,37755,63,412,28,35,0
58250,35440,0,0,66,66,0,1,0,1,0,1
53642,39344,30760,39344,612,306,306,10,15,5,5,0
10004,57470,0,0,145,145,0,1,0,1,0,1
45169,443,45169,443,282,140,142,5,152,3,2,0
53459,37807,0,0,62,62,0,1,0,1,0,1
51792,80,21440,80,3840,2265,1575,16,47,10,6,0
58248,445,0,0,70,70,0,1,0,1,0,2
54666,123,26890,123,184,94,90,2,31,1,1,0
20,17095,0,0,554,554,0,1,0,1,0,1
64001,445,0,0,70,70,0,1,0,1,0,2
33948,15503,0,0,146,146,0,1,0,1,0,1
56940,443,47279,443,5147,2613,2534,19,137,10,9,0
54138,445,0,0,66,66,0,1,0,1,0,2
52120,42751,65345,42751,70,70,0,2,8,2,0,0
57761,15503,0,0,62,62,0,1,0,1,0,1
65013,53,26292,53,473,105,368,4,30,2,2,0
60544,445,0,0,70,70,0,1,0,1,0,2
56935,53,38764,53,179,94,85,2,30,1,1,0
49641,443,54383,443,5776,1079,4697,15,53,8,7,0
58007,445,0,0,66,66,0,1,0,1,0,2
56841,443,47510,443,156805,44621,112184,289,215,137,152,0
50577,80,17204,80,2350,896,1454,13,25,7,6,0
64075,53,49394,53,352,86,266,4,36,2,2,0
55269,53,18249,53,102,102,0,1,30,1,0,0
57090,51505,0,0,66,66,0,1,0,1,0,1
58638,5900,0,0,62,62,0,1,0,1,0,1
65384,57470,0,0,66,66,0,1,0,1,0,1
53663,17904,16406,17904,320,140,180,6,7,3,3,0
9146,443,17435,443,10056,2310,7746,27,36,14,13,0
62007,445,0,0,70,70,0,1,0,1,0,2
41390,443,29292,443,7240,2035,5205,25,316,12,13,0
2890,53,28510,53,78,78,0,1,30,1,0,0
52111,44847,0,0,62,62,0,1,0,1,0,1
55617,53,46139,53,214,110,104,2,30,1,1,0
35356,53,0,0,82,82,0,1,30,1,0,0
56884,53,35715,53,199,102,97,2,30,1,1,0
26900,27017,11839,27017,422,164,258,6,30,3,3,0
52691,445,0,0,70,70,0,1,0,1,0,2
30960,45684,7454,45684,330,330,0,6,3609,6,0,0
54352,443,38196,443,12594,5098,7496,32,34,17,15,0
50584,15926,55734,15926,1377,300,1077,6,1200,3,3,0
64095,53,63030,53,177,94,83,2,29,1,1,0
57282,445,0,0,70,70,0,1,0,1,0,2
30599,46824,0,0,66,66,0,1,0,1,0,1
56909,50584,0,0,62,62,0,1,0,1,0,1
27005,27001,35440,27001,887,126,761,2,31,1,1,0
64489,445,0,0,70,70,0,1,0,1,0,2
27824,51505,0,0,146,146,0,1,0,1,0,1
56608,443,64637,443,8034,2014,6020,20,15,11,9,0
59569,445,0,0,70,70,0,1,0,1,0,2
61885,445,0,0,66,66,0,1,0,1,0,2
60941,25174,0,0,62,62,0,1,0,1,0,1
54883,445,0,0,70,70,0,1,0,1,0,2
34112,44847,0,0,66,66,0,1,0,1,0,1
51803,33973,12809,33973,70,70,0,2,8,2,0,0
60311,445,0,0,70,70,0,1,0,1,0,2
1081,43109,0,0,146,146,0,1,0,1,0,1
39586,22114,0,0,66,66,0,1,0,1,0,1
57331,53,57928,53,178,94,84,2,29,1,1,0
49575,53,46030,53,775,102,673,2,29,1,1,0
60875,443,9147,443,45373,35377,9996,88,72,48,40,0
64303,53,57962,53,177,94,83,2,29,1,1,0
56694,443,1542,443,8058,2038,6020,20,15,11,9,0
56489,443,54085,443,75930,4291,71639,90,120,32,58,0
57470,40794,36042,40794,132,132,0,3,1199,3,0,0
58343,23718,0,0,66,66,0,1,0,1,0,1
57470,6882,62846,6882,528,528,0,9,1200,9,0,0
55257,53,9976,53,749,89,660,2,30,1,1,0
55693,443,55693,443,23467,2707,20760,45,80,21,24,0
48817,1722,48817,1722,158,158,0,1,1200,1,0,0
35247,80,59441,80,1614,1300,314,10,15,5,5,0
22409,55442,0,0,74,74,0,1,0,1,0,1
49765,445,0,0,66,66,0,1,0,1,0,2
50127,443,64951,443,31982,9936,22046,61,16,33,28,0
50313,80,63654,80,736,670,66,6,15,5,1,0
58638,5900,0,0,62,62,0,1,0,1,0,1
27005,27014,42282,27014,882,126,756,2,30,1,1,0
40836,443,10613,443,9524,3934,5590,20,135,10,10,0
65373,445,0,0,66,66,0,1,0,1,0,2
50612,445,0,0,70,70,0,1,0,1,0,2
49429,53,19123,53,204,104,100,2,31,1,1,0
35080,80,13868,80,71843,2833,69010,83,16,36,47,0
5223,1210,0,0,66,66,0,1,0,1,0,1
65061,53,34099,53,297,101,196,4,31,2,2,0
49567,53,36957,53,184,102,82,2,29,1,1,0
58091,51505,0,0,66,66,0,1,0,1,0,1
58876,57470,0,0,66,66,0,1,0,1,0,1
51446,3033,0,0,100,100,0,1,0,1,0,1
54588,445,0,0,70,70,0,1,0,1,0,2
45196,443,61474,443,6357,1546,4811,26,17,14,12,0
50245,44847,0,0,62,62,0,1,0,1,0,1
37657,443,62208,443,8926,2746,6180,27,46,16,11,0
39715,443,41417,443,65276,4554,60722,82,217,34,48,0
51782,10637,45950,10637,66,66,0,1,5,1,0,0
55654,445,0,0,70,70,0,1,0,1,0,2
58023,445,0,0,70,70,0,1,0,1,0,2
55808,53,45901,53,738,86,652,2,31,1,1,0
50089,53,38993,53,752,93,659,2,31,1,1,0
56888,443,59232,443,10384,2236,8148,28,186,15,13,0
46720,53,0,0,82,82,0,1,30,1,0,0
57723,45129,0,0,148,148,0,1,0,1,0,1
52034,48856,38527,48856,66,66,0,1,5,1,0,0
37608,443,17459,443,499,425,74,4,0,3,1,0
62625,445,0,0,70,70,0,1,0,1,0,2
60133,1,0,0,66,66,0,1,0,1,0,1
26900,27017,43419,27017,422,164,258,6,30,3,3,0
51972,80,28549,80,7001170,112187,6888983,6101,29,1546,4555,0
56262,53,24636,53,177,94,83,2,30,1,1,0
57807,443,57807,443,4434,1527,2907,19,29,11,8,0
11344,42873,0,0,62,62,0,1,0,1,0,1
55600,80,5814,80,70,70,0,1,5,1,0,0
58869,443,7982,443,4052,2588,1464,18,16,9,9,0
39500,443,7473,443,6517,2048,4469,21,90,12,9,0
55883,445,0,0,70,70,0,1,0,1,0,2
56462,37965,0,0,66,66,0,1,0,1,0,1
59209,25174,0,0,62,62,0,1,0,1,0,1
63799,13835,2064,13835,66,66,0,2,8,2,0,0
45941,23386,0,0,60,60,0,1,0,1,0,1
61143,8080,0,0,60,60,0,1,0,1,0,1
50316,53,39379,53,193,102,91,2,30,1,1,0
63236,443,2158,443,4945,2798,2147,27,141,14,13,0
52690,445,0,0,70,70,0,1,0,1,0,2
48931,53,2346,53,168,78,90,2,30,1,1,0
46260,80,59881,80,3459,1620,1839,16,186,10,6,0
57263,443,6071,443,7748,3859,3889,20,148,10,10,0
0,0,0,0,156,156,0,2,0,2,0,0
65238,53,22542,53,168,86,82,2,29,1,1,0
52520,443,9446,443,4463,1215,3248,16,121,8,8,0
58739,445,0,0,66,66,0,1,0,1,0,2
1040,6004,0,0,72,72,0,1,0,1,0,1
60350,51505,0,0,66,66,0,1,0,1,0,1
57477,445,0,0,70,70,0,1,0,1,0,2
56803,53,37278,53,183,94,89,2,29,1,1,0
50365,443,19679,443,712,374,338,11,28,6,5,0
55130,27046,9695,27046,1798,1386,412,8,29,4,4,0
52459,33890,0,0,60,60,0,1,0,1,0,1
65389,445,0,0,66,66,0,1,0,1,0,2
49847,80,28928,80,4135,2587,1548,10,89,7,3,0
49806,443,11715,443,37255,2202,35053,46,125,17,29,0
63877,51413,26586,51413,564,382,182,9,18,6,3,0
55620,53,14188,53,170,87,83,2,30,1,1,0
51653,443,13431,443,6660,1542,5118,21,305,11,10,0
53819,443,53819,443,1386,751,635,15,180,8,7,0
0,0,0,0,244,244,0,2,0,2,0,0
50140,53,26490,53,209,110,99,2,30,1,1,0
27147,22114,0,0,62,62,0,1,0,1,0,1
51978,57496,57419,57496,70,70,0,1,5,1,0,0
2923,57470,0,0,66,66,0,1,0,1,0,1
56614,25174,0,0,66,66,0,1,0,1,0,1
38693,443,23499,443,16959,8920,8039,46,33,24,22,0
64712,445,0,0,70,70,0,1,0,1,0,2
61148,37965,0,0,66,66,0,1,0,1,0,1
26884,57866,0,0,74,74,0,1,0,1,0,1
51157,443,53993,443,5378,1423,3955,19,22,11,8,0
52407,445,0,0,66,66,0,1,0,1,0,2
28839,30188,0,0,62,62,0,1,0,1,0,1
53010,443,23300,443,31660,3248,28412,58,93,23,35,0
55788,53,26476,53,231,110,121,2,30,1,1,0
51725,56205,0,0,62,62,0,1,0,1,0,1
57470,6881,14174,6881,490,163,327,2,1200,1,1,0
61337,443,54439,443,31111,6287,24824,62,247,25,37,0
60037,443,12655,443,6194,1289,4905,23,66,12,11,0
55280,53,18692,53,258,110,148,2,30,1,1,0
49843,53,31745,53,186,95,91,2,31,1,1,0
57418,53,27035,53,758,96,662,2,31,1,1,0
53909,20545,63910,20545,612,366,246,10,19,6,4,0
65319,53,30506,53,285,103,182,4,44,2,2,0
55157,7302,0,0,66,66,0,1,0,1,0,1
58255,50584,0,0,62,62,0,1,0,1,0,1
3585,64147,0,0,62,62,0,1,0,1,0,1
10390,26467,0,0,66,66,0,1,0,1,0,1
50513,445,0,0,70,70,0,1,0,1,0,2
28435,23,0,0,60,60,0,1,0,1,0,1
58868,445,0,0,66,66,0,1,0,1,0,2
55032,53,0,0,288,79,209,2,31,1,1,0
64946,53,40387,53,202,95,107,2,31,1,1,0
40204,40016,39697,40016,140,78,62,2,30,1,1,0
21459,23,0,0,60,60,0,1,0,1,0,1
61408,443,17703,443,9492,3543,5949,49,117,25,24,0
53031,443,28915,443,2399,1799,600,15,120,10,5,0
63516,445,0,0,70,70,0,1,0,1,0,2
49234,8080,49234,8080,2604,848,1756,13,136,7,6,0
26447,80,26447,80,12599,1479,11120,28,16,15,13,0
57750,37965,0,0,146,146,0,1,0,1,0,1
49564,53,7876,53,168,78,90,2,30,1,1,0
51075,80,51075,80,450,246,204,8,26,5,3,0
50591,80,63944,80,318,192,126,6,25,4,2,0
63178,445,0,0,66,66,0,1,0,1,0,2
50942,445,0,0,70,70,0,1,0,1,0,2
51940,26399,39116,26399,70,70,0,2,8,2,0,0
62029,36237,0,0,66,66,0,1,0,1,0,1
55864,445,0,0,66,66,0,1,0,1,0,2
65161,53,65161,53,256,114,142,2,30,1,1,0
56677,53,7912,53,200,102,98,2,30,1,1,0
49402,53,34826,53,214,110,104,2,30,1,1,0
49222,53,61468,53,418,150,268,2,30,1,1,0
49418,27015,47175,27015,234,78,156,2,30,1,1,0
47661,80,24519,80,2865,2000,865,12,15,7,5,0
61323,23117,0,0,62,62,0,1,0,1,0,1
9175,443,52821,443,6331,837,5494,19,28,10,9,0
49205,53,36921,53,194,102,92,2,30,1,1,0
65189,53,27284,53,180,94,86,2,30,1,1,0
56973,53,45728,53,193,102,91,2,30,1,1,0
59785,445,0,0,66,66,0,1,0,1,0,2
8889,60297,0,0,60,60,0,1,0,1,0,1
34348,22114,0,0,146,146,0,1,0,1,0,1
36138,443,58693,443,50384,5218,45166,76,99,26,50,0
52977,445,0,0,70,70,0,1,0,1,0,2
49512,53,36100,53,195,102,93,2,30,1,1,0
54437,443,40534,443,716056,89267,626789,952,300,368,584,0
49518,53,16482,53,193,102,91,2,30,1,1,0
38400,53,0,0,82,82,0,1,30,1,0,0
65514,53,43311,53,214,110,104,2,30,1,1,0
58638,5900,0,0,62,62,0,1,0,1,0,1
52485,443,22795,443,22817,7615,15202,30,16,16,14,0
49855,36180,0,0,62,62,0,1,0,1,0,1
22924,25174,0,0,62,62,0,1,0,1,0,1
50571,80,64124,80,300,174,126,5,15,3,2,0
50968,443,54503,443,13683,6075,7608,58,5113,23,35,0
56271,53,40470,53,195,102,93,2,30,1,1,0
56148,37965,0,0,66,66,0,1,0,1,0,1
59487,80,24242,80,350,210,140,6,26,4,2,0
59836,443,35828,443,1394,733,661,14,80,8,6,0
35052,80,38624,80,350,210,140,6,30,4,2,0
25600,23684,0,0,159,159,0,1,0,1,0,1
49467,443,18409,443,4564,2466,2098,20,119,11,9,0
54567,445,0,0,70,70,0,1,0,1,0,2
55661,49671,9206,49671,70,70,0,2,8,2,0,0
64772,445,0,0,70,70,0,1,0,1,0,2
51592,51505,0,0,66,66,0,1,0,1,0,1
58155,445,0,0,70,70,0,1,0,1,0,2
56667,53,23608,53,168,86,82,2,31,1,1,0
65246,53,37552,53,183,94,89,2,30,1,1,0
53837,443,2999,443,499,425,74,4,0,3,1,0
57574,443,28846,443,3595,1957,1638,17,361,9,8,0
61406,445,0,0,70,70,0,1,0,1,0,2
58770,443,24221,443,6033,770,5263,18,15,8,10,0
39981,57470,0,0,62,62,0,1,0,1,0,1
50502,123,48233,123,184,94,90,2,30,1,1,0
58381,53,27908,53,199,94,105,2,31,1,1,0
51564,50584,0,0,62,62,0,1,0,1,0,1
65460,53,40464,53,197,102,95,2,30,1,1,0
50791,445,0,0,70,70,0,1,0,1,0,2
5588,5588,0,0,3354,1792,1562,46,196,23,23,0
56489,53,51415,53,178,94,84,2,30,1,1,0
9119,80,62063,80,8732,2438,6294,23,36,11,12,0
42927,443,28678,443,6921,1769,5152,22,24,13,9,0
53419,445,0,0,70,70,0,1,0,1,0,2
49857,443,44578,443,18811,1868,16943,22,139,7,15,0
43591,443,23363,443,4680,2835,1845,33,80,16,17,0
56112,53,63106,53,199,102,97,2,30,1,1,0
23770,50584,0,0,66,66,0,1,0,1,0,1
64485,53,38773,53,182,93,89,2,30,1,1,0
52132,55014,27986,55014,70,70,0,1,4,1,0,0
60007,443,50307,443,2798,1652,1146,15,143,8,7,0
63955,445,0,0,66,66,0,1,0,1,0,2
51862,27758,32851,27758,70,70,0,2,7,2,0,0
53670,32016,15273,32016,70,70,0,2,8,2,0,0
65422,445,0,0,70,70,0,1,0,1,0,2
58928,445,0,0,70,70,0,1,0,1,0,2
56639,48817,0,0,66,66,0,1,0,1,0,1
42853,443,43627,443,3508,2120,1388,20,241,10,10,0
65359,445,0,0,70,70,0,1,0,1,0,2
49761,80,17829,80,2113,1181,932,10,127,6,4,0
50208,80,63761,80,1277,460,817,16,77,5,11,0
51503,445,0,0,70,70,0,1,0,1,0,2
54986,443,39292,443,5684,3042,2642,32,46,18,14,0
64381,53,44937,53,952,291,661,8,68,4,4,0
56107,53,50537,53,817,102,715,2,30,1,1,0
50124,445,0,0,70,70,0,1,0,1,0,2
57470,22646,6893,22646,353,166,187,2,1200,1,1,0
50293,53,25447,53,740,93,647,2,31,1,1,0
56652,53,23903,53,821,102,719,2,30,1,1,0
63953,445,0,0,66,66,0,1,0,1,0,2
59389,445,0,0,70,70,0,1,0,1,0,2
63938,3389,63938,3389,3364,1714,1650,15,32,8,7,0
56604,443,32761,443,7314,2061,5253,29,92,15,14,0
60558,445,0,0,70,70,0,1,0,1,0,2
49432,53,25699,53,309,94,215,4,32,2,2,0
56141,53,40551,53,713,94,619,4,54,2,2,0
49999,53,61068,53,181,94,87,2,30,1,1,0
17842,22114,0,0,62,62,0,1,0,1,0,1
42996,53,58544,53,168,78,90,2,30,1,1,0
56654,53,47578,53,102,102,0,1,30,1,0,0
55665,44235,23820,44235,504,318,186,8,15,5,3,0
51453,64147,0,0,62,62,0,1,0,1,0,1
18415,37965,0,0,62,62,0,1,0,1,0,1
17027,1,0,0,62,62,0,1,0,1,0,1
60394,53,18080,53,330,94,236,2,30,1,1,0
50299,445,0,0,70,70,0,1,0,1,0,2
51993,25174,0,0,66,66,0,1,0,1,0,1
54121,445,0,0,66,66,0,1,0,1,0,2
9319,443,38033,443,5687,499,5188,14,16,7,7,0
55803,445,0,0,66,66,0,1,0,1,0,2
54827,445,0,0,70,70,0,1,0,1,0,2
56561,443,57452,443,341343,9074,332269,353,121,122,231,0
53073,32468,0,0,62,62,0,1,0,1,0,1
38169,443,2048,443,7841,2301,5540,18,135,8,10,0
56620,53,63507,53,216,110,106,2,30,1,1,0
50310,80,55858,80,7979,802,7177,17,57,8,9,0
58638,5900,0,0,62,62,0,1,0,1,0,1
64789,53,49397,53,199,102,97,2,30,1,1,0
50610,445,0,0,70,70,0,1,0,1,0,2
29599,443,15239,443,2227,1018,1209,17,16,8,9,0
54074,445,0,0,66,66,0,1,0,1,0,2
47625,53,55385,53,168,78,90,2,30,1,1,0
53381,25174,0,0,66,66,0,1,0,1,0,1
55058,53,41146,53,216,110,106,2,31,1,1,0
41901,443,21025,443,5586,1404,4182,17,212,10,7,0
52931,443,65247,443,8519,1687,6832,29,17,16,13,0
55640,53,37187,53,797,208,589,6,67,3,3,0
60222,22114,0,0,62,62,0,1,0,1,0,1
55768,443,42706,443,5263,2534,2729,16,120,8,8,0
13943,22,0,0,60,60,0,1,0,1,0,1
55629,53,22449,53,168,86,82,2,30,1,1,0
8802,80,39611,80,4999,1313,3686,36,667,8,28,0
56115,445,0,0,66,66,0,1,0,1,0,2
55276,445,0,0,70,70,0,1,0,1,0,2
49713,80,27859,80,5029,1986,3043,16,130,8,8,0
53976,443,65435,443,9921,2236,7685,35,32,17,18,0
49324,53,24551,53,258,94,164,2,30,1,1,0
39814,443,9384,443,5761,3561,2200,45,51,23,22,0
54717,445,0,0,70,70,0,1,0,1,0,2
58761,445,0,0,70,70,0,1,0,1,0,2
55920,25174,0,0,146,146,0,1,0,1,0,1
49750,445,0,0,66,66,0,1,0,1,0,2
56015,53,12325,53,195,102,93,2,31,1,1,0
64065,53,56733,53,264,94,170,2,29,1,1,0
56770,53,31600,53,779,86,693,2,30,1,1,0
49589,445,0,0,66,66,0,1,0,1,0,2
56998,53,64754,53,177,94,83,2,30,1,1,0
1912,48817,0,0,62,62,0,1,0,1,0,1
55631,53,42735,53,422,96,326,4,42,2,2,0
55972,53,18787,53,193,102,91,2,31,1,1,0
64837,53,3342,53,190,97,93,2,31,1,1,0
59937,37965,0,0,66,66,0,1,0,1,0,1
50387,443,3636,443,2227,1018,1209,17,16,8,9,0
57013,53,50114,53,178,94,84,2,29,1,1,0
443,56513,0,0,78,78,0,1,0,1,0,1
62392,445,0,0,70,70,0,1,0,1,0,2
58272,445,0,0,66,66,0,1,0,1,0,2
58318,15503,0,0,66,66,0,1,0,1,0,1
50654,445,0,0,66,66,0,1,0,1,0,2
56139,53,55354,53,306,94,212,2,30,1,1,0
56253,445,0,0,66,66,0,1,0,1,0,2
55538,53,6885,53,168,86,82,2,30,1,1,0
56167,53,20756,53,461,94,367,2,30,1,1,0
50849,80,37869,80,1218354,26709,1191645,1128,133,332,796,0
34105,443,37693,443,43883,3446,40437,57,122,22,35,0
49618,80,5688,80,314,192,122,6,42,4,2,0
53724,53,53724,53,268,114,154,2,29,1,1,0
65168,53,45025,53,749,94,655,2,30,1,1,0
52566,443,55072,443,8594,1042,7552,16,120,7,9,0
62164,445,0,0,70,70,0,1,0,1,0,2
27005,27018,61540,27018,881,126,755,2,30,1,1,0
56216,53,54561,53,177,94,83,2,30,1,1,0
44274,53,0,0,82,82,0,1,31,1,0,0
3272,1433,0,0,60,60,0,1,0,1,0,1
64559,53,60231,53,258,110,148,2,29,1,1,0
56752,53,3213,53,183,94,89,2,29,1,1,0
50362,53,19652,53,177,94,83,2,30,1,1,0
56815,50510,55664,50510,70,70,0,1,5,1,0,0
57733,445,0,0,66,66,0,1,0,1,0,2
56099,445,0,0,70,70,0,1,0,1,0,2
3478,61463,0,0,214,214,0,1,0,1,0,1
56668,443,3930,443,8005,1985,6020,20,15,11,9,0
38427,443,30130,443,12591,2902,9689,40,55,19,21,0
55830,53,20748,53,177,94,83,2,30,1,1,0
23795,44847,0,0,146,146,0,1,0,1,0,1
65248,53,49147,53,212,110,102,2,30,1,1,0
57030,445,0,0,66,66,0,1,0,1,0,2
58638,5900,0,0,62,62,0,1,0,1,0,1
53482,445,0,0,70,70,0,1,0,1,0,2
55159,53,20403,53,200,102,98,2,29,1,1,0
50207,53,12070,53,189,102,87,2,31,1,1,0
55929,445,0,0,70,70,0,1,0,1,0,2
57969,53,57969,53,194,87,107,2,31,1,1,0
52125,49224,3384,49224,70,70,0,1,5,1,0,0
58564,50432,0,0,66,66,0,1,0,1,0,1
43100,22114,0,0,146,146,0,1,0,1,0,1
64781,53,27529,53,209,102,107,2,30,1,1,0
56924,53,38205,53,177,94,83,2,31,1,1,0
39213,25174,0,0,62,62,0,1,0,1,0,1
52929,43890,0,0,66,66,0,1,0,1,0,1
55830,53,50350,53,166,86,80,2,30,1,1,0
38093,11392,0,0,62,62,0,1,0,1,0,1
56835,53,43767,53,213,102,111,2,30,1,1,0
57304,53,49312,53,228,110,118,2,31,1,1,0
56771,43648,30018,43648,70,70,0,2,8,2,0,0
53196,445,0,0,66,66,0,1,0,1,0,2
53316,445,0,0,70,70,0,1,0,1,0,2
60423,35440,0,0,146,146,0,1,0,1,0,1
49810,53,13654,53,244,94,150,2,30,1,1,0
43818,53,4303,53,168,78,90,2,30,1,1,0
3303,80,51748,80,2338,1419,919,10,15,5,5,0
52011,10722,14551,10722,70,70,0,1,4,1,0,0
64818,53,5282,53,174,89,85,2,30,1,1,0
57441,53,16567,53,177,94,83,2,29,1,1,0
56365,53,6321,53,199,102,97,2,30,1,1,0
56510,445,0,0,70,70,0,1,0,1,0,2
16168,23,0,0,60,60,0,1,0,1,0,1
38484,48637,0,0,60,60,0,1,0,1,0,1
65349,445,0,0,70,70,0,1,0,1,0,2
38009,443,41561,443,130,70,60,3,5,2,1,0
49341,53,41507,53,199,102,97,2,30,1,1,0
55654,18251,23263,18251,70,70,0,2,8,2,0,0
65239,53,58774,53,199,102,97,2,29,1,1,0
51596,443,63040,443,4638384,61757,4576627,3641,280,309,3332,0
54769,50584,0,0,146,146,0,1,0,1,0,1
40631,53,40631,53,262,107,155,2,30,1,1,0
57001,53,25113,53,177,94,83,2,30,1,1,0
60244,80,21449,80,1114,534,580,12,16,7,5,0
50265,50262,19967,50262,3758,2456,1302,52,2355,31,21,0
58638,5900,0,0,62,62,0,1,0,1,0,1
63711,445,0,0,70,70,0,1,0,1,0,2
12986,64147,0,0,62,62,0,1,0,1,0,1
45941,23386,0,0,60,60,0,1,0,1,0,1
8282,17435,17967,17435,73,73,0,1,30,1,0,0
41694,443,48276,443,16107,3200,12907,35,362,17,18,0
64004,48339,32132,48339,70,70,0,1,4,1,0,0
57146,53,5349,53,199,102,97,2,29,1,1,0
50265,43974,25412,43974,132,132,0,3,1200,3,0,0
56163,53,14069,53,265,85,180,4,42,2,2,0
49888,53,54251,53,196,100,96,2,30,1,1,0
50291,53,32259,53,86,86,0,1,30,1,0,0
3524,25174,0,0,66,66,0,1,0,1,0,1
49901,53,54026,53,776,102,674,2,30,1,1,0
56365,53,8027,53,199,102,97,2,30,1,1,0
50986,445,0,0,70,70,0,1,0,1,0,2
51948,17372,0,0,62,62,0,1,0,1,0,1
41699,443,36765,443,40273,3243,37030,60,77,28,32,0
58597,35440,0,0,66,66,0,1,0,1,0,1
56511,53,55404,53,200,102,98,2,30,1,1,0
57433,445,0,0,70,70,0,1,0,1,0,2
49828,53,30864,53,340,110,230,2,31,1,1,0
56332,53,17265,53,193,102,91,2,30,1,1,0
55025,443,11622,443,7599,3113,4486,30,20,17,13,0
58638,5900,0,0,62,62,0,1,0,1,0,1
54998,53,35657,53,174,89,85,2,31,1,1,0
60676,57866,0,0,66,66,0,1,0,1,0,1
55903,53,28482,53,177,94,83,2,30,1,1,0
56653,443,22218,443,1272,876,396,10,25,6,4,0
17750,8953,36082,8953,491,150,341,2,1200,1,1,0
56688,53,52079,53,196,102,94,2,31,1,1,0
11136,15503,0,0,62,62,0,1,0,1,0,1
43129,15503,0,0,62,62,0,1,0,1,0,1
35516,80,25484,80,841,715,126,5,15,3,2,0
53910,445,0,0,70,70,0,1,0,1,0,2
53914,443,31627,443,499,425,74,4,0,3,1,0
61534,445,0,0,70,70,0,1,0,1,0,2
64054,53,42745,53,182,93,89,2,31,1,1,0
38053,50584,0,0,62,62,0,1,0,1,0,1
56550,53,60039,53,182,93,89,2,31,1,1,0
56985,53,26642,53,916,86,830,2,30,1,1,0
3986,17372,0,0,66,66,0,1,0,1,0,1
54135,443,36564,443,11065,1394,9671,23,75,13,10,0
61256,443,47931,443,2680,255,2425,9,120,4,5,0
55941,53,18127,53,184,94,90,2,30,1,1,0
65191,53,21889,53,196,94,102,2,29,1,1,0
49343,445,0,0,66,66,0,1,0,1,0,2
59326,57470,0,0,74,74,0,1,0,1,0,1
65015,22114,0,0,66,66,0,1,0,1,0,1
57612,28793,0,0,66,66,0,1,0,1,0,1
50026,53,4265,53,395,99,296,4,57,2,2,0
33973,50265,0,0,62,62,0,1,0,1,0,1
50239,53,39194,53,183,94,89,2,30,1,1,0
53258,53,63456,53,277,78,199,2,30,1,1,0
55363,445,0,0,70,70,0,1,0,1,0,2
60384,443,37407,443,39385,3771,35614,67,129,27,40,0
55482,53,16639,53,822,102,720,2,30,1,1,0
0,0,0,0,156,156,0,2,0,2,0,0
33053,53,52435,53,164,78,86,2,31,1,1,0
50070,445,0,0,70,70,0,1,0,1,0,2
8486,56205,0,0,66,66,0,1,0,1,0,1
50006,53,55896,53,378,94,284,2,30,1,1,0
7364,50584,0,0,66,66,0,1,0,1,0,1
49952,80,46004,80,4023,620,3403,14,15,7,7,0
59845,44847,0,0,66,66,0,1,0,1,0,1
44384,80,20153,80,51651,48866,2785,74,19,38,36,0
60222,22114,0,0,66,66,0,1,0,1,0,1
42252,33306,0,0,60,60,0,1,0,1,0,1
53804,445,0,0,66,66,0,1,0,1,0,2
49187,2710,53094,2710,70,70,0,1,5,1,0,0
55427,64147,0,0,66,66,0,1,0,1,0,1
55182,445,0,0,66,66,0,1,0,1,0,2
11295,40040,23656,40040,213,89,124,4,31,2,2,0
65472,443,58915,443,460338,13340,446998,472,16,165,307,0
56438,53,21882,53,312,94,218,2,30,1,1,0
60141,30188,0,0,66,66,0,1,0,1,0,1
52148,80,52148,80,62796,1961,60835,72,141,26,46,0
57030,53,10715,53,749,94,655,2,30,1,1,0
50905,443,13622,443,124,64,60,2,15,1,1,0
64291,445,0,0,66,66,0,1,0,1,0,2
56550,123,27975,123,184,94,90,2,30,1,1,0
65009,53,11589,53,152,78,74,2,30,1,1,0
55020,445,0,0,70,70,0,1,0,1,0,2
65153,53,29688,53,168,86,82,2,30,1,1,0
19678,36237,0,0,146,146,0,1,0,1,0,1
51795,60258,28772,60258,70,70,0,1,5,1,0,0
62748,445,0,0,66,66,0,1,0,1,0,2
47812,30627,0,0,62,62,0,1,0,1,0,1
63609,53,0,0,182,81,101,2,30,1,1,0
53685,53,0,0,547,97,450,4,40,2,2,0
5588,5588,0,0,3354,1792,1562,46,195,23,23,0
50920,443,55566,443,6273,1375,4898,18,127,9,9,0
51857,40561,47310,40561,70,70,0,1,5,1,0,0
56481,53,4723,53,193,102,91,2,30,1,1,0
60636,445,0,0,66,66,0,1,0,1,0,2
43104,443,41004,443,3067,1817,1250,18,15,8,10,0
65076,53,51472,53,215,94,121,2,29,1,1,0
64997,53,32660,53,771,102,669,2,29,1,1,0
23031,22114,0,0,146,146,0,1,0,1,0,1
36456,25174,0,0,62,62,0,1,0,1,0,1
53496,443,54389,443,3155,2234,921,15,16,8,7,0
11825,38338,0,0,86,86,0,1,0,1,0,1
56509,53,49839,53,1165,94,1071,2,30,1,1,0
6881,6881,0,0,62,62,0,1,0,1,0,1
60419,445,0,0,70,70,0,1,0,1,0,2
56075,443,56807,443,5640,3241,2399,22,120,11,11,0
58638,5900,0,0,62,62,0,1,0,1,0,1
56369,53,3400,53,168,86,82,2,30,1,1,0
56606,445,0,0,66,66,0,1,0,1,0,2
52006,443,14012,443,2898,2047,851,19,22,11,8,0
51037,80,32981,80,134,60,74,3,4,2,1,0
56803,53,49854,53,195,102,93,2,29,1,1,0
56567,53,56060,53,188,96,92,2,31,1,1,0
37917,443,55165,443,6124,860,5264,18,361,9,9,0
44847,15315,12919,15315,150,150,0,1,1200,1,0,0
21424,53,21424,53,225,90,135,2,29,1,1,0
50553,3389,50553,3389,3327,1438,1889,15,17,8,7,0
59737,445,0,0,70,70,0,1,0,1,0,2
47996,80,47996,80,1920,1471,449,10,19,6,4,0
30861,46783,0,0,62,62,0,1,0,1,0,1
57366,53,60542,53,458,188,270,6,31,3,3,0
61538,445,0,0,66,66,0,1,0,1,0,2
50826,445,0,0,70,70,0,1,0,1,0,2
44318,51180,0,0,74,74,0,1,0,1,0,1
55808,53,55808,53,257,106,151,2,30,1,1,0
54223,443,38222,443,499,425,74,4,0,3,1,0
52872,443,5601,443,110507,3940,106567,129,118,37,92,0
57090,445,0,0,66,66,0,1,0,1,0,2
63526,3389,63526,3389,4365,2581,1784,20,33,11,9,0
20389,64147,0,0,66,66,0,1,0,1,0,1
65132,53,27212,53,167,86,81,2,30,1,1,0
45225,443,59513,443,11233,3101,8132,37,150,18,19,0
49996,443,63041,443,19523,5346,14177,37,87,17,20,0
56562,44847,0,0,62,62,0,1,0,1,0,1
65165,53,21302,53,200,102,98,2,31,1,1,0
53223,445,0,0,66,66,0,1,0,1,0,2
52058,8329,19334,8329,70,70,0,2,9,2,0,0
53166,61600,0,0,66,66,0,1,0,1,0,1
16037,25174,0,0,62,62,0,1,0,1,0,1
0,0,0,0,2000,1020,980,20,0,10,10,0
56887,53,63111,53,177,94,83,2,30,1,1,0
53897,46913,50139,46913,552,306,246,9,15,5,4,0
57606,443,30554,443,2614,1689,925,18,22,10,8,0
13917,18033,0,0,62,62,0,1,0,1,0,1
61657,445,0,0,70,70,0,1,0,1,0,2
37590,443,37590,443,4572,1665,2907,19,27,11,8,0
55240,53,47282,53,193,102,91,2,30,1,1,0
16387,26193,0,0,60,60,0,1,0,1,0,1
43546,443,49269,443,5948,1664,4284,21,247,12,9,0
40400,22114,0,0,62,62,0,1,0,1,0,1
56072,53,60907,53,198,101,97,2,31,1,1,0
58638,5900,0,0,62,62,0,1,0,1,0,1
49506,53,26702,53,200,102,98,2,31,1,1,0
55339,445,0,0,70,70,0,1,0,1,0,2
50063,53,53923,53,173,94,79,2,30,1,1,0
56941,53,44223,53,196,102,94,2,30,1,1,0
58799,30188,0,0,66,66,0,1,0,1,0,1
52094,445,0,0,70,70,0,1,0,1,0,2
60369,80,60369,80,266818,12375,254443,285,34,107,178,0
54883,51505,0,0,62,62,0,1,0,1,0,1
64589,53,29733,53,742,88,654,2,30,1,1,0
60514,39004,0,0,66,66,0,1,0,1,0,1
57174,57470,0,0,66,66,0,1,0,1,0,1
55105,53,24892,53,194,94,100,2,30,1,1,0
65384,57470,0,0,66,66,0,1,0,1,0,1
54819,3389,54819,3389,3327,1438,1889,15,17,8,7,0
50987,445,0,0,70,70,0,1,0,1,0,2
50571,445,0,0,66,66,0,1,0,1,0,2
59155,39004,0,0,74,74,0,1,0,1,0,1
56309,22114,0,0,62,62,0,1,0,1,0,1
58638,5900,0,0,62,62,0,1,0,1,0,1
56570,443,57405,443,4722,1330,3392,18,80,9,9,0
57285,445,0,0,66,66,0,1,0,1,0,2
45551,80,20742,80,694,350,344,11,27,6,5,0
51817,443,24496,443,2811130,115323,2695807,3382,206,1445,1937,0
59951,53,55881,53,237,86,151,2,30,1,1,0
57470,2710,46091,2710,124,124,0,3,1199,3,0,0
61790,445,0,0,66,66,0,1,0,1,0,2
58549,445,0,0,66,66,0,1,0,1,0,2
50233,53,55519,53,756,95,661,2,31,1,1,0
40375,443,13030,443,130,70,60,3,5,2,1,0
14252,35993,0,0,62,62,0,1,0,1,0,1
43271,50584,0,0,62,62,0,1,0,1,0,1
52052,80,13756,80,2308,1541,767,11,18,7,4,0
52324,443,60831,443,295493,16052,279441,394,68,186,208,0
49276,80,4660,80,254,128,126,5,16,3,2,0
49359,445,0,0,70,70,0,1,0,1,0,2
64516,53,41634,53,216,110,106,2,30,1,1,0
3478,61463,0,0,252,252,0,1,0,1,0,1
55934,53,0,0,86,86,0,1,30,1,0,0
57177,53,5547,53,174,89,85,2,31,1,1,0
54018,445,0,0,70,70,0,1,0,1,0,2
50845,445,0,0,66,66,0,1,0,1,0,2
60413,80,20847,80,958,543,415,11,315,6,5,0
27005,27015,3616,27015,887,126,761,2,30,1,1,0
56736,443,56736,443,120441,7846,112595,167,61,76,91,0
49459,53,5838,53,199,102,97,2,29,1,1,0
50049,443,7528,443,27889,1445,26444,37,121,14,23,0
52005,33191,61687,33191,70,70,0,2,7,2,0,0
54721,445,0,0,66,66,0,1,0,1,0,2
43817,53,0,0,82,82,0,2,40,2,0,0
49449,53,11737,53,216,110,106,2,30,1,1,0
42202,443,2028,443,6610,1106,5504,23,361,12,11,0
58638,5900,0,0,62,62,0,1,0,1,0,1
49601,53,44219,53,178,94,84,2,30,1,1,0
62025,445,0,0,66,66,0,1,0,1,0,2
60959,443,46440,443,17149,2543,14606,40,46,22,18,0
50474,80,43879,80,19357,10244,9113,36,27,19,17,0
65080,53,25627,53,209,110,99,2,30,1,1,0
50898,445,0,0,70,70,0,1,0,1,0,2
49591,53,21458,53,86,86,0,1,29,1,0,0
38741,37965,0,0,146,146,0,1,0,1,0,1
34436,443,8261,443,9083,2087,6996,28,18,16,12,0
53501,445,0,0,70,70,0,1,0,1,0,2
57839,445,0,0,70,70,0,1,0,1,0,2
57873,445,0,0,70,70,0,1,0,1,0,2
62577,445,0,0,70,70,0,1,0,1,0,2
55966,35440,0,0,62,62,0,1,0,1,0,1
55812,443,35991,443,9398,2478,6920,26,82,14,12,0
64983,53,54706,53,181,94,87,2,30,1,1,0
50848,445,0,0,70,70,0,1,0,1,0,2
54093,5228,31167,5228,7608,1824,5784,34,171,19,15,0
60887,445,0,0,70,70,0,1,0,1,0,2
59685,445,0,0,70,70,0,1,0,1,0,2
58152,445,0,0,70,70,0,1,0,1,0,2
58987,443,9430,443,3730,2378,1352,23,28,12,11,0
49652,80,63583,80,372,192,180,7,42,4,3,0
60473,8765,52424,8765,1370,750,620,21,329,11,10,0
29022,23,0,0,60,60,0,1,0,1,0,1
64980,53,27979,53,199,102,97,2,29,1,1,0
59097,2767,0,0,66,66,0,1,0,1,0,1
5588,5588,0,0,3562,1936,1626,48,194,24,24,0
64937,53,42639,53,204,104,100,2,31,1,1,0
53928,15503,0,0,62,62,0,1,0,1,0,1
55942,53,15569,53,197,102,95,2,30,1,1,0
55624,80,56586,80,70,70,0,1,5,1,0,0
65516,53,45586,53,749,94,655,2,31,1,1,0
53278,445,0,0,66,66,0,1,0,1,0,2
21365,23718,0,0,62,62,0,1,0,1,0,1
10034,53,10034,53,215,98,117,2,29,1,1,0
50274,445,0,0,66,66,0,1,0,1,0,2
52147,30265,61743,30265,66,66,0,1,5,1,0,0
50713,80,55082,80,708,384,324,12,195,7,5,0
54666,445,0,0,70,70,0,1,0,1,0,2
53435,443,53435,443,2503,1457,1046,21,102,10,11,0
62112,443,29747,443,505589,13504,492085,462,345,91,371,0
56189,445,0,0,70,70,0,1,0,1,0,2
34478,443,59065,443,9107,2253,6854,22,185,11,11,0
50442,37807,0,0,66,66,0,1,0,1,0,1
60955,443,4042,443,40105,2847,37258,61,17,28,33,0
63385,25174,0,0,66,66,0,1,0,1,0,1
55423,53,7848,53,170,87,83,2,30,1,1,0
49949,443,7206,443,4712,908,3804,18,89,9,9,0
59220,445,0,0,70,70,0,1,0,1,0,2
52092,80,44323,80,426,240,186,8,25,5,3,0
64266,53,49573,53,168,86,82,2,31,1,1,0
50920,60182,0,0,66,66,0,1,0,1,0,1
12116,53,12116,53,214,82,132,2,33,1,1,0
56092,445,0,0,66,66,0,1,0,1,0,2
49466,53,63958,53,324,103,221,4,46,2,2,0
55167,48817,0,0,66,66,0,1,0,1,0,1
42951,443,65078,443,6513,1609,4904,26,303,14,12,0
61920,445,0,0,70,70,0,1,0,1,0,2
64531,53,13391,53,754,94,660,2,30,1,1,0
51815,80,14356,80,3910,2158,1752,15,32,10,5,0
56635,443,56247,443,8654,2150,6504,20,15,11,9,0
53901,443,43794,443,499,425,74,4,0,3,1,0
49434,53,30404,53,326,134,192,2,30,1,1,0
26900,27017,12054,27017,422,164,258,6,30,3,3,0
56020,53,56318,53,168,86,82,2,29,1,1,0
49622,443,43494,443,15336,2803,12533,47,202,24,23,0
53724,445,0,0,70,70,0,1,0,1,0,2
12668,42707,0,0,62,62,0,1,0,1,0,1
49845,445,0,0,70,70,0,1,0,1,0,2
49659,443,27992,443,11455,2804,8651,59,121,28,31,0
34169,443,8049,443,6507,1060,5447,22,255,12,10,0
58858,445,0,0,70,70,0,1,0,1,0,2
51410,443,1294,443,619870,220857,399013,1045,123,531,514,0
49988,445,0,0,70,70,0,1,0,1,0,2
41632,443,56228,443,8507,4462,4045,27,141,14,13,0
59610,51505,0,0,66,66,0,1,0,1,0,1
60319,445,0,0,70,70,0,1,0,1,0,2
49257,53,2534,53,198,101,97,2,30,1,1,0
10477,44847,0,0,62,62,0,1,0,1,0,1
55463,53,39462,53,816,102,714,2,29,1,1,0
37546,80,60597,80,10438,979,9459,21,38,11,10,0
57867,27019,27516,27019,468,390,78,5,30,4,1,0
62617,445,0,0,66,66,0,1,0,1,0,2
53895,53,0,0,86,86,0,1,29,1,0,0
49240,53,19807,53,330,101,229,4,47,2,2,0
50066,30188,0,0,66,66,0,1,0,1,0,1
55966,443,29704,443,214312,69934,144378,612,671,303,309,0
65515,22114,0,0,62,62,0,1,0,1,0,1
30729,22114,0,0,66,66,0,1,0,1,0,1
55341,445,0,0,66,66,0,1,0,1,0,2
7000,23117,0,0,66,66,0,1,0,1,0,1
9461,443,60064,443,2581,1602,979,17,20,9,8,0
56833,23117,0,0,62,62,0,1,0,1,0,1
52416,445,0,0,70,70,0,1,0,1,0,2
35927,443,23260,443,9102,1205,7897,25,14,14,11,0
30456,36237,0,0,62,62,0,1,0,1,0,1
61911,50432,0,0,146,146,0,1,0,1,0,1
50475,445,0,0,70,70,0,1,0,1,0,2
49731,443,14153,443,13155,3815,9340,29,24,13,16,0
60502,443,31971,443,416,210,206,7,28,4,3,0
65317,51221,0,0,78,78,0,1,0,1,0,1
60449,445,0,0,70,70,0,1,0,1,0,2
50501,123,36469,123,184,94,90,2,30,1,1,0
55563,53,56094,53,188,96,92,2,31,1,1,0
33830,443,43990,443,448,78,370,6,25,1,5,0
53055,443,19489,443,17225,7769,9456,71,91,34,37,0
48919,443,27329,443,10338,3346,6992,27,19,15,12,0
58543,6881,0,0,146,146,0,1,0,1,0,1
56472,53,54930,53,167,86,81,2,30,1,1,0
50721,445,0,0,66,66,0,1,0,1,0,2
13871,53,13871,53,240,98,142,2,30,1,1,0
11136,15503,0,0,62,62,0,1,0,1,0,1
49424,53,45939,53,198,102,96,2,32,1,1,0
53781,37965,0,0,62,62,0,1,0,1,0,1
63930,44330,64385,44330,66,66,0,2,7,2,0,0
30129,37965,0,0,72,72,0,1,0,1,0,1
49161,53,1492,53,385,102,283,2,30,1,1,0
56931,445,0,0,70,70,0,1,0,1,0,2
60750,42707,0,0,66,66,0,1,0,1,0,1
58638,5900,0,0,62,62,0,1,0,1,0,1
56861,33412,8103,33412,70,70,0,1,5,1,0,0
54196,80,31560,80,2640,540,2100,12,45,6,6,0
49505,53,46670,53,232,110,122,2,30,1,1,0
7811,44847,0,0,62,62,0,1,0,1,0,1
50574,80,53098,80,2734,1250,1484,16,15,10,6,0
56344,53,27123,53,198,101,97,2,31,1,1,0
53159,445,0,0,66,66,0,1,0,1,0,2
63545,445,0,0,70,70,0,1,0,1,0,2
37058,80,51116,80,1056,682,374,10,15,6,4,0
56431,53,52567,53,323,110,213,2,30,1,1,0
49671,53,15823,53,166,86,80,2,29,1,1,0
64338,53,55215,53,292,102,190,2,29,1,1,0
53160,80,36074,80,1213,725,488,10,323,6,4,0
49969,445,0,0,70,70,0,1,0,1,0,2
35191,53,35191,53,825,99,726,2,31,1,1,0
40457,443,34174,443,5630,3451,2179,39,67,20,19,0
49472,53,22827,53,751,95,656,2,31,1,1,0
56224,53,54618,53,221,102,119,2,30,1,1,0
59840,80,40850,80,469946,11862,458084,482,68,173,309,0
26081,53,4535,53,243667,236247,7420,2897,90,2851,46,0
58638,5900,0,0,62,62,0,1,0,1,0,1
60368,443,14990,443,10483,4072,6411,20,26,9,11,0
50031,53,15521,53,181,94,87,2,30,1,1,0
51444,443,39755,443,3283,951,2332,13,135,6,7,0
57967,445,0,0,70,70,0,1,0,1,0,2
40107,53,34833,53,168,78,90,2,30,1,1,0
62876,445,0,0,70,70,0,1,0,1,0,2
51702,445,0,0,66,66,0,1,0,1,0,2
49484,7000,49484,7000,2958,1567,1391,15,15,8,7,0
55281,53,43570,53,210,102,108,2,30,1,1,0
52258,445,0,0,70,70,0,1,0,1,0,2
50394,25174,0,0,62,62,0,1,0,1,0,1
53338,53,53532,53,168,78,90,2,30,1,1,0
64992,53,21333,53,177,94,83,2,29,1,1,0
26900,27017,5951,27017,422,164,258,6,30,3,3,0
45862,443,6882,443,234,234,0,4,11,4,0,0
49965,53,10762,53,226,110,116,2,30,1,1,0
65012,2767,0,0,66,66,0,1,0,1,0,1
55461,53,48907,53,198,110,88,2,31,1,1,0
49786,25174,0,0,66,66,0,1,0,1,0,1
63867,64147,0,0,62,62,0,1,0,1,0,1
29509,25174,0,0,62,62,0,1,0,1,0,1
50482,445,0,0,70,70,0,1,0,1,0,2
57792,53,57792,53,215,87,128,2,31,1,1,0
49234,53,44202,53,167,86,81,2,30,1,1,0
59062,445,0,0,70,70,0,1,0,1,0,2
51313,25174,0,0,66,66,0,1,0,1,0,1
39456,443,56286,443,6944,1650,5294,24,40,14,10,0
56941,53,63824,53,196,102,94,2,30,1,1,0
54458,445,0,0,70,70,0,1,0,1,0,2
43785,443,28083,443,6017,1285,4732,18,984,8,10,0
50355,43890,0,0,66,66,0,1,0,1,0,1
45964,55559,0,0,60,60,0,1,0,1,0,1
56073,445,0,0,70,70,0,1,0,1,0,2
65206,53,7977,53,167,86,81,2,30,1,1,0
61200,445,0,0,70,70,0,1,0,1,0,2
60293,445,0,0,70,70,0,1,0,1,0,2
60996,443,58632,443,6043,1568,4475,11,120,4,7,0
55605,53,8941,53,711,87,624,2,30,1,1,0
13235,44847,0,0,62,62,0,1,0,1,0,1
37390,80,51104,80,234,234,0,4,12,4,0,0
49846,80,38683,80,3215,2272,943,15,38,9,6,0
56728,443,61064,443,5367,725,4642,15,15,8,7,0
58036,445,0,0,70,70,0,1,0,1,0,2
64673,53,43122,53,213,94,119,2,30,1,1,0
9206,443,23255,443,5043,432,4611,12,15,6,6,0
55276,53,62860,53,177,94,83,2,30,1,1,0
47632,25174,0,0,62,62,0,1,0,1,0,1
51443,443,10966,443,1048,1048,0,9,16,9,0,0
29424,37807,0,0,66,66,0,1,0,1,0,1
51811,20740,61529,20740,70,70,0,2,8,2,0,0
55666,35440,0,0,60,60,0,1,0,1,0,1
27337,51505,0,0,66,66,0,1,0,1,0,1
50306,445,0,0,70,70,0,1,0,1,0,2
49238,445,0,0,70,70,0,1,0,1,0,2
27005,27222,26856,27222,890,126,764,2,30,1,1,0
32892,23,0,0,60,60,0,1,0,1,0,1
53678,31592,21651,31592,70,70,0,1,5,1,0,0
51094,35440,0,0,66,66,0,1,0,1,0,1
56958,53,40535,53,193,102,91,2,30,1,1,0
52049,80,61901,80,34695,17472,17223,55,33,28,27,0
56883,53,30894,53,184,94,90,2,29,1,1,0
55551,445,0,0,66,66,0,1,0,1,0,2
26531,25174,0,0,146,146,0,1,0,1,0,1
55566,445,0,0,70,70,0,1,0,1,0,2
49629,53,5781,53,198,102,96,2,30,1,1,0
50911,445,0,0,70,70,0,1,0,1,0,2
64563,445,0,0,70,70,0,1,0,1,0,2
39803,443,33160,443,1701571,69958,1631613,1930,170,782,1148,0
56560,53,11515,53,198,102,96,2,31,1,1,0
16387,45121,0,0,60,60,0,1,0,1,0,1
50916,445,0,0,70,70,0,1,0,1,0,2
49274,53,51381,53,197,102,95,2,29,1,1,0
42166,443,27279,443,4057,966,3091,14,31,8,6,0
58638,5900,0,0,62,62,0,1,0,1,0,1
51706,25174,0,0,66,66,0,1,0,1,0,1
56975,53,16815,53,413,170,243,6,31,3,3,0
50723,445,0,0,66,66,0,1,0,1,0,2
49418,27022,63608,27022,229,71,158,2,31,1,1,0
50418,445,0,0,70,70,0,1,0,1,0,2
52027,443,40345,443,8698,1393,7305,22,16,12,10,0
65007,53,7048,53,165,86,79,2,30,1,1,0
54667,445,0,0,70,70,0,1,0,1,0,2
52496,445,0,0,70,70,0,1,0,1,0,2
26698,25174,0,0,66,66,0,1,0,1,0,1
9277,443,3010,443,4230,760,3470,14,27,8,6,0
64726,53,62108,53,172,88,84,2,31,1,1,0
59828,443,44871,443,306,180,126,6,29,4,2,0
56001,53,33036,53,196,94,102,2,30,1,1,0
50052,65008,0,0,60,60,0,1,0,1,0,1
49291,53,35462,53,212,102,110,2,29,1,1,0
55192,53,55863,53,178,94,84,2,30,1,1,0
49550,80,26667,80,3531,1965,1566,14,29,8,6,0
53865,64000,37089,64000,492,306,186,8,15,5,3,0
55123,64097,0,0,66,66,0,1,0,1,0,1
55810,53,12633,53,182,93,89,2,30,1,1,0
51231,443,1331,443,1396,735,661,14,80,8,6,0
37556,16386,44427,16386,432,192,240,8,30,4,4,0
49296,443,49940,443,20862040,250452,20611588,16880,170,1832,15048,0
59813,443,22135,443,23244,13793,9451,50,29,26,24,0
63002,445,0,0,70,70,0,1,0,1,0,2
61023,26467,0,0,62,62,0,1,0,1,0,1
57625,445,0,0,70,70,0,1,0,1,0,2
57470,18634,6347,18634,594,594,0,10,1199,10,0,0
27005,27016,17329,27016,883,126,757,2,30,1,1,0
53852,443,26865,443,499,425,74,4,0,3,1,0
36542,443,35325,443,31814,26657,5157,52,212,32,20,0
65071,53,37727,53,93,93,0,2,60,2,0,0
57369,16881,7618,16881,564,318,246,9,15,5,4,0
55305,53,52264,53,1448,103,1345,4,54,2,2,0
47943,50584,0,0,74,74,0,1,0,1,0,1
55048,443,61386,443,1600,1089,511,13,151,7,6,0
56158,445,0,0,70,70,0,1,0,1,0,2
60681,443,60681,443,5667,1393,4274,19,16,9,10,0
65344,445,0,0,70,70,0,1,0,1,0,2
55353,53,65240,53,168,86,82,2,30,1,1,0
49487,443,25025,443,72073,12550,59523,78,45,25,53,0
56225,53,8973,53,194,102,92,2,29,1,1,0
49791,53,47745,53,226,94,132,2,30,1,1,0
62427,445,0,0,70,70,0,1,0,1,0,2
19875,30170,0,0,145,145,0,1,0,1,0,1
53786,53,10105,53,260,86,174,2,30,1,1,0
56764,443,62218,443,8006,1986,6020,20,16,11,9,0
63875,43485,59709,43485,312,132,180,6,6,3,3,0
34809,57470,0,0,66,66,0,1,0,1,0,1
64381,53,35709,53,168,86,82,2,32,1,1,0
60864,5223,16379,5223,194,134,60,2,5,1,1,0
64987,53,8755,53,357,107,250,4,36,2,2,0
51533,44847,0,0,66,66,0,1,0,1,0,1
56990,445,0,0,70,70,0,1,0,1,0,2
56360,53,64885,53,711,87,624,2,30,1,1,0
64752,53,55237,53,190,97,93,2,31,1,1,0
2267,53,13184,53,826,826,0,8,44,8,0,0
52481,443,2836,443,70,70,0,1,5,1,0,0
42128,54532,0,0,60,60,0,1,0,1,0,1
60772,36829,0,0,66,66,0,1,0,1,0,1
52164,443,54936,443,4187,773,3414,16,30,9,7,0
60857,443,19971,443,18385,7771,10614,47,48,27,20,0
57985,443,21475,443,140109,5229,134880,159,46,59,100,0
51986,80,28001,80,1420,888,532,11,49,7,4,0
50298,53,22376,53,172,94,78,2,30,1,1,0
49663,53,41171,53,184,102,82,2,30,1,1,0
5664,36237,0,0,62,62,0,1,0,1,0,1
64872,53,61410,53,166,86,80,2,29,1,1,0
123,123,34455,123,184,94,90,2,30,1,1,0
57772,50584,0,0,66,66,0,1,0,1,0,1
49502,53,35075,53,179,86,93,2,29,1,1,0
41882,53,0,0,86,86,0,1,29,1,0,0
56167,53,49116,53,178,94,84,2,30,1,1,0
32940,443,60631,443,13056,4233,8823,27,121,12,15,0
50139,443,27090,443,72523,5814,66709,125,255,61,64,0
2780,23117,0,0,62,62,0,1,0,1,0,1
65291,445,0,0,70,70,0,1,0,1,0,2
63392,445,0,0,70,70,0,1,0,1,0,2
54884,445,0,0,70,70,0,1,0,1,0,2
32554,34729,0,0,62,62,0,1,0,1,0,1
34150,443,7922,443,12564,9272,3292,66,107,31,35,0
36374,30228,0,0,145,145,0,1,0,1,0,1
56661,443,32722,443,8059,2039,6020,20,15,11,9,0
49402,80,31803,80,405,285,120,5,15,3,2,0
55680,53,52561,53,749,94,655,2,31,1,1,0
37965,40840,26004,40840,150,150,0,1,1199,1,0,0
49705,445,0,0,70,70,0,1,0,1,0,2
58229,445,0,0,66,66,0,1,0,1,0,2
42438,443,37580,443,7747,1737,6010,27,316,13,14,0
55439,53,12410,53,738,86,652,2,30,1,1,0
60044,443,17036,443,15769,1619,14150,17,141,4,13,0
59828,443,59390,443,7083,2786,4297,24,81,14,10,0
26469,26348,0,0,62,62,0,1,0,1,0,1
56738,53,23984,53,264,87,177,4,37,2,2,0
54251,443,43085,443,499,425,74,4,0,3,1,0
52006,49849,60139,49849,70,70,0,1,5,1,0,0
49896,53,58946,53,772,102,670,2,30,1,1,0
37655,443,5274,443,17842,11204,6638,43,174,24,19,0
52976,31573,0,0,66,66,0,1,0,1,0,1
27018,61508,0,0,753,753,0,1,0,1,0,1
53108,7003,16327,7003,512,326,186,9,22,6,3,0
64151,445,0,0,70,70,0,1,0,1,0,2
50681,443,36673,443,6888,1380,5508,19,171,9,10,0
65162,53,50444,53,328,102,226,2,30,1,1,0
58018,445,0,0,66,66,0,1,0,1,0,2
49269,53,5251,53,198,110,88,2,29,1,1,0
51916,24596,6622,24596,70,70,0,2,8,2,0,0
51630,445,0,0,70,70,0,1,0,1,0,2
9323,443,4707,443,26959,1764,25195,42,48,18,24,0
51411,443,64614,443,7842,1155,6687,19,105,10,9,0
50995,53,51013,53,168,78,90,2,30,1,1,0
57496,25174,0,0,66,66,0,1,0,1,0,1
65370,53,21172,53,193,102,91,2,30,1,1,0
58638,5900,0,0,62,62,0,1,0,1,0,1
52471,445,0,0,66,66,0,1,0,1,0,2
64582,53,25024,53,202,103,99,2,30,1,1,0
62388,39004,0,0,62,62,0,1,0,1,0,1
53227,64097,0,0,62,62,0,1,0,1,0,1
35556,443,35556,443,7201,1167,6034,16,131,8,8,0
58638,5900,0,0,62,62,0,1,0,1,0,1
60337,445,0,0,70,70,0,1,0,1,0,2
42252,33306,0,0,60,60,0,1,0,1,0,1
58638,5900,0,0,62,62,0,1,0,1,0,1
56194,445,0,0,66,66,0,1,0,1,0,2
9477,443,41654,443,7461,1448,6013,22,35,11,11,0
443,42788,0,0,74,74,0,1,0,1,0,1
45941,23386,0,0,60,60,0,1,0,1,0,1
50292,62413,0,0,62,62,0,1,0,1,0,1
55075,53,35995,53,181,94,87,2,30,1,1,0
60861,445,0,0,66,66,0,1,0,1,0,2
43835,443,28215,443,11422,2361,9061,26,505,10,16,0
3976,25174,0,0,62,62,0,1,0,1,0,1
49702,53,29408,53,771,102,669,2,31,1,1,0
55849,53,18869,53,195,102,93,2,31,1,1,0
2705,37,0,0,60,60,0,1,0,1,0,1
49248,35993,0,0,66,66,0,1,0,1,0,1
50758,445,0,0,70,70,0,1,0,1,0,2
37965,10909,61398,10909,844,152,692,4,1199,2,2,0
42379,443,33462,443,1622,1137,485,11,26,7,4,0
56327,44512,0,0,66,66,0,1,0,1,0,1
34079,443,61674,443,14068,7909,6159,37,82,23,14,0
35377,443,51737,443,15771,2037,13734,39,187,20,19,0
58638,5900,0,0,62,62,0,1,0,1,0,1
55236,53,12241,53,819,102,717,2,29,1,1,0
51725,32787,39792,32787,70,70,0,2,8,2,0,0
62470,443,10717,443,38402253,1191239,37211014,39088,243,12126,26962,0
51490,30228,0,0,100,100,0,1,0,1,0,1
64756,11392,0,0,146,146,0,1,0,1,0,1
50002,53,33820,53,192,98,94,2,31,1,1,0
49931,25174,0,0,66,66,0,1,0,1,0,1
65349,53,30593,53,772,103,669,2,31,1,1,0
52133,15015,35766,15015,66,66,0,1,5,1,0,0
50521,445,0,0,70,70,0,1,0,1,0,2
49777,53,28087,53,216,110,106,2,30,1,1,0
39992,443,33603,443,3470,1045,2425,13,121,6,7,0
55867,53,6696,53,184,94,90,2,30,1,1,0
52173,44632,63328,44632,258,70,188,4,9,2,2,0
37346,443,8413,443,7814,2339,5475,26,316,12,14,0
10521,15503,0,0,146,146,0,1,0,1,0,1
53995,25174,0,0,66,66,0,1,0,1,0,1
55078,80,14305,80,265275,25834,239441,366,101,182,184,0
27005,27246,16977,27246,865,126,739,2,30,1,1,0
64595,53,62622,53,167,86,81,2,30,1,1,0
10669,49756,0,0,60,60,0,1,0,1,0,1
57504,44847,0,0,66,66,0,1,0,1,0,1
14255,2767,0,0,146,146,0,1,0,1,0,1
60297,53,6955,53,227,86,141,2,30,1,1,0
62005,445,0,0,70,70,0,1,0,1,0,2
50277,445,0,0,70,70,0,1,0,1,0,2
49508,53,61449,53,370,102,268,2,30,1,1,0
20147,53,20147,53,219,87,132,2,30,1,1,0
64333,57470,0,0,78,78,0,1,0,1,0,1
51767,59158,21535,59158,70,70,0,2,8,2,0,0
49418,29999,25371,29999,244,78,166,2,31,1,1,0
50023,443,17571,443,70,70,0,2,5,2,0,0
62867,445,0,0,70,70,0,1,0,1,0,2
54752,31573,0,0,66,66,0,1,0,1,0,1
41779,443,29003,443,618072,8505,609567,523,87,90,433,0
56429,53,7462,53,762,98,664,2,31,1,1,0
57436,53,46375,53,183,94,89,2,30,1,1,0
1821,64147,0,0,66,66,0,1,0,1,0,1
52459,33890,0,0,60,60,0,1,0,1,0,1
55396,443,55396,443,63319,6716,56603,91,19,45,46,0
56854,445,0,0,70,70,0,1,0,1,0,2
41861,5223,49797,5223,5169,1103,4066,26,214,10,16,0
55508,64147,0,0,62,62,0,1,0,1,0,1
62944,445,0,0,70,70,0,1,0,1,0,2
64222,53,1206,53,264,94,170,2,30,1,1,0
57464,80,18705,80,78,78,0,1,5,1,0,0
443,54507,0,0,82,82,0,1,0,1,0,1
59326,445,0,0,66,66,0,1,0,1,0,2
57897,445,0,0,70,70,0,1,0,1,0,2
45317,53,22055,53,86,86,0,1,30,1,0,0
55441,53,20150,53,216,110,106,2,31,1,1,0
63751,17102,12860,17102,312,132,180,6,6,3,3,0
49168,53,25368,53,196,102,94,2,30,1,1,0
26287,56205,0,0,62,62,0,1,0,1,0,1
52049,443,18143,443,7710,2476,5234,18,135,8,10,0
5151,50584,0,0,62,62,0,1,0,1,0,1
64823,53,49719,53,754,94,660,2,30,1,1,0
13021,25174,0,0,146,146,0,1,0,1,0,1
55921,53,32858,53,177,94,83,2,30,1,1,0
443,44683,0,0,83,83,0,1,0,1,0,1
1620,53567,0,0,62,62,0,1,0,1,0,1
49327,443,21395,443,116686,4968,111718,116,53,31,85,0
50652,445,0,0,70,70,0,1,0,1,0,2
443,50238,0,0,60,60,0,1,0,1,0,1
56640,445,0,0,66,66,0,1,0,1,0,2
49185,53,26156,53,307,94,213,2,29,1,1,0
51320,37965,0,0,62,62,0,1,0,1,0,1
60806,51050,0,0,66,66,0,1,0,1,0,1
50346,445,0,0,66,66,0,1,0,1,0,2
50164,445,0,0,66,66,0,1,0,1,0,2
49616,30188,0,0,66,66,0,1,0,1,0,1
23969,57470,0,0,62,62,0,1,0,1,0,1
63944,8999,41992,8999,70,70,0,1,5,1,0,0
53710,27935,34512,27935,70,70,0,1,4,1,0,0
53530,8999,38471,8999,70,70,0,2,7,2,0,0
64067,53,52701,53,329,94,235,2,29,1,1,0
53770,443,15341,443,499,425,74,4,0,3,1,0
53589,445,0,0,70,70,0,1,0,1,0,2
58771,53,58771,53,226,106,120,2,30,1,1,0
39827,443,61705,443,6128,3746,2382,48,46,25,23,0
53574,23650,56670,23650,320,140,180,6,5,3,3,0
38716,443,32682,443,90273,3481,86792,96,15,31,65,0
64950,53,1692,53,183,94,89,2,30,1,1,0
58802,443,8176,443,5167,700,4467,16,15,7,9,0
37893,53,0,0,86,86,0,1,30,1,0,0
53298,26467,0,0,66,66,0,1,0,1,0,1
57251,445,0,0,70,70,0,1,0,1,0,2
64344,445,0,0,66,66,0,1,0,1,0,2
45218,443,18311,443,16297,12965,3332,54,193,30,24,0
52487,443,29392,443,13734,3206,10528,26,150,13,13,0
64708,53,37304,53,437,89,348,4,48,2,2,0
58289,445,0,0,70,70,0,1,0,1,0,2
58768,443,60756,443,18568,12357,6211,43,18,24,19,0
58234,445,0,0,70,70,0,1,0,1,0,2
56698,443,46123,443,8058,2038,6020,20,15,11,9,0
64975,53,43514,53,198,94,104,2,30,1,1,0
49205,53,38111,53,188,96,92,2,31,1,1,0
62921,445,0,0,66,66,0,1,0,1,0,2
8211,28793,0,0,62,62,0,1,0,1,0,1
60775,443,60775,443,4652,1745,2907,19,29,11,8,0
0,0,0,0,244,244,0,2,0,2,0,0
63628,53,35423,53,289,86,203,2,30,1,1,0
53238,443,61389,443,13597,1371,12226,26,323,11,15,0
49224,80,15279,80,2999,2271,728,11,15,6,5,0
53395,445,0,0,66,66,0,1,0,1,0,2
56498,445,0,0,70,70,0,1,0,1,0,2
50477,80,59736,80,648,256,392,8,25,5,3,0
46108,48817,0,0,145,145,0,1,0,1,0,1
52401,443,47720,443,12402,3972,8430,46,138,26,20,0
54052,443,54052,443,1386,751,635,15,181,8,7,0
60658,445,0,0,70,70,0,1,0,1,0,2
49157,53,4191,53,184,94,90,2,30,1,1,0
55728,53,52425,53,195,102,93,2,30,1,1,0
56945,53,27105,53,176,90,86,2,31,1,1,0
52520,80,54295,80,3224,2776,448,11,15,7,4,0
49840,445,0,0,70,70,0,1,0,1,0,2
57275,53,32208,53,177,94,83,2,31,1,1,0
27773,56205,0,0,62,62,0,1,0,1,0,1
49333,25174,0,0,146,146,0,1,0,1,0,1
60960,49049,0,0,62,62,0,1,0,1,0,1
15056,2222,0,0,60,60,0,1,0,1,0,1
57052,53,38641,53,177,94,83,2,30,1,1,0
49633,53,1926,53,245,94,151,2,29,1,1,0
51304,445,0,0,70,70,0,1,0,1,0,2
49343,53,1518,53,209,110,99,2,30,1,1,0
56141,53,2789,53,184,94,90,2,31,1,1,0
58152,443,52749,443,5584,1168,4416,19,17,11,8,0
55534,53,23781,53,168,86,82,2,30,1,1,0
53546,46824,0,0,66,66,0,1,0,1,0,1
52176,445,0,0,70,70,0,1,0,1,0,2
56497,443,18628,443,1343,763,580,14,26,8,6,0
49012,443,59626,443,44584,2838,41746,66,31,31,35,0
30629,46783,0,0,145,145,0,1,0,1,0,1
31066,57470,0,0,74,74,0,1,0,1,0,1
42318,443,52319,443,10723,2046,8677,29,116,10,19,0
42298,40002,3434,40002,241,178,63,2,31,1,1,0
24037,443,24037,443,3611,2177,1434,24,17,13,11,0
51786,37832,29443,37832,70,70,0,1,5,1,0,0
51989,29736,26603,29736,160,70,90,2,5,1,1,0
55820,53,22468,53,184,94,90,2,29,1,1,0
64240,50584,0,0,66,66,0,1,0,1,0,1
57474,445,0,0,66,66,0,1,0,1,0,2
57334,53,51470,53,184,94,90,2,29,1,1,0
56007,53,24693,53,197,102,95,2,35,1,1,0
19245,64147,0,0,66,66,0,1,0,1,0,1
3052,20421,0,0,104,104,0,1,0,1,0,1
52288,443,59643,443,38314,11683,26631,76,34,38,38,0
49953,53,46343,53,214,110,104,2,30,1,1,0
58627,25174,0,0,62,62,0,1,0,1,0,1
51264,445,0,0,70,70,0,1,0,1,0,2
51882,443,57503,443,366,180,186,7,30,4,3,0
27153,992,0,0,60,60,0,1,0,1,0,1
56760,48386,9485,48386,268,70,198,4,19,1,3,0
58638,5900,58638,5900,126,62,64,2,5,1,1,0
52866,445,0,0,70,70,0,1,0,1,0,2
63464,443,19526,443,8543,1114,7429,26,93,11,15,0
42532,22114,0,0,62,62,0,1,0,1,0,1
49183,443,49342,443,473744,13158,460586,495,20,183,312,0
40510,1488,40510,1488,156,156,0,3,7,3,0,0
10089,80,55892,80,130,70,60,2,15,1,1,0
49863,8100,2379,8100,78,78,0,1,4,1,0,0
49317,53,16697,53,166,86,80,2,31,1,1,0
58638,5900,58638,5900,126,62,64,2,5,1,1,0
53890,443,45559,443,499,425,74,4,0,3,1,0
58060,445,0,0,70,70,0,1,0,1,0,2
7946,23,7946,23,130,66,64,2,5,1,1,0
52648,443,16992,443,64748,15327,49421,87,273,39,48,0
51595,443,19980,443,632,158,474,2,30,1,1,0
33886,65504,0,0,162,162,0,1,0,1,0,1
55629,42873,0,0,74,74,0,1,0,1,0,1
61739,445,0,0,70,70,0,1,0,1,0,2
55032,62413,0,0,66,66,0,1,0,1,0,1
4910,2149,0,0,66,66,0,1,0,1,0,1
39336,443,13653,443,4362,1145,3217,17,25,9,8,0
60155,23718,0,0,66,66,0,1,0,1,0,1
7347,56205,0,0,62,62,0,1,0,1,0,1
55538,445,0,0,70,70,0,1,0,1,0,2
56655,80,36577,80,234,234,0,4,12,4,0,0
50134,53,12196,53,768,99,669,2,30,1,1,0
64585,445,0,0,70,70,0,1,0,1,0,2
64666,445,0,0,70,70,0,1,0,1,0,2
25067,22114,0,0,146,146,0,1,0,1,0,1
49173,53,27694,53,214,110,104,2,30,1,1,0
51411,445,0,0,70,70,0,1,0,1,0,2
65080,53,11923,53,209,110,99,2,30,1,1,0
49831,30188,0,0,66,66,0,1,0,1,0,1
56071,53,32735,53,193,102,91,2,31,1,1,0
55851,445,0,0,70,70,0,1,0,1,0,2
51818,43942,60184,43942,156,66,90,2,5,1,1,0
50550,53,58594,53,168,78,90,2,30,1,1,0
49945,53,14331,53,281,97,184,4,56,2,2,0
53270,445,0,0,70,70,0,1,0,1,0,2
58666,53,17306,53,167,78,89,2,29,1,1,0
49174,50584,0,0,146,146,0,1,0,1,0,1
52682,22114,0,0,66,66,0,1,0,1,0,1
56215,53,29779,53,165,86,79,2,30,1,1,0
60306,443,28741,443,9188,3421,5767,43,83,19,24,0
54144,445,0,0,70,70,0,1,0,1,0,2
54903,445,0,0,70,70,0,1,0,1,0,2
53746,445,0,0,70,70,0,1,0,1,0,2
64612,53,64612,53,213,87,126,2,30,1,1,0
61404,445,0,0,70,70,0,1,0,1,0,2
64573,53,51074,53,184,94,90,2,30,1,1,0
26658,25174,0,0,62,62,0,1,0,1,0,1
53948,7370,62549,7370,70,70,0,1,5,1,0,0
50883,80,50883,80,514,246,268,9,42,5,4,0
62119,53,18352,53,239,102,137,2,30,1,1,0
50085,80,7079,80,3326,684,2642,12,15,7,5,0
56810,445,0,0,70,70,0,1,0,1,0,2
3478,61463,0,0,174,174,0,1,0,1,0,1
56367,44847,0,0,62,62,0,1,0,1,0,1
31738,51505,0,0,62,62,0,1,0,1,0,1
38448,443,13312,443,18512,3109,15403,45,48,22,23,0
50147,443,13714,443,9915,1833,8082,22,46,13,9,0
56528,443,48835,443,158084,6138,151946,173,95,64,109,0
49939,53,35198,53,231,102,129,2,29,1,1,0
64098,10096,50669,10096,70,70,0,1,4,1,0,0
38768,443,45644,443,7380,3474,3906,18,16,10,8,0
51762,12747,31596,12747,70,70,0,1,5,1,0,0
39617,50584,0,0,146,146,0,1,0,1,0,1
40465,443,49132,443,1053,566,487,10,47,6,4,0
36727,443,3578,443,27009,7414,19595,46,122,21,25,0
57882,443,30006,443,22342,1787,20555,38,177,16,22,0
56516,445,0,0,70,70,0,1,0,1,0,2
57043,53,5336,53,166,86,80,2,31,1,1,0
30188,63853,28721,63853,502,150,352,2,1200,1,1,0
56417,445,0,0,70,70,0,1,0,1,0,2
9448,443,19728,443,5691,503,5188,14,15,7,7,0
52274,443,52274,443,6679,2408,4271,23,20,10,13,0
58661,443,49876,443,2956,790,2166,10,120,5,5,0
63365,445,0,0,70,70,0,1,0,1,0,2
61613,445,0,0,66,66,0,1,0,1,0,2
63497,445,0,0,66,66,0,1,0,1,0,2
31176,53,31176,53,414,268,146,3,32,2,1,0
49008,53,13913,53,168,78,90,2,29,1,1,0
57253,443,15843,443,8613,2377,6236,41,17,23,18,0
49415,443,37841,443,9623,3235,6388,33,118,18,15,0
64623,445,0,0,66,66,0,1,0,1,0,2
49945,53,50921,53,281,97,184,4,58,2,2,0
33254,443,31595,443,4838,2974,1864,21,17,13,8,0
6881,6881,26370,6881,502,150,352,2,1200,1,1,0
55707,53,31512,53,177,94,83,2,30,1,1,0
44691,53,43758,53,199,94,105,2,30,1,1,0
63195,445,0,0,66,66,0,1,0,1,0,2
28579,64147,0,0,62,62,0,1,0,1,0,1
49419,443,41592,443,318,192,126,6,15,4,2,0
80,13743,80,13743,70,70,0,1,5,1,0,0
37487,25174,0,0,66,66,0,1,0,1,0,1
56432,80,52279,80,17128,1499,15629,24,25,9,15,0
53298,445,0,0,66,66,0,1,0,1,0,2
54880,445,0,0,70,70,0,1,0,1,0,2
37959,3855,0,0,72,72,0,1,0,1,0,1
49686,53,23134,53,183,94,89,2,30,1,1,0
50637,44847,0,0,62,62,0,1,0,1,0,1
53907,445,0,0,66,66,0,1,0,1,0,2
60864,80,22050,80,10629,1104,9525,23,46,12,11,0
8999,57470,0,0,146,146,0,1,0,1,0,1
64235,445,0,0,66,66,0,1,0,1,0,2
50006,445,0,0,70,70,0,1,0,1,0,2
38368,15000,38283,15000,130,70,60,2,5,1,1,0
49418,27015,40733,27015,242,78,164,2,30,1,1,0
52527,445,0,0,70,70,0,1,0,1,0,2
55026,443,35367,443,17336,5332,12004,33,121,18,15,0
52011,443,52011,443,110812,7779,103033,122,49,44,78,0
64105,6363,30786,6363,66,66,0,2,8,2,0,0
49876,80,23793,80,24764,4454,20310,30,88,12,18,0
64975,27033,50776,27033,734,462,272,2,30,1,1,0
58638,5900,0,0,62,62,0,1,0,1,0,1
21839,443,21839,443,13003,1226,11777,25,19,12,13,0
2525,23,0,0,60,60,0,1,0,1,0,1
58695,53,54969,53,392,86,306,2,30,1,1,0
61405,445,0,0,66,66,0,1,0,1,0,2
59504,445,0,0,70,70,0,1,0,1,0,2
49162,53,60010,53,182,93,89,2,31,1,1,0
41322,443,6156,443,994089,30018,964071,1058,350,373,685,0
64019,53,58991,53,267,94,173,2,30,1,1,0
52194,443,38386,443,12374,1090,11284,27,15,13,14,0
38323,443,27893,443,130,70,60,2,15,1,1,0
49208,53,8830,53,216,94,122,2,29,1,1,0
50106,31573,0,0,62,62,0,1,0,1,0,1
53835,62413,0,0,62,62,0,1,0,1,0,1
57883,443,47068,443,1786,1147,639,17,177,10,7,0
50487,445,0,0,70,70,0,1,0,1,0,2
50699,445,0,0,70,70,0,1,0,1,0,2
53419,28189,0,0,60,60,0,1,0,1,0,1
52217,22114,0,0,66,66,0,1,0,1,0,1
50684,80,2387,80,132,132,0,2,8,2,0,0
50517,80,5050,80,502,256,246,9,25,5,4,0
63852,25174,0,0,62,62,0,1,0,1,0,1
8734,56205,0,0,66,66,0,1,0,1,0,1
40780,80,6352,80,1155,781,374,10,16,6,4,0
34529,443,32303,443,77395,64623,12772,206,188,116,90,0
55234,443,6100,443,9176,2226,6950,28,31,16,12,0
64088,39650,57206,39650,66,66,0,2,7,2,0,0
64839,53,30697,53,443,182,261,6,30,3,3,0
52303,445,0,0,70,70,0,1,0,1,0,2
54306,443,48186,443,6376,1576,4800,24,19,13,11,0
60536,80,60536,80,318,120,198,6,25,3,3,0
65251,53,36655,53,277,98,179,4,36,2,2,0
54734,445,0,0,70,70,0,1,0,1,0,2
56043,445,0,0,70,70,0,1,0,1,0,2
60502,445,0,0,70,70,0,1,0,1,0,2
55344,53,18078,53,208,106,102,2,31,1,1,0
57978,5228,59102,5228,2725,1610,1115,20,3600,10,10,0
6932,80,6932,80,124405,3747,120658,131,38,46,85,0
51134,445,0,0,66,66,0,1,0,1,0,2
64955,443,38956,443,2279,1129,1150,25,120,12,13,0
65269,445,0,0,70,70,0,1,0,1,0,2
56852,445,0,0,70,70,0,1,0,1,0,2
53896,443,17824,443,499,425,74,4,0,3,1,0
55653,53,34737,53,199,102,97,2,30,1,1,0
65116,53,63214,53,200,94,106,2,30,1,1,0
57793,53,34542,53,168,78,90,2,31,1,1,0
59876,44847,0,0,66,66,0,1,0,1,0,1
55632,45682,28003,45682,70,70,0,2,8,2,0,0
13285,29892,0,0,145,145,0,1,0,1,0,1
60047,80,39100,80,2634,1780,854,14,142,8,6,0
57015,53,23440,53,363,102,261,2,30,1,1,0
54873,445,0,0,70,70,0,1,0,1,0,2
64410,445,0,0,70,70,0,1,0,1,0,2
25209,53,25209,53,240,98,142,2,30,1,1,0
64254,53,19864,53,197,94,103,2,30,1,1,0
56111,53,5335,53,179,94,85,2,30,1,1,0
44948,443,65427,443,4792,3072,1720,31,80,16,15,0
57287,443,20277,443,8960,2778,6182,31,20,16,15,0
49881,80,7229,80,1965,1450,515,7,87,5,2,0
58897,443,22242,443,5167,700,4467,16,14,7,9,0
63066,445,0,0,66,66,0,1,0,1,0,2
64100,445,0,0,70,70,0,1,0,1,0,2
50438,3389,50438,3389,3429,1474,1955,16,16,8,8,0
54488,443,26044,443,4967,2482,2485,26,271,13,13,0
56301,53,2529,53,177,94,83,2,30,1,1,0
56696,445,0,0,70,70,0,1,0,1,0,2
65316,445,0,0,70,70,0,1,0,1,0,2
60324,445,0,0,70,70,0,1,0,1,0,2
18017,25773,0,0,143,143,0,1,0,1,0,3
62085,445,0,0,70,70,0,1,0,1,0,2
49927,80,6147,80,1141,636,505,10,45,6,4,0
49558,53,38507,53,193,102,91,2,29,1,1,0
49562,443,59931,443,3380,346,3034,12,120,5,7,0
40549,443,33434,443,5591,3194,2397,16,122,8,8,0
58785,53,58785,53,216,90,126,2,30,1,1,0
55926,53,35022,53,184,94,90,2,30,1,1,0
49527,445,0,0,66,66,0,1,0,1,0,2
62679,445,0,0,70,70,0,1,0,1,0,2
45273,53,45273,53,213,79,134,2,32,1,1,0
55648,80,53307,80,70,70,0,2,8,2,0,0
10427,32480,0,0,66,66,0,1,0,1,0,1
54953,53,34688,53,263,94,169,2,30,1,1,0
64526,53,11461,53,377,94,283,2,30,1,1,0
55796,53,55796,53,253,99,154,2,32,1,1,0
50970,80,27517,80,1123476,15099,1108377,963,39,223,740,0
56965,53,44831,53,183,94,89,2,30,1,1,0
55944,53,48983,53,762,98,664,2,30,1,1,0
49386,53,12060,53,332,102,230,2,30,1,1,0
27005,27017,35476,27017,882,126,756,2,31,1,1,0
50038,53,65055,53,286,87,199,4,59,2,2,0
52787,443,46630,443,352,218,134,6,28,4,2,0
68,67,0,0,346,346,0,1,0,1,0,1
52688,445,0,0,70,70,0,1,0,1,0,2
27005,27024,9068,27024,1760,252,1508,5,31,3,2,0
56274,443,23756,443,3093,868,2225,10,120,5,5,0
56035,1310,0,0,66,66,0,1,0,1,0,1
64239,445,0,0,66,66,0,1,0,1,0,2
64859,53,38916,53,385,134,251,2,30,1,1,0
62527,445,0,0,70,70,0,1,0,1,0,2
52150,445,0,0,66,66,0,1,0,1,0,2
51691,445,0,0,70,70,0,1,0,1,0,2
56804,53,22833,53,760,96,664,2,31,1,1,0
50265,31101,44674,31101,150,150,0,1,1200,1,0,0
55025,53,42219,53,183,94,89,2,30,1,1,0
54460,445,0,0,66,66,0,1,0,1,0,2
50995,445,0,0,66,66,0,1,0,1,0,2
53193,445,0,0,70,70,0,1,0,1,0,2
40312,55442,0,0,62,62,0,1,0,1,0,1
52177,25320,0,0,66,66,0,1,0,1,0,1
55538,53,14832,53,195,102,93,2,30,1,1,0
38433,443,38484,443,33344,25806,7538,105,130,56,49,0
56864,53,8861,53,200,102,98,2,30,1,1,0
40403,53,40667,53,199,94,105,2,30,1,1,0
34246,53,34246,53,217,87,130,2,31,1,1,0
51938,445,0,0,70,70,0,1,0,1,0,2
50629,445,0,0,66,66,0,1,0,1,0,2
16230,53,64249,53,223,78,145,2,30,1,1,0
26852,443,37860,443,6701,2064,4637,19,19,9,10,0
42810,443,64537,443,9265,2134,7131,24,123,12,12,0
56356,53,61835,53,184,102,82,2,30,1,1,0
51815,51221,0,0,74,74,0,1,0,1,0,1
52740,51505,0,0,66,66,0,1,0,1,0,1
49001,40108,0,0,161,161,0,1,0,1,0,1
56322,53,0,0,166,73,93,2,31,1,1,0
47030,81,0,0,60,60,0,1,0,1,0,1
11136,19910,0,0,62,62,0,1,0,1,0,1
53841,8999,39565,8999,70,70,0,1,4,1,0,0
38568,443,10055,443,11418,1999,9419,28,22,13,15,0
52915,445,0,0,66,66,0,1,0,1,0,2
46985,443,26507,443,4957,3488,1469,25,51,15,10,0
10038,443,58313,443,7481,2070,5411,25,315,12,13,0
51208,443,57276,443,8886,2767,6119,52,17,28,24,0
61687,80,48451,80,11437,2775,8662,32,53,15,17,0
52160,49212,45447,49212,316,136,180,6,6,3,3,0
55109,445,0,0,70,70,0,1,0,1,0,2
3407,57866,0,0,66,66,0,1,0,1,0,1
137,137,20437,137,384,384,0,5,51,5,0,0
26502,64147,0,0,62,62,0,1,0,1,0,1
54446,445,0,0,66,66,0,1,0,1,0,2
64048,44918,54494,44918,70,70,0,1,4,1,0,0
63182,445,0,0,70,70,0,1,0,1,0,2
50318,53,54870,53,94,94,0,1,30,1,0,0
50698,5900,50698,5900,130,66,64,2,5,1,1,0
59133,443,44471,443,2863,1501,1362,20,315,10,10,0
55847,445,0,0,70,70,0,1,0,1,0,2
51311,22,51311,22,5624,2099,3525,30,23,17,13,0
61270,445,0,0,70,70,0,1,0,1,0,2
6122,23,0,0,60,60,0,1,0,1,0,1
64990,445,0,0,70,70,0,1,0,1,0,2
56478,53,6625,53,177,94,83,2,29,1,1,0
57675,445,0,0,70,70,0,1,0,1,0,2
50327,445,0,0,70,70,0,1,0,1,0,2
56336,53,15481,53,489,88,401,4,46,2,2,0
49337,53,4969,53,303,97,206,4,56,2,2,0
50113,51505,0,0,62,62,0,1,0,1,0,1
61392,50584,0,0,146,146,0,1,0,1,0,1
50423,445,0,0,70,70,0,1,0,1,0,2
49265,445,0,0,70,70,0,1,0,1,0,2
64929,53,8681,53,168,86,82,2,31,1,1,0
53907,45622,50876,45622,70,70,0,2,7,2,0,0
58828,53,32002,53,215,102,113,2,30,1,1,0
49125,53,10970,53,168,78,90,2,30,1,1,0
54447,53,9967,53,199,94,105,2,29,1,1,0
57441,53,9760,53,177,94,83,2,29,1,1,0
53726,445,0,0,70,70,0,1,0,1,0,2
50011,53,8163,53,272,110,162,2,30,1,1,0
40204,40028,12239,40028,143,81,62,2,30,1,1,0
56959,445,0,0,70,70,0,1,0,1,0,2
50740,445,0,0,66,66,0,1,0,1,0,2
50614,445,0,0,66,66,0,1,0,1,0,2
64691,445,0,0,70,70,0,1,0,1,0,2
55535,80,6697,80,18450,1862,16588,29,17,15,14,0
43222,443,24936,443,2088188,38201,2049987,1829,84,404,1425,0
59355,51505,0,0,66,66,0,1,0,1,0,1
31021,35440,0,0,146,146,0,1,0,1,0,1
49530,53,54763,53,265,102,163,2,30,1,1,0
49418,27016,31344,27016,250,78,172,2,31,1,1,0
40215,443,50672,443,5656,1009,4647,24,87,10,14,0
64054,53,34990,53,183,94,89,2,30,1,1,0
37965,58043,10741,58043,6029,3652,2377,79,3221,45,34,0
50872,445,0,0,70,70,0,1,0,1,0,2
54442,445,0,0,66,66,0,1,0,1,0,2
52973,23,0,0,60,60,0,1,0,1,0,1
56272,53,59359,53,167,86,81,2,31,1,1,0
59952,445,0,0,70,70,0,1,0,1,0,2
51691,5543,12224,5543,70,70,0,1,5,1,0,0
6999,2310,0,0,143,143,0,1,0,1,0,1
58638,5900,0,0,62,62,0,1,0,1,0,1
58898,443,10940,443,5108,700,4408,15,15,7,8,0
49456,53,27659,53,360,110,250,2,29,1,1,0
55836,53,17150,53,181,94,87,2,33,1,1,0
59476,445,0,0,70,70,0,1,0,1,0,2
63514,445,0,0,66,66,0,1,0,1,0,2
51403,443,43951,443,334,70,264,5,17,1,4,0
50488,22114,0,0,62,62,0,1,0,1,0,1
57281,53,42469,53,172,88,84,2,30,1,1,0
2707,37,0,0,60,60,0,1,0,1,0,1
65120,445,0,0,66,66,0,1,0,1,0,2
49209,52030,14863,52030,66,66,0,1,5,1,0,0
63245,26296,0,0,159,159,0,1,0,1,0,1
46570,443,45902,443,8897,2184,6713,24,516,13,11,0
62825,445,0,0,70,70,0,1,0,1,0,2
53306,53,0,0,86,86,0,1,29,1,0,0
3584,25174,0,0,146,146,0,1,0,1,0,1
49736,443,65019,443,52574,2783,49791,61,129,19,42,0
6824,26467,0,0,62,62,0,1,0,1,0,1
56719,445,0,0,66,66,0,1,0,1,0,2
57691,445,0,0,70,70,0,1,0,1,0,2
57069,53,40804,53,1335,87,1248,4,32,2,2,0
65386,53,49656,53,197,102,95,2,33,1,1,0
2362,53,2362,53,225,90,135,2,30,1,1,0
50426,53,48591,53,889,404,485,10,30,5,5,0
39051,443,15445,443,7082,4527,2555,31,31,16,15,0
57256,445,0,0,70,70,0,1,0,1,0,2
55182,53,17791,53,199,102,97,2,30,1,1,0
63621,30188,0,0,62,62,0,1,0,1,0,1
60665,445,0,0,66,66,0,1,0,1,0,2
61152,445,0,0,66,66,0,1,0,1,0,2
53893,11344,38662,11344,70,70,0,1,5,1,0,0
65110,53,12122,53,754,191,563,6,51,3,3,0
64114,53,0,0,200,90,110,2,30,1,1,0
61753,445,0,0,70,70,0,1,0,1,0,2
51902,445,0,0,70,70,0,1,0,1,0,2
49211,53,35833,53,484,100,384,4,56,2,2,0
55705,53,6400,53,281,101,180,4,60,2,2,0
20608,28189,0,0,60,60,0,1,0,1,0,1
49632,53,30803,53,198,101,97,2,30,1,1,0
52191,443,40696,443,7018,1766,5252,23,19,13,10,0
52112,22114,0,0,66,66,0,1,0,1,0,1
52076,44847,0,0,66,66,0,1,0,1,0,1
65037,53,41367,53,210,110,100,2,29,1,1,0
50854,445,0,0,70,70,0,1,0,1,0,2
51937,38056,49622,38056,66,66,0,1,5,1,0,0
55724,445,0,0,70,70,0,1,0,1,0,2
49573,443,10413,443,1326,876,450,11,55,6,5,0
60795,40010,57308,40010,316,136,180,6,6,3,3,0
5588,5588,0,0,3562,1936,1626,48,196,24,24,0
53830,445,0,0,70,70,0,1,0,1,0,2
61294,445,0,0,66,66,0,1,0,1,0,2
52018,53,53682,53,164,78,86,2,30,1,1,0
61146,445,0,0,70,70,0,1,0,1,0,2
49404,53,23314,53,200,94,106,2,30,1,1,0
49515,80,17973,80,5101,2867,2234,15,38,8,7,0
40923,53,40923,53,200,90,110,2,29,1,1,0
49611,53,14294,53,184,94,90,2,30,1,1,0
51731,57470,0,0,78,78,0,1,0,1,0,1
24311,22617,0,0,60,60,0,1,0,1,0,1
60075,41705,0,0,62,62,0,1,0,1,0,1
61929,445,0,0,70,70,0,1,0,1,0,2
49962,53,28111,53,184,94,90,2,30,1,1,0
52187,38153,15114,38153,70,70,0,2,9,2,0,0
6881,6881,14892,6881,502,150,352,2,1200,1,1,0
39475,443,29487,443,3310,2291,1019,17,16,10,7,0
65437,53,38141,53,195,102,93,2,29,1,1,0
41931,443,53560,443,8579,2273,6306,17,136,8,9,0
51171,445,0,0,70,70,0,1,0,1,0,2
58974,443,58974,443,6792,1521,5271,18,28,11,7,0
61642,445,0,0,70,70,0,1,0,1,0,2
19698,502,0,0,60,60,0,1,0,1,0,1
63027,35440,0,0,66,66,0,1,0,1,0,1
50624,445,0,0,70,70,0,1,0,1,0,2
51581,17546,0,0,66,66,0,1,0,1,0,1
60604,445,0,0,70,70,0,1,0,1,0,2
52071,57491,38679,57491,70,70,0,1,5,1,0,0
57333,53,41487,53,258,110,148,2,31,1,1,0
61945,48817,0,0,66,66,0,1,0,1,0,1
54968,53,59116,53,199,102,97,2,30,1,1,0
55039,443,27278,443,8209,2789,5420,24,42,14,10,0
58338,3353,0,0,60,60,0,1,0,1,0,1
52011,80,26180,80,23580,10536,13044,36,39,18,18,0
57251,37965,0,0,62,62,0,1,0,1,0,1
64276,53,39382,53,197,102,95,2,29,1,1,0
9231,443,14526,443,4942,429,4513,12,15,6,6,0
58842,443,44558,443,16260,10863,5397,39,19,21,18,0
55152,53,27991,53,176,90,86,2,30,1,1,0
1025,50584,0,0,146,146,0,1,0,1,0,1
60135,445,0,0,70,70,0,1,0,1,0,2
60923,49903,0,0,66,66,0,1,0,1,0,1
56176,53,54476,53,177,94,83,2,30,1,1,0
58795,443,29024,443,19700,12992,6708,44,18,23,21,0
53869,17089,2091,17089,70,70,0,2,7,2,0,0
21268,62609,0,0,146,146,0,1,0,1,0,1
56794,46824,0,0,66,66,0,1,0,1,0,1
50035,445,0,0,70,70,0,1,0,1,0,2
64266,445,0,0,70,70,0,1,0,1,0,2
57276,445,0,0,70,70,0,1,0,1,0,2
65480,443,49360,443,310863,9840,301023,323,16,115,208,0
33257,443,43255,443,19341,4612,14729,38,21,19,19,0
24480,35440,0,0,62,62,0,1,0,1,0,1
52277,80,52277,80,259496,6676,252820,249,28,74,175,0
443,44683,0,0,83,83,0,1,0,1,0,1
57281,53,55108,53,178,94,84,2,30,1,1,0
56756,443,1855,443,7565,2187,5378,27,24,15,12,0
60011,443,31949,443,6053,2582,3471,30,80,15,15,0
57399,445,0,0,66,66,0,1,0,1,0,2
59234,21247,0,0,62,62,0,1,0,1,0,1
64472,53,45709,53,183,94,89,2,30,1,1,0
56731,53,43957,53,173,94,79,2,31,1,1,0
56652,53,9807,53,177,94,83,2,30,1,1,0
49426,53,14946,53,492,91,401,4,56,2,2,0
51761,445,0,0,66,66,0,1,0,1,0,2
63779,26467,0,0,66,66,0,1,0,1,0,1
64959,53,63198,53,245,102,143,2,31,1,1,0
56732,10271,46976,10271,3090,1706,1384,16,30,10,6,0
64129,445,0,0,70,70,0,1,0,1,0,2
18246,64097,0,0,66,66,0,1,0,1,0,1
57147,53,63811,53,166,86,80,2,29,1,1,0
48745,443,43215,443,229628,10653,218975,263,49,103,160,0
55275,445,0,0,70,70,0,1,0,1,0,2
50678,80,52506,80,1549,1097,452,9,21,5,4,0
62316,445,0,0,66,66,0,1,0,1,0,2
65045,53,47072,53,755,94,661,2,30,1,1,0
60259,443,51277,443,3285,2009,1276,26,150,16,10,0
59144,445,0,0,70,70,0,1,0,1,0,2
44351,53,3058,53,168,78,90,2,30,1,1,0
15503,52798,43633,52798,28448,16525,11923,253,3696,148,105,0
57659,80,4317,80,742,140,602,12,409,3,9,0
50947,445,0,0,66,66,0,1,0,1,0,2
27005,27015,4428,27015,884,126,758,2,31,1,1,0
54926,6789,33904,6789,124239,48650,75589,1342,84,628,714,0
49963,53,30474,53,279,96,183,4,58,2,2,0
55673,445,0,0,66,66,0,1,0,1,0,2
64303,53,30875,53,298,87,211,4,34,2,2,0
39107,443,62182,443,692830,23263,669567,784,114,306,478,0
40781,443,27911,443,362,302,60,2,5,1,1,0
26793,3389,26793,3389,293,223,70,4,1,3,1,3
54166,25174,0,0,66,66,0,1,0,1,0,1
52522,445,0,0,70,70,0,1,0,1,0,2
54957,53,30594,53,197,102,95,2,33,1,1,0
55669,62781,37625,62781,320,140,180,6,7,3,3,0
49777,53,45833,53,166,86,80,2,31,1,1,0
52412,445,0,0,66,66,0,1,0,1,0,2
57601,80,57601,80,25872,4400,21472,41,38,16,25,0
54792,443,48996,443,9515,2231,7284,25,22,14,11,0
49532,53,40570,53,195,102,93,2,30,1,1,0
64535,37965,0,0,62,62,0,1,0,1,0,1
58638,5900,0,0,62,62,0,1,0,1,0,1
55562,53,27476,53,239,94,145,2,29,1,1,0
56929,53,5055,53,170,87,83,2,30,1,1,0
51831,80,34274,80,486,300,186,9,31,6,3,0
52946,80,25585,80,2043,1331,712,13,17,7,6,0
56231,80,56231,80,44747,815,43932,45,15,12,33,0
55044,443,65434,443,14427,4574,9853,34,61,18,16,0
58638,5900,0,0,62,62,0,1,0,1,0,1
12709,51505,0,0,62,62,0,1,0,1,0,1
55669,53,4616,53,784,94,690,2,30,1,1,0
58798,443,46435,443,5167,700,4467,16,15,7,9,0
56400,35440,0,0,66,66,0,1,0,1,0,1
58859,445,0,0,70,70,0,1,0,1,0,2
65226,53,19267,53,79,79,0,2,34,2,0,0
60293,53,33499,53,312,78,234,2,30,1,1,0
51907,80,10230,80,9189,3144,6045,19,28,11,8,0
57033,53,53118,53,216,110,106,2,30,1,1,0
42487,443,53584,443,4887,895,3992,16,29,9,7,0
32342,62413,0,0,66,66,0,1,0,1,0,1
61597,445,0,0,66,66,0,1,0,1,0,2
34219,53,25349,53,199,94,105,2,30,1,1,0
58638,5900,0,0,62,62,0,1,0,1,0,1
50264,443,29730,443,430,60,370,7,24,2,5,0
4110,35440,0,0,66,66,0,1,0,1,0,1
48632,443,58774,443,12433,4515,7918,32,136,17,15,0
46085,443,28925,443,13018,2021,10997,34,95,14,20,0
37075,80,46978,80,1678,1364,314,10,15,5,5,0
64985,53,36411,53,192,98,94,2,30,1,1,0
64840,53,31006,53,186,95,91,2,31,1,1,0
49984,53,41486,53,172,88,84,2,30,1,1,0
63467,37807,0,0,62,62,0,1,0,1,0,1
52726,445,0,0,66,66,0,1,0,1,0,2
60235,443,27735,443,7990,1730,6260,25,151,13,12,0
52870,22197,0,0,66,66,0,1,0,1,0,1
49757,445,0,0,70,70,0,1,0,1,0,2
64116,53,45149,53,267,94,173,4,59,2,2,0
51917,80,25082,80,43399,5061,38338,55,29,24,31,0
53301,11000,8510,11000,1642,822,820,5,30,1,4,0
58784,443,58898,443,41305,2456,38849,63,30,29,34,0
57431,53,35038,53,392,134,258,2,30,1,1,0
57402,9992,42519,9992,47040,13931,33109,428,129,207,221,0
49869,80,37142,80,2125,1041,1084,11,87,6,5,0
65501,53,1213,53,226,94,132,2,29,1,1,0
60741,443,38588,443,2042,559,1483,20,89,6,14,0
9522,51505,0,0,66,66,0,1,0,1,0,1
39948,5223,55367,5223,5551,1338,4213,28,1323,11,17,0
55195,53,34217,53,969,86,883,2,29,1,1,0
64066,80,28023,80,314,192,122,6,15,4,2,0
8889,21251,0,0,60,60,0,1,0,1,0,1
62060,443,7381,443,12169,4985,7184,34,52,19,15,0
60391,47212,53433,47212,258,70,188,4,8,2,2,0
61880,445,0,0,70,70,0,1,0,1,0,2
55372,53,7739,53,448,184,264,6,30,3,3,0
52177,443,52177,443,38013,6855,31158,58,21,25,33,0
56621,80,4891,80,234,234,0,4,12,4,0,0
49445,80,19716,80,1586,808,778,13,45,7,6,0
57087,445,0,0,70,70,0,1,0,1,0,2
60287,80,59923,80,10135,7433,2702,28,164,19,9,0
36108,8245,12106,8245,280,214,66,2,29,1,1,0
59788,443,42215,443,162,102,60,2,5,1,1,0
52858,443,52858,443,313243,267937,45306,456,5925,210,246,0
54693,30188,0,0,62,62,0,1,0,1,0,1
65221,53,28071,53,196,86,110,2,30,1,1,0
65321,53,36858,53,167,86,81,2,29,1,1,0
49242,443,26105,443,4528,803,3725,14,15,8,6,0
55021,443,3999,443,5987,1556,4431,19,47,12,7,0
65201,53,38349,53,216,110,106,2,30,1,1,0
51132,80,62444,80,426,240,186,8,21,5,3,0
49890,443,3826,443,6370237,150385,6219852,6047,138,1688,4359,0
51595,443,49515,443,10614,5312,5302,25,91,14,11,0
6881,6881,2586,6881,237,118,119,2,1200,1,1,0
47150,9339,62687,9339,179194,19657,159537,415,149,202,213,0
63762,41373,50271,41373,66,66,0,2,8,2,0,0
58249,445,0,0,66,66,0,1,0,1,0,2
49805,443,42807,443,2839,1654,1185,15,126,9,6,0
49168,445,0,0,70,70,0,1,0,1,0,2
52549,445,0,0,70,70,0,1,0,1,0,2
12567,23,0,0,60,60,0,1,0,1,0,1
42252,33303,0,0,60,60,0,1,0,1,0,1
65454,61600,0,0,66,66,0,1,0,1,0,1
49990,443,43414,443,622,210,412,10,21,4,6,0
65236,445,0,0,70,70,0,1,0,1,0,2
60817,443,60817,443,1320,685,635,14,180,7,7,0
52120,443,51831,443,305183,9715,295468,312,44,107,205,0
60000,80,0,0,60,60,0,1,0,1,0,1
57246,53,12592,53,183,94,89,2,30,1,1,0
49555,53,24625,53,193,102,91,2,30,1,1,0
56853,13203,65279,13203,316,136,180,6,6,3,3,0
39915,443,44120,443,6922156,117604,6804552,6122,50,1519,4603,0
49160,6889,59737,6889,834,150,684,4,1200,2,2,0
65487,443,51445,443,3641,886,2755,13,136,6,7,0
39324,64147,0,0,62,62,0,1,0,1,0,1
61408,30188,0,0,66,66,0,1,0,1,0,1
48755,443,25931,443,6423,1145,5278,19,33,11,8,0
64854,53,19682,53,178,94,84,2,31,1,1,0
65318,53,16200,53,395,102,293,2,30,1,1,0
45402,80,27119,80,573,499,74,6,15,5,1,0
2572,17546,0,0,66,66,0,1,0,1,0,1
51959,445,0,0,66,66,0,1,0,1,0,2
46424,443,29456,443,1340,760,580,14,39,8,6,0
64026,53,1792,53,211,102,109,2,30,1,1,0
60411,58131,27448,58131,70,70,0,1,5,1,0,0
57789,445,0,0,66,66,0,1,0,1,0,2
53866,443,56444,443,499,425,74,4,1,3,1,0
29300,35440,0,0,62,62,0,1,0,1,0,1
55306,53,39881,53,177,94,83,2,30,1,1,0
37335,443,14228,443,130,70,60,3,5,2,1,0
57929,53,0,0,294,86,208,2,30,1,1,0
42298,40032,22903,40032,720,549,171,4,30,2,2,0
61147,22114,0,0,62,62,0,1,0,1,0,1
65423,443,16318,443,5854,1796,4058,21,142,10,11,0
35515,53,6694,53,199,94,105,2,29,1,1,0
57436,53,11754,53,728,102,626,2,29,1,1,0
50737,445,0,0,70,70,0,1,0,1,0,2
65152,53,43515,53,170,87,83,2,30,1,1,0
55030,443,37524,443,5372,1221,4151,23,18,14,9,0
57099,53,12968,53,278,102,176,2,31,1,1,0
37148,53,21111,53,164,78,86,2,30,1,1,0
52100,443,58970,443,190,70,120,4,15,2,2,0
59699,55783,0,0,62,62,0,1,0,1,0,1
56118,445,0,0,70,70,0,1,0,1,0,2
60657,445,0,0,70,70,0,1,0,1,0,2
61960,445,0,0,70,70,0,1,0,1,0,2
60376,443,40016,443,6608,1843,4765,44,120,23,21,0
53293,445,0,0,66,66,0,1,0,1,0,2
42348,53,29230,53,199,94,105,2,30,1,1,0
58638,5900,0,0,62,62,0,1,0,1,0,1
63732,40642,2876,40642,70,70,0,1,5,1,0,0
50350,445,0,0,70,70,0,1,0,1,0,2
55826,42771,0,0,66,66,0,1,0,1,0,1
33898,80,33898,80,14448,2001,12447,26,16,14,12,0
58533,443,53373,443,17356,5096,12260,46,26,24,22,0
61729,445,0,0,70,70,0,1,0,1,0,2
38700,53,38476,53,164,78,86,2,30,1,1,0
59980,443,52666,443,345468,18536,326932,432,22,200,232,0
10775,35440,0,0,66,66,0,1,0,1,0,1
55060,123,26864,123,184,94,90,2,30,1,1,0
26900,27017,45404,27017,422,164,258,6,30,3,3,0
55000,53,36007,53,193,102,91,2,31,1,1,0
59876,44847,0,0,66,66,0,1,0,1,0,1
50901,26467,0,0,66,66,0,1,0,1,0,1
20746,53,43830,53,191,86,105,2,30,1,1,0
34366,443,52089,443,520306,17622,502684,582,210,210,372,0
49372,53,57735,53,210,110,100,2,30,1,1,0
38544,161,0,0,8977,3570,5407,30,31,15,15,0
49418,30006,39633,30006,244,71,173,2,30,1,1,0
51691,993,8747,993,17462,4583,12879,93,19,47,46,0
51221,65264,24402,65264,870,330,540,12,1573,6,6,0
63331,51221,0,0,62,62,0,1,0,1,0,1
56839,49949,49715,49949,70,70,0,1,5,1,0,0
53646,16561,53092,16561,422,140,282,6,15,3,3,0
59726,53,53950,53,304,86,218,2,30,1,1,0
57593,80,6872,80,486,280,206,8,26,5,3,0
27005,27023,4968,27023,1640,126,1514,4,30,2,2,0
59136,50584,0,0,62,62,0,1,0,1,0,1
54700,445,0,0,66,66,0,1,0,1,0,2
34600,80,41483,80,3089,775,2314,15,16,9,6,0
59230,445,0,0,70,70,0,1,0,1,0,2
51651,445,0,0,66,66,0,1,0,1,0,2
60187,443,13141,443,9875,1112,8763,21,125,10,11,0
55084,445,0,0,70,70,0,1,0,1,0,2
65104,53,46686,53,311,94,217,2,30,1,1,0
63237,445,0,0,70,70,0,1,0,1,0,2
42309,443,23092,443,7295,1469,5826,30,360,9,21,0
61804,51505,0,0,66,66,0,1,0,1,0,1
50441,80,50441,80,79227,5480,73747,89,19,32,57,0
51697,445,0,0,66,66,0,1,0,1,0,2
65232,445,0,0,66,66,0,1,0,1,0,2
56639,53,47791,53,168,86,82,2,32,1,1,0
6121,51505,0,0,66,66,0,1,0,1,0,1
60749,40010,57224,40010,316,136,180,6,5,3,3,0
56664,443,21855,443,8005,1985,6020,20,15,11,9,0
50858,445,0,0,70,70,0,1,0,1,0,2
56266,53,11208,53,193,102,91,2,30,1,1,0
37965,16153,40075,16153,1320,1320,0,21,1682,21,0,0
62139,445,0,0,70,70,0,1,0,1,0,2
47821,443,31829,443,71624,60795,10829,194,131,110,84,0
56110,53,15545,53,508,102,406,2,30,1,1,0
55056,80,26189,80,306,180,126,6,26,4,2,0
50438,53,15254,53,296,101,195,4,31,2,2,0
56878,443,56878,443,27657,5506,22151,58,46,30,28,0
55015,443,24425,443,22687,6933,15754,50,50,26,24,0
46587,57470,0,0,66,66,0,1,0,1,0,1
59211,445,0,0,66,66,0,1,0,1,0,2
58638,5900,0,0,62,62,0,1,0,1,0,1
58627,64097,0,0,62,62,0,1,0,1,0,1
63055,445,0,0,70,70,0,1,0,1,0,2
43479,443,6073,443,6990,2019,4971,29,20,16,13,0
7360,14914,0,0,157,157,0,1,0,1,0,1
57888,445,0,0,70,70,0,1,0,1,0,2
52020,80,52020,80,6764,5555,1209,20,28,12,8,0
37004,80,37004,80,13825,1203,12622,22,29,9,13,0
49182,21247,0,0,62,62,0,1,0,1,0,1
49516,445,0,0,70,70,0,1,0,1,0,2
53213,80,60340,80,18040,904,17136,22,15,7,15,0
61461,50584,0,0,62,62,0,1,0,1,0,1
55107,53,60741,53,184,94,90,2,29,1,1,0
49815,53,3379,53,789,110,679,2,31,1,1,0
57117,53,45575,53,366,102,264,4,46,2,2,0
49628,53,54412,53,168,86,82,2,30,1,1,0
55940,445,0,0,70,70,0,1,0,1,0,2
57005,53,13005,53,199,94,105,2,30,1,1,0
49203,53,20527,53,168,86,82,2,31,1,1,0
80,9918,0,0,60,60,0,1,0,1,0,1
51676,445,0,0,70,70,0,1,0,1,0,2
58701,445,0,0,70,70,0,1,0,1,0,2
52450,443,52450,443,4750,1843,2907,19,26,11,8,0
51444,443,44166,443,7658,1309,6349,24,75,13,11,0
49376,53,53542,53,209,110,99,2,30,1,1,0
27528,35440,0,0,66,66,0,1,0,1,0,1
61918,445,0,0,66,66,0,1,0,1,0,2
51131,445,0,0,70,70,0,1,0,1,0,2
56127,53,8590,53,166,85,81,2,31,1,1,0
58022,1471,0,0,60,60,0,1,0,1,0,1
58029,443,3427,443,1312,651,661,13,185,7,6,0
25348,23,0,0,60,60,0,1,0,1,0,1
53147,26330,14316,26330,70,70,0,2,8,2,0,0
54961,53,50012,53,211,102,109,2,29,1,1,0
64091,53,16270,53,178,94,84,2,30,1,1,0
12537,28816,0,0,145,145,0,1,0,1,0,1
50622,53,57483,53,185,102,83,2,30,1,1,0
51413,54351,0,0,136,136,0,1,0,1,0,1
49951,53,52674,53,525,110,415,2,30,1,1,0
52772,445,0,0,70,70,0,1,0,1,0,2
53255,445,0,0,70,70,0,1,0,1,0,2
56046,53,6511,53,193,102,91,2,31,1,1,0
53924,45212,48371,45212,70,70,0,2,8,2,0,0
53720,443,24279,443,499,425,74,4,0,3,1,0
64104,53,54315,53,288,101,187,4,58,2,2,0
48908,53,48908,53,398,255,143,3,32,2,1,0
64693,53,60951,53,766,102,664,2,30,1,1,0
61527,443,62594,443,17161,1619,15542,18,143,4,14,0
62571,445,0,0,70,70,0,1,0,1,0,2
46864,25174,0,0,146,146,0,1,0,1,0,1
27368,22114,0,0,146,146,0,1,0,1,0,1
6881,39927,58260,39927,228,118,110,2,1199,1,1,0
55533,53,2426,53,183,94,89,2,30,1,1,0
42732,57470,0,0,62,62,0,1,0,1,0,1
41292,443,17156,443,7644,1098,6546,19,35,10,9,0
49189,445,0,0,70,70,0,1,0,1,0,2
49249,445,0,0,70,70,0,1,0,1,0,2
35642,80,28559,80,1849,1015,834,11,150,6,5,0
42607,443,6741,443,10221,3259,6962,36,120,18,18,0
58638,5900,0,0,62,62,0,1,0,1,0,1
64935,53,15324,53,193,102,91,2,31,1,1,0
27679,37965,0,0,62,62,0,1,0,1,0,1
55318,53,35151,53,166,85,81,2,30,1,1,0
9443,443,55182,443,7398,1480,5918,24,39,12,12,0
53294,445,0,0,66,66,0,1,0,1,0,2
57324,445,0,0,70,70,0,1,0,1,0,2
49966,80,31375,80,1210,788,422,9,33,5,4,0
26900,27017,48615,27017,422,164,258,6,30,3,3,0
56468,53,3693,53,180,94,86,2,30,1,1,0
50497,443,60901,443,1322,725,597,14,78,7,7,0
51226,445,0,0,70,70,0,1,0,1,0,2
57940,24748,0,0,148,148,0,1,0,1,0,1
55164,53,64984,53,177,94,83,2,30,1,1,0
55166,445,0,0,66,66,0,1,0,1,0,2
64319,53,63281,53,193,102,91,2,29,1,1,0
45908,33330,0,0,60,60,0,1,0,1,0,1
33150,53,63816,53,816,228,588,8,29,4,4,0
58774,443,50443,443,7254,838,6416,27,290,9,18,0
55641,61762,32816,61762,70,70,0,2,8,2,0,0
51925,29587,42996,29587,70,70,0,2,8,2,0,0
64817,53,59265,53,199,94,105,2,29,1,1,0
50584,51414,36185,51414,475,150,325,2,1200,1,1,0
59422,51221,0,0,62,62,0,1,0,1,0,1
62662,445,0,0,70,70,0,1,0,1,0,2
51870,40490,51955,40490,70,70,0,1,5,1,0,0
53318,445,0,0,70,70,0,1,0,1,0,2
53521,8999,10502,8999,312,186,126,5,15,3,2,0
54948,445,0,0,70,70,0,1,0,1,0,2
52311,445,0,0,70,70,0,1,0,1,0,2
58058,445,0,0,70,70,0,1,0,1,0,2
49878,53,34561,53,216,94,122,2,30,1,1,0
34331,53,34331,53,404,259,145,3,32,2,1,0
54124,80,4965,80,1594,1280,314,10,15,5,5,0
65485,53,57081,53,184,94,90,2,31,1,1,0
57069,53,52685,53,177,94,83,2,31,1,1,0
64231,443,45459,443,2227,1018,1209,17,16,8,9,0
55272,53,54690,53,198,110,88,2,29,1,1,0
61927,445,0,0,66,66,0,1,0,1,0,2
55573,445,0,0,70,70,0,1,0,1,0,2
21846,53,21846,53,247,98,149,2,33,1,1,0
56640,443,54047,443,8735,1819,6916,23,30,14,9,0
49978,53,17082,53,195,102,93,2,31,1,1,0
64877,53,24531,53,309,110,199,2,30,1,1,0
50927,445,0,0,66,66,0,1,0,1,0,2
7749,36237,0,0,62,62,0,1,0,1,0,1
49771,53,57877,53,177,94,83,2,29,1,1,0
53289,445,0,0,66,66,0,1,0,1,0,2
62479,443,46621,443,14673,3914,10759,31,27,14,17,0
57200,53,48391,53,711,87,624,2,30,1,1,0
49915,35440,0,0,62,62,0,1,0,1,0,1
61298,445,0,0,70,70,0,1,0,1,0,2
49654,22,49654,22,7791,3373,4418,54,36,26,28,0
53577,8999,47694,8999,372,186,186,6,15,3,3,0
58402,445,0,0,70,70,0,1,0,1,0,2
58421,30188,0,0,66,66,0,1,0,1,0,1
64980,445,0,0,70,70,0,1,0,1,0,2
8999,57099,0,0,146,146,0,1,0,1,0,1
25297,11530,0,0,145,145,0,1,0,1,0,1
57594,443,61887,443,291,171,120,4,15,2,2,0
64581,53,16875,53,214,110,104,2,29,1,1,0
59630,443,48650,443,3304,1468,1836,18,139,10,8,0
55635,38649,44116,38649,70,70,0,1,5,1,0,0
52914,443,10656,443,70,70,0,1,5,1,0,0
30270,37965,0,0,62,62,0,1,0,1,0,1
62538,445,0,0,66,66,0,1,0,1,0,2
49824,25174,0,0,146,146,0,1,0,1,0,1
60558,51221,0,0,62,62,0,1,0,1,0,1
55731,445,0,0,70,70,0,1,0,1,0,2
3478,61463,0,0,164,164,0,1,0,1,0,1
60407,8106,10620,8106,2541,1158,1383,19,16,9,10,0
36368,80,54133,80,78,78,0,1,5,1,0,0
54200,445,0,0,70,70,0,1,0,1,0,2
27005,27035,11763,27035,891,126,765,2,31,1,1,0
51946,443,39002,443,8670,1805,6865,28,26,15,13,0
38945,443,48637,443,20511,4206,16305,24,134,7,17,0
58638,5900,0,0,62,62,0,1,0,1,0,1
55448,445,0,0,70,70,0,1,0,1,0,2
45152,80,61047,80,2865,2000,865,12,18,7,5,0
1818,22114,0,0,62,62,0,1,0,1,0,1
29512,30188,0,0,66,66,0,1,0,1,0,1
43829,443,59022,443,368,160,208,6,33,3,3,0
57310,445,0,0,66,66,0,1,0,1,0,2
49535,53,29045,53,771,102,669,2,30,1,1,0
57470,18560,34437,18560,150,150,0,1,1199,1,0,0
56308,443,13053,443,1622,1137,485,11,26,7,4,0
49847,445,0,0,70,70,0,1,0,1,0,2
55830,53,38726,53,177,94,83,2,29,1,1,0
56562,53,8442,53,726,85,641,2,30,1,1,0
64041,53,28808,53,380,92,288,4,37,2,2,0
50877,30041,0,0,66,66,0,1,0,1,0,1
50327,1433,0,0,60,60,0,1,0,1,0,1
51628,443,16414,443,8084,2509,5575,36,195,19,17,0
60591,80,30981,80,1364,860,504,13,17,8,5,0
56703,22,0,0,60,60,0,1,0,1,0,1
60300,80,12014,80,1343,846,497,11,145,6,5,0
47063,15503,0,0,62,62,0,1,0,1,0,1
53833,26467,0,0,66,66,0,1,0,1,0,1
50528,80,29242,80,1658,1247,411,8,16,5,3,0
56725,443,7873,443,6481,972,5509,17,52,10,7,0
58435,64631,0,0,74,74,0,1,0,1,0,1
56899,445,0,0,66,66,0,1,0,1,0,2
44389,443,27883,443,3067,1817,1250,18,16,8,10,0
35099,53,35099,53,225,106,119,2,30,1,1,0
49631,53,64330,53,198,102,96,2,33,1,1,0
56819,445,0,0,66,66,0,1,0,1,0,2
63130,445,0,0,70,70,0,1,0,1,0,2
6889,65473,0,0,143,143,0,1,0,1,0,1
33069,80,38685,80,1899,1172,727,17,284,10,7,0
59832,445,0,0,70,70,0,1,0,1,0,2
56676,445,0,0,70,70,0,1,0,1,0,2
64489,53,32733,53,215,102,113,2,30,1,1,0
55306,53,23236,53,170,87,83,2,0,1,1,0
56626,80,44276,80,234,234,0,4,12,4,0,0
58304,443,13109,443,13442,1200,12242,26,29,11,15,0
50689,443,64099,443,180,60,120,4,15,2,2,0
63854,16437,39591,16437,66,66,0,2,7,2,0,0
55010,53,35689,53,195,102,93,2,29,1,1,0
57280,445,0,0,66,66,0,1,0,1,0,2
64887,53,53065,53,209,110,99,2,30,1,1,0
51412,53,4036,53,252,78,174,2,30,1,1,0
53447,44847,0,0,66,66,0,1,0,1,0,1
65501,57470,0,0,72,72,0,1,0,1,0,1
51581,445,0,0,70,70,0,1,0,1,0,2
25054,36827,0,0,66,66,0,1,0,1,0,1
57747,15000,28219,15000,130,70,60,2,6,1,1,0
58807,443,28426,443,6033,770,5263,18,15,8,10,0
43210,443,51289,443,5960402,99613,5860789,5017,133,952,4065,0
60575,80,18847,80,9034,1860,7174,17,16,8,9,0
56726,443,29318,443,7941,1952,5989,20,15,11,9,0
2467,2767,0,0,66,66,0,1,0,1,0,1
1323,64147,0,0,66,66,0,1,0,1,0,1
36586,3142,36586,3142,138,78,60,2,6,1,1,0
65194,53,61837,53,402,142,260,2,31,1,1,0
55777,445,0,0,70,70,0,1,0,1,0,2
10532,26672,0,0,60,60,0,1,0,1,0,1
55719,8060,46962,8060,70,70,0,1,4,1,0,0
59343,445,0,0,66,66,0,1,0,1,0,2
63976,445,0,0,66,66,0,1,0,1,0,2
18423,51505,0,0,62,62,0,1,0,1,0,1
50572,80,10361,80,318,192,126,6,26,4,2,0
64587,43890,0,0,66,66,0,1,0,1,0,1
55393,44512,0,0,66,66,0,1,0,1,0,1
44933,443,37036,443,8958,1683,7275,24,23,10,14,0
50360,37965,0,0,66,66,0,1,0,1,0,1
57125,53,40271,53,745,93,652,2,30,1,1,0
54256,445,0,0,70,70,0,1,0,1,0,2
9494,23,0,0,60,60,0,1,0,1,0,1
49281,53,58920,53,345,110,235,2,29,1,1,0
65437,53,4286,53,165,86,79,2,30,1,1,0
38122,443,65050,443,191454,11241,180213,262,42,128,134,0
46576,23718,0,0,62,62,0,1,0,1,0,1
56497,53,2084,53,170,87,83,2,31,1,1,0
49936,53,39032,53,216,110,106,2,29,1,1,0
37522,22114,0,0,62,62,0,1,0,1,0,1
49211,443,58097,443,9739,3414,6325,59,928,30,29,0
39077,443,60900,443,24631,1902,22729,37,215,17,20,0
60292,7129,0,0,62,62,0,1,0,1,0,1
55000,53,30925,53,753,93,660,2,31,1,1,0
55899,443,47257,443,4819,2304,2515,16,135,8,8,0
64381,53,4400,53,168,86,82,2,32,1,1,0
49651,37965,0,0,74,74,0,1,0,1,0,1
12694,12446,0,0,62,62,0,1,0,1,0,1
47013,37965,0,0,62,62,0,1,0,1,0,1
57736,445,0,0,66,66,0,1,0,1,0,2
62169,445,0,0,70,70,0,1,0,1,0,2
62991,51221,0,0,66,66,0,1,0,1,0,1
58847,443,24312,443,3143,1064,2079,18,82,8,10,0
52573,445,0,0,70,70,0,1,0,1,0,2
56341,53,28637,53,213,102,111,2,29,1,1,0
55704,13343,3338,13343,564,318,246,9,15,5,4,0
49489,443,60116,443,1627,884,743,12,27,6,6,0
39056,22114,0,0,62,62,0,1,0,1,0,1
62381,445,0,0,66,66,0,1,0,1,0,2
56375,53,32161,53,216,110,106,2,31,1,1,0
1024,45129,0,0,145,145,0,1,0,1,0,1
43146,80,15239,80,1102,545,557,10,16,6,4,0
6703,21247,0,0,62,62,0,1,0,1,0,1
17004,64147,0,0,66,66,0,1,0,1,0,1
55010,443,19028,443,7651,2261,5390,41,255,21,20,0
3478,61463,0,0,164,164,0,1,0,1,0,1
57395,53,40276,53,262,88,174,4,58,2,2,0
57930,445,0,0,70,70,0,1,0,1,0,2
50075,445,0,0,70,70,0,1,0,1,0,2
56170,53,52947,53,198,102,96,2,31,1,1,0
53667,22114,0,0,66,66,0,1,0,1,0,1
58638,5900,0,0,62,62,0,1,0,1,0,1
57400,443,4312,443,10169,1957,8212,26,136,11,15,0
57894,44847,0,0,66,66,0,1,0,1,0,1
26084,36237,0,0,66,66,0,1,0,1,0,1
64303,445,0,0,66,66,0,1,0,1,0,2
49316,53,24928,53,184,94,90,2,31,1,1,0
59587,445,0,0,66,66,0,1,0,1,0,2
53012,80,53012,80,278027,5087,272940,288,22,76,212,0
64108,53,41542,53,296,126,170,2,30,1,1,0
50707,445,0,0,70,70,0,1,0,1,0,2
64084,445,0,0,66,66,0,1,0,1,0,2
5588,5588,0,0,3354,1792,1562,46,192,23,23,0
64001,53,5288,53,182,93,89,2,30,1,1,0
3068,36237,0,0,62,62,0,1,0,1,0,1
53814,6725,2877,6725,70,70,0,2,7,2,0,0
59488,443,37367,443,6100,580,5520,17,53,5,12,0
63436,445,0,0,66,66,0,1,0,1,0,2
55896,53,50702,53,184,94,90,2,31,1,1,0
62890,993,29471,993,9624,4559,5065,88,196,45,43,0
16376,35440,0,0,62,62,0,1,0,1,0,1
61833,445,0,0,66,66,0,1,0,1,0,2
33811,443,49179,443,17406,8237,9169,53,165,21,32,0
55454,53,16777,53,168,78,90,2,30,1,1,0
33340,443,55389,443,3598,1118,2480,14,120,7,7,0
18085,26467,0,0,66,66,0,1,0,1,0,1
54817,443,47884,443,12861,6761,6100,34,164,20,14,0
52471,443,40608,443,41966,23593,18373,89,154,42,47,0
55235,53,18331,53,178,94,84,2,29,1,1,0
61935,445,0,0,70,70,0,1,0,1,0,2
2717,31573,0,0,66,66,0,1,0,1,0,1
51090,53,42988,53,164,78,86,2,30,1,1,0
56624,53,34436,53,177,94,83,2,30,1,1,0
41032,80,41032,80,11428,2250,9178,22,126,11,11,0
58140,53,58140,53,262,106,156,2,34,1,1,0
55146,53,47251,53,181,94,87,2,30,1,1,0
55471,445,0,0,70,70,0,1,0,1,0,2
52221,53,10859,53,177,86,91,2,30,1,1,0
37981,80,45214,80,1572,755,817,11,15,6,5,0
55760,53,53617,53,180,92,88,2,31,1,1,0
26802,50584,0,0,62,62,0,1,0,1,0,1
44984,443,57604,443,4499,2807,1692,24,95,13,11,0
33906,80,51887,80,1248,660,588,8,15,4,4,0
47013,44512,0,0,62,62,0,1,0,1,0,1
53587,32029,40143,32029,70,70,0,1,5,1,0,0
56637,443,17039,443,8865,1819,7046,24,30,14,10,0
55898,443,55898,443,1850,431,1419,5,0,3,2,1
50059,445,0,0,70,70,0,1,0,1,0,2
65225,443,9124,443,3350,2037,1313,25,95,14,11,0
57239,53,63537,53,186,95,91,2,31,1,1,0
50674,80,2786,80,3325,598,2727,12,15,6,6,0
64877,53,41929,53,209,110,99,2,30,1,1,0
57131,26296,0,0,145,145,0,1,0,1,0,1
56783,53,44833,53,193,102,91,2,30,1,1,0
45400,80,25751,80,574,500,74,6,15,5,1,0
62732,443,28854,443,50000,36438,13562,98,336,61,37,0
56363,2710,2278,2710,1222,747,475,10,25,5,5,0
39820,443,46872,443,2190,1249,941,23,26,12,11,0
58853,445,0,0,70,70,0,1,0,1,0,2
42022,80,12678,80,31196,607,30589,29,500,5,24,0
57620,445,0,0,66,66,0,1,0,1,0,2
44849,46478,0,0,74,74,0,1,0,1,0,1
63288,445,0,0,70,70,0,1,0,1,0,2
55859,443,4096,443,399086,26649,372437,488,462,156,332,0
53062,445,0,0,66,66,0,1,0,1,0,2
62870,445,0,0,70,70,0,1,0,1,0,2
60637,445,0,0,70,70,0,1,0,1,0,2
25565,62979,0,0,60,60,0,1,0,1,0,1
50316,25604,0,0,66,66,0,1,0,1,0,1
50930,443,54294,443,134,60,74,3,10,2,1,0
41812,8080,0,0,60,60,0,1,0,1,0,1
55663,19994,59885,19994,70,70,0,2,8,2,0,0
49775,53,55039,53,399,93,306,4,41,2,2,0
64878,26467,0,0,145,145,0,1,0,1,0,1
65234,5228,52749,5228,4149,2263,1886,46,708,23,23,0
58818,445,0,0,70,70,0,1,0,1,0,2
52189,443,16564,443,36007,4328,31679,65,217,33,32,0
49701,80,63516,80,70321,956,69365,62,52,11,51,0
53614,443,48622,443,6352,1552,4800,23,17,12,11,0
58022,5560,0,0,60,60,0,1,0,1,0,1
61480,443,37591,443,5716,1341,4375,29,80,16,13,0
39681,37965,0,0,66,66,0,1,0,1,0,1
50765,22114,0,0,66,66,0,1,0,1,0,1
60138,445,0,0,70,70,0,1,0,1,0,2
55975,53,49618,53,711,87,624,2,30,1,1,0
59830,443,56581,443,82533,15815,66718,124,131,50,74,0
27617,51505,0,0,146,146,0,1,0,1,0,1
62831,445,0,0,70,70,0,1,0,1,0,2
49743,53,12081,53,636,202,434,6,47,3,3,0
51263,445,0,0,66,66,0,1,0,1,0,2
61030,21247,0,0,66,66,0,1,0,1,0,1
49650,53,24810,53,216,110,106,2,29,1,1,0
49480,53,59035,53,184,94,90,2,31,1,1,0
60500,44739,7471,44739,70,70,0,1,5,1,0,0
24276,53,24276,53,233,90,143,2,33,1,1,0
50362,80,15549,80,3907,880,3027,11,15,5,6,0
49277,53,5788,53,199,86,113,2,29,1,1,0
57906,443,49224,443,9316,3279,6037,39,186,20,19,0
65298,53,43096,53,246,102,144,2,30,1,1,0
56101,53,1484,53,188,96,92,2,40,1,1,0
58638,5900,0,0,62,62,0,1,0,1,0,1
63106,443,7897,443,8712,3748,4964,51,255,23,28,0
55013,443,19104,443,7531,1773,5758,30,32,17,13,0
52783,443,32956,443,1581,924,657,15,125,7,8,0
34811,56205,0,0,66,66,0,1,0,1,0,1
14036,48817,0,0,62,62,0,1,0,1,0,1
53990,445,0,0,66,66,0,1,0,1,0,2
65189,28015,14178,28015,240,78,162,2,29,1,1,0
50429,445,0,0,70,70,0,1,0,1,0,2
55392,445,0,0,70,70,0,1,0,1,0,2
64190,2767,0,0,62,62,0,1,0,1,0,1
56337,443,18375,443,9683,2173,7510,35,26,17,18,0
64598,445,0,0,70,70,0,1,0,1,0,2
64578,53,53350,53,186,95,91,2,31,1,1,0
52003,18150,63580,18150,70,70,0,1,5,1,0,0
56143,53,11476,53,214,94,120,2,30,1,1,0
49411,53,5629,53,764,99,665,2,31,1,1,0
49941,53,57941,53,193,102,91,2,31,1,1,0
63855,25174,0,0,62,62,0,1,0,1,0,1
39839,22114,0,0,62,62,0,1,0,1,0,1
41169,443,56459,443,8805,1938,6867,21,17,12,9,0
58369,445,0,0,66,66,0,1,0,1,0,2
58178,53,58178,53,237,93,144,2,31,1,1,0
46029,80,61068,80,111564,6775,104789,160,85,86,74,0
48826,25174,0,0,66,66,0,1,0,1,0,1
49602,53,63187,53,178,94,84,2,30,1,1,0
58765,443,24675,443,26158,17265,8893,57,19,31,26,0
63543,445,0,0,66,66,0,1,0,1,0,2
53490,445,0,0,70,70,0,1,0,1,0,2
64684,53,7467,53,757,102,655,2,30,1,1,0
49884,443,34007,443,5265,1647,3618,16,88,9,7,0
49418,4444,6124,4444,238,78,160,2,31,1,1,0
61257,445,0,0,70,70,0,1,0,1,0,2
39802,80,39802,80,424,198,226,7,142,4,3,0
65251,53,54208,53,183,98,85,3,36,2,1,0
61701,44847,0,0,66,66,0,1,0,1,0,1
49369,445,0,0,70,70,0,1,0,1,0,2
53800,443,21628,443,499,425,74,4,0,3,1,0
59364,44847,0,0,62,62,0,1,0,1,0,1
50861,445,0,0,70,70,0,1,0,1,0,2
58639,443,58639,443,4380,1473,2907,19,30,11,8,0
52483,445,0,0,70,70,0,1,0,1,0,2
48164,53,51985,53,199,94,105,2,30,1,1,0
17415,25174,0,0,62,62,0,1,0,1,0,1
64137,53,61015,53,216,102,114,2,30,1,1,0
50970,443,47824,443,469,403,66,4,0,3,1,0
57860,445,0,0,66,66,0,1,0,1,0,2
11410,36237,0,0,146,146,0,1,0,1,0,1
59694,50584,0,0,62,62,0,1,0,1,0,1
36676,443,44727,443,7636,3367,4269,24,319,13,11,0
62069,443,28586,443,38455,5252,33203,71,60,41,30,0
59097,445,0,0,70,70,0,1,0,1,0,2
40890,53,0,0,86,86,0,1,30,1,0,0
61667,80,57155,80,21567,1666,19901,35,46,18,17,0
59943,37807,0,0,62,62,0,1,0,1,0,1
58787,443,18932,443,5107,700,4407,15,15,7,8,0
60783,445,0,0,70,70,0,1,0,1,0,2
59723,80,4011,80,613,539,74,7,15,6,1,0
55745,445,0,0,66,66,0,1,0,1,0,2
55700,26957,2984,26957,70,70,0,1,5,1,0,0
63617,53,24659,53,299,102,197,2,30,1,1,0
64815,37965,0,0,66,66,0,1,0,1,0,1
57878,80,49228,80,5518,527,4991,13,75,6,7,0
8191,51221,0,0,62,62,0,1,0,1,0,1
64852,53,7184,53,248,102,146,2,29,1,1,0
56589,53,29602,53,199,102,97,2,30,1,1,0
60292,7129,0,0,62,62,0,1,0,1,0,1
3802,55777,0,0,66,66,0,1,0,1,0,1
27005,27015,11957,27015,901,126,775,2,30,1,1,0
37175,53,14480,53,231,86,145,2,29,1,1,0
53725,64147,0,0,66,66,0,1,0,1,0,1
52887,37807,0,0,62,62,0,1,0,1,0,1
39742,80,38417,80,1569,593,976,10,44,6,4,0
59824,445,0,0,70,70,0,1,0,1,0,2
58829,64147,0,0,62,62,0,1,0,1,0,1
55027,445,0,0,70,70,0,1,0,1,0,2
3792,52700,0,0,62,62,0,1,0,1,0,1
53261,443,49163,443,12912,4288,8624,43,20,22,21,0
36963,23,0,0,60,60,0,1,0,1,0,1
58295,445,0,0,70,70,0,1,0,1,0,2
63027,35440,0,0,62,62,0,1,0,1,0,1
52014,443,52014,443,16507,6060,10447,32,49,16,16,0
51243,445,0,0,70,70,0,1,0,1,0,2
56887,53,19033,53,177,94,83,2,31,1,1,0
50023,445,0,0,66,66,0,1,0,1,0,2
52712,443,61572,443,348281,20002,328279,401,350,153,248,0
51975,80,44833,80,426,240,186,8,25,5,3,0
63221,53436,0,0,62,62,0,1,0,1,0,1
53063,445,0,0,70,70,0,1,0,1,0,2
50161,53,38218,53,165,86,79,2,30,1,1,0
62903,445,0,0,70,70,0,1,0,1,0,2
58263,445,0,0,70,70,0,1,0,1,0,2
50577,53,42323,53,819,102,717,2,30,1,1,0
47196,443,63403,443,2701330,44089,2657241,2230,134,296,1934,0
58021,22114,0,0,66,66,0,1,0,1,0,1
56709,443,60934,443,1239919,29325,1210594,1214,46,409,805,0
50858,445,0,0,66,66,0,1,0,1,0,2
55050,80,49586,80,246,120,126,5,15,3,2,0
57424,53,8409,53,210,102,108,2,30,1,1,0
49620,445,0,0,70,70,0,1,0,1,0,2
61419,443,15902,443,6661,862,5799,18,28,9,9,0
10947,53,10947,53,197,90,107,2,29,1,1,0
49734,53,21745,53,216,110,106,2,30,1,1,0
52852,80,35656,80,7572,3232,4340,42,140,23,19,0
55052,80,37545,80,11677266,314362,11362904,12711,129,5174,7537,0
57283,64147,0,0,66,66,0,1,0,1,0,1
30179,23,0,0,60,60,0,1,0,1,0,1
48706,23393,0,0,60,60,0,1,0,1,0,1
9193,443,3894,443,5043,432,4611,12,16,6,6,0
52935,443,46702,443,1769338,65258,1704080,1935,1200,735,1200,0
44861,443,26247,443,1053,566,487,10,47,6,4,0
55222,53,19882,53,178,91,87,2,30,1,1,0
56900,445,0,0,70,70,0,1,0,1,0,2
46557,57866,0,0,66,66,0,1,0,1,0,1
57316,53,12512,53,177,94,83,2,30,1,1,0
51617,445,0,0,70,70,0,1,0,1,0,2
39042,443,16986,443,19733,3606,16127,43,16,22,21,0
59829,443,54560,443,948180,35714,912466,1121,119,378,743,0
49418,27013,52057,27013,230,71,159,2,31,1,1,0
55435,25174,0,0,146,146,0,1,0,1,0,1
51388,443,13575,443,6703,3312,3391,31,145,14,17,0
57503,445,0,0,66,66,0,1,0,1,0,2
50119,445,0,0,70,70,0,1,0,1,0,2
64503,445,0,0,70,70,0,1,0,1,0,2
54146,5900,0,0,60,60,0,1,0,1,0,1
59350,445,0,0,66,66,0,1,0,1,0,2
52843,445,0,0,70,70,0,1,0,1,0,2
65266,53,53450,53,233,102,131,2,29,1,1,0
39775,443,49168,443,6883,1887,4996,23,361,12,11,0
36369,51505,0,0,62,62,0,1,0,1,0,1
50798,445,0,0,70,70,0,1,0,1,0,2
20619,25174,0,0,66,66,0,1,0,1,0,1
65421,445,0,0,66,66,0,1,0,1,0,2
57174,57470,0,0,66,66,0,1,0,1,0,1
54711,443,40588,443,3663,1136,2527,13,136,6,7,0
51689,53,34111,53,198,86,112,2,30,1,1,0
32974,37965,0,0,66,66,0,1,0,1,0,1
12107,22114,0,0,62,62,0,1,0,1,0,1
51806,49530,21191,49530,70,70,0,2,8,2,0,0
52625,25174,0,0,66,66,0,1,0,1,0,1
61694,443,25571,443,8696,3245,5451,36,47,16,20,0
54235,445,0,0,70,70,0,1,0,1,0,2
18570,2323,0,0,60,60,0,1,0,1,0,1
58638,5900,0,0,62,62,0,1,0,1,0,1
59891,53,0,0,248,75,173,2,30,1,1,0
58633,445,0,0,66,66,0,1,0,1,0,2
1638,22114,0,0,62,62,0,1,0,1,0,1
49973,445,0,0,70,70,0,1,0,1,0,2
41184,53,29887,53,168,78,90,2,30,1,1,0
58692,445,0,0,70,70,0,1,0,1,0,2
57982,25174,0,0,62,62,0,1,0,1,0,1
51675,445,0,0,70,70,0,1,0,1,0,2
46389,27098,0,0,66,66,0,1,0,1,0,1
40819,30975,0,0,157,157,0,1,0,1,0,1
1480,12447,0,0,66,66,0,1,0,1,0,1
49730,445,0,0,70,70,0,1,0,1,0,2
58638,5900,0,0,62,62,0,1,0,1,0,1
61712,443,30612,443,7443,2692,4751,19,76,11,8,0
5223,14446,0,0,220,220,0,1,0,1,0,1
40203,80,61605,80,28577,1878,26699,47,31,23,24,0
56552,53,11395,53,190,97,93,2,31,1,1,0
39674,443,32592,443,2828,1800,1028,27,184,15,12,0
10075,53,26138,53,229,86,143,2,30,1,1,0
55834,53,17845,53,184,94,90,2,30,1,1,0
51124,445,0,0,66,66,0,1,0,1,0,2
1026,64147,0,0,145,145,0,1,0,1,0,1
11136,15503,0,0,62,62,0,1,0,1,0,1
6881,16869,32052,16869,509,150,359,2,1200,1,1,0
60512,6881,33887,6881,320,140,180,6,6,3,3,0
26420,25174,0,0,66,66,0,1,0,1,0,1
50003,443,32664,443,13812,3042,10770,29,16,15,14,0
48344,443,64214,443,2588313,95154,2493159,2645,190,811,1834,0
55727,53,61818,53,177,94,83,2,30,1,1,0
61570,445,0,0,70,70,0,1,0,1,0,2
55646,443,13625,443,11771,2624,9147,50,19,25,25,0
24965,53,24965,53,247,98,149,2,32,1,1,0
52206,445,0,0,70,70,0,1,0,1,0,2
26642,57470,0,0,62,62,0,1,0,1,0,1
52904,445,0,0,70,70,0,1,0,1,0,2
59335,80,59335,80,107776,4213,103563,177,16,60,117,0
49268,53,5165,53,353,118,235,2,30,1,1,0
55214,445,0,0,70,70,0,1,0,1,0,2
56317,445,0,0,70,70,0,1,0,1,0,2
60579,25174,0,0,66,66,0,1,0,1,0,1
56782,49135,47020,49135,70,70,0,2,8,2,0,0
49882,53,52287,53,441,104,337,4,48,2,2,0
2681,48817,0,0,146,146,0,1,0,1,0,1
47700,51505,0,0,66,66,0,1,0,1,0,1
49351,53,27652,53,166,86,80,2,30,1,1,0
53336,445,0,0,70,70,0,1,0,1,0,2
49627,445,0,0,70,70,0,1,0,1,0,2
56339,443,15948,443,8991,1756,7235,28,26,15,13,0
64188,53,45023,53,194,94,100,2,30,1,1,0
51966,443,65076,443,9249,4498,4751,39,15,22,17,0
49899,7000,49899,7000,758568,17631,740937,772,17,269,503,0
41230,443,13536,443,78,78,0,1,5,1,0,0
58833,445,0,0,70,70,0,1,0,1,0,2
49965,445,0,0,70,70,0,1,0,1,0,2
57526,445,0,0,66,66,0,1,0,1,0,2
49453,53,64414,53,227,110,117,2,31,1,1,0
65525,443,9387,443,92247,4799,87448,107,15,43,64,0
10436,37965,0,0,62,62,0,1,0,1,0,1
59911,80,3482,80,2025658,45348,1980310,1992,44,640,1352,0
56292,53,4815,53,197,102,95,2,30,1,1,0
64697,53,51206,53,199,102,97,2,30,1,1,0
7068,53,7068,53,197,90,107,2,30,1,1,0
64864,53,28778,53,275,126,149,2,30,1,1,0
35937,25174,0,0,66,66,0,1,0,1,0,1
52086,80,55343,80,2703,632,2071,12,22,7,5,0
55110,53,57772,53,770,102,668,2,30,1,1,0
48629,63131,0,0,74,74,0,1,0,1,0,1
61714,445,0,0,70,70,0,1,0,1,0,2
58368,53,61007,53,167,78,89,2,30,1,1,0
54424,50584,0,0,146,146,0,1,0,1,0,1
38517,53,38517,53,214,82,132,2,32,1,1,0
65514,53,14703,53,214,110,104,2,29,1,1,0
55458,445,0,0,70,70,0,1,0,1,0,2
58230,443,58230,443,4465,1558,2907,19,27,11,8,0
60100,445,0,0,66,66,0,1,0,1,0,2
55698,45710,26352,45710,70,70,0,2,8,2,0,0
52255,16087,20036,16087,70,70,0,2,8,2,0,0
61094,445,0,0,70,70,0,1,0,1,0,2
52094,443,49643,443,3296065,47110,3248955,2746,51,533,2213,0
59422,445,0,0,70,70,0,1,0,1,0,2
26900,27017,12614,27017,422,164,258,6,29,3,3,0
56979,53,46725,53,209,110,99,2,29,1,1,0
6881,7999,34044,7999,238,118,120,2,1199,1,1,0
58238,445,0,0,70,70,0,1,0,1,0,2
55979,53,61976,53,275,110,165,2,30,1,1,0
46531,123,21322,123,184,94,90,2,30,1,1,0
53499,445,0,0,70,70,0,1,0,1,0,2
34553,48637,0,0,60,60,0,1,0,1,0,1
51942,22272,28402,22272,140,70,70,2,5,1,1,0
61398,445,0,0,66,66,0,1,0,1,0,2
1024,35894,0,0,62,62,0,1,0,1,0,1
64516,53,8350,53,216,110,106,2,30,1,1,0
5208,63836,0,0,145,145,0,1,0,1,0,1
55271,53,59088,53,168,86,82,2,29,1,1,0
33970,443,28633,443,2586,832,1754,14,15,7,7,0
45499,443,58024,443,17031,8260,8771,39,128,19,20,0
62693,443,62693,443,4788,1881,2907,19,31,11,8,0
34358,80,63755,80,350,210,140,6,16,4,2,0
64097,445,0,0,66,66,0,1,0,1,0,2
49160,57470,0,0,146,146,0,1,0,1,0,1
49990,53,60528,53,198,102,96,2,30,1,1,0
62459,445,0,0,70,70,0,1,0,1,0,2
38852,37965,0,0,62,62,0,1,0,1,0,1
50233,445,0,0,70,70,0,1,0,1,0,2
50821,445,0,0,66,66,0,1,0,1,0,2
58638,5900,0,0,62,62,0,1,0,1,0,1
56419,53,27801,53,199,102,97,2,30,1,1,0
55690,443,36462,443,914,444,470,14,29,7,7,0
52098,29067,64917,29067,70,70,0,1,5,1,0,0
60645,35440,0,0,66,66,0,1,0,1,0,1
49948,53,46968,53,177,94,83,2,30,1,1,0
38675,443,44099,443,90810,3417,87393,94,16,30,64,0
49777,53,2324,53,485,79,406,4,31,2,2,0
43863,80,21010,80,2025,805,1220,12,46,7,5,0
53215,443,56280,443,6983,1629,5354,17,15,9,8,0
22587,30188,0,0,66,66,0,1,0,1,0,1
65484,53,31170,53,195,102,93,2,30,1,1,0
65506,53,15371,53,197,102,95,2,30,1,1,0
36843,443,62939,443,1988,1348,640,16,30,9,7,0
60993,445,0,0,70,70,0,1,0,1,0,2
43744,53,43744,53,235,90,145,2,32,1,1,0
49894,445,0,0,66,66,0,1,0,1,0,2
54633,445,0,0,66,66,0,1,0,1,0,2
64320,53,46178,53,199,102,97,2,30,1,1,0
2919,37965,0,0,62,62,0,1,0,1,0,1
43483,443,14734,443,144138,17538,126600,275,300,115,160,0
54943,445,0,0,70,70,0,1,0,1,0,2
57243,53,64536,53,165,86,79,2,31,1,1,0
55321,53,63193,53,193,102,91,2,30,1,1,0
11897,443,11897,443,1452,817,635,16,29,9,7,0
0,0,0,0,320,320,0,5,0,5,0,0
37566,443,61835,443,1386,924,462,12,30,7,5,0
48982,15000,10476,15000,130,70,60,2,5,1,1,0
56655,53,28955,53,168,86,82,2,29,1,1,0
65291,53,60855,53,335,97,238,4,31,2,2,0
49662,443,55920,443,9534,4029,5505,22,59,12,10,0
60411,80,48309,80,1589,941,648,11,121,6,5,0
43584,24748,0,0,156,156,0,1,0,1,0,1
57181,445,0,0,70,70,0,1,0,1,0,2
61183,25174,0,0,62,62,0,1,0,1,0,1
63930,53,2970,53,377,94,283,2,29,1,1,0
49417,38558,0,0,66,66,0,1,0,1,0,1
64739,53,35789,53,164,86,78,2,31,1,1,0
49513,80,22592,80,476333,9582,466751,453,225,135,318,0
50977,80,25806,80,1111949,11633,1100316,906,37,173,733,0
55313,443,62411,443,4005,1162,2843,17,142,8,9,0
62796,37807,0,0,66,66,0,1,0,1,0,1
63853,443,40585,443,3182,1568,1614,8,120,4,4,0
53404,443,43178,443,4972,1547,3425,22,149,10,12,0
57106,53,8204,53,760,97,663,2,31,1,1,0
38425,443,45581,443,103112,8212,94900,165,55,80,85,0
56881,53,21712,53,181,86,95,2,30,1,1,0
41482,23,0,0,60,60,0,1,0,1,0,1
33806,443,17179,443,37541,4945,32596,69,127,31,38,0
56608,445,0,0,70,70,0,1,0,1,0,2
62464,41090,36975,41090,454923,271912,183011,516,549,295,221,0
49577,443,34979,443,6947,833,6114,20,53,9,11,0
52305,445,0,0,70,70,0,1,0,1,0,2
58046,443,58046,443,4682,1775,2907,19,29,11,8,0
50818,445,0,0,66,66,0,1,0,1,0,2
10627,23117,0,0,62,62,0,1,0,1,0,1
57356,53,43032,53,780,93,687,2,30,1,1,0
54657,6881,47052,6881,1682,716,966,12,15,6,6,0
50584,51413,45972,51413,1275,300,975,6,1200,3,3,0
33401,51505,0,0,66,66,0,1,0,1,0,1
65072,53,64909,53,338,110,228,2,29,1,1,0
26351,22114,0,0,62,62,0,1,0,1,0,1
45099,57470,0,0,62,62,0,1,0,1,0,1
50156,445,0,0,70,70,0,1,0,1,0,2
59222,445,0,0,66,66,0,1,0,1,0,2
63976,53,34685,53,200,102,98,2,30,1,1,0
61911,445,0,0,66,66,0,1,0,1,0,2
36538,64147,0,0,62,62,0,1,0,1,0,1
64546,57470,0,0,66,66,0,1,0,1,0,1
53415,445,0,0,66,66,0,1,0,1,0,2
14445,443,55284,443,2589,1443,1146,18,15,8,10,0
63951,53,30484,53,193,102,91,2,30,1,1,0
62396,51050,0,0,146,146,0,1,0,1,0,1
26379,23,0,0,60,60,0,1,0,1,0,1
36811,53,36811,53,227,90,137,2,29,1,1,0
51904,445,0,0,70,70,0,1,0,1,0,2
22452,443,22452,443,5785,2575,3210,24,76,14,10,0
58638,5900,0,0,62,62,0,1,0,1,0,1
55992,445,0,0,70,70,0,1,0,1,0,2
37647,29892,0,0,145,145,0,1,0,1,0,1
57605,80,57605,80,36471,5174,31297,57,38,23,34,0
38772,53,26700,53,168,78,90,2,30,1,1,0
51451,445,0,0,70,70,0,1,0,1,0,2
33979,23,0,0,60,60,0,1,0,1,0,1
54114,443,54114,443,171467,27550,143917,220,85,108,112,0
62088,56205,0,0,66,66,0,1,0,1,0,1
58023,47808,0,0,60,60,0,1,0,1,0,1
56770,26467,0,0,66,66,0,1,0,1,0,1
49297,53,13905,53,182,93,89,2,31,1,1,0
12841,37965,0,0,62,62,0,1,0,1,0,1
64901,445,0,0,70,70,0,1,0,1,0,2
8999,49001,0,0,146,146,0,1,0,1,0,1
55822,445,0,0,70,70,0,1,0,1,0,2
52166,57975,20041,57975,66,66,0,1,5,1,0,0
49277,53,20518,53,199,102,97,2,30,1,1,0
59533,443,28553,443,448,78,370,6,24,1,5,0
40404,80,22213,80,1502,467,1035,9,180,5,4,0
55871,53,54584,53,177,94,83,2,29,1,1,0
56691,443,56691,443,4378,1471,2907,19,29,11,8,0
50418,445,0,0,66,66,0,1,0,1,0,2
30920,64147,0,0,62,62,0,1,0,1,0,1
55027,443,27203,443,17167,5192,11975,32,121,17,15,0
56718,80,40668,80,1462,703,759,8,15,5,3,0
65398,7129,0,0,66,66,0,1,0,1,0,1
62080,54532,0,0,60,60,0,1,0,1,0,1
50432,80,29144,80,318,192,126,6,27,4,2,0
60248,30188,0,0,62,62,0,1,0,1,0,1
54139,53,64934,53,168,78,90,2,31,1,1,0
60060,22,60060,22,7974,3469,4505,57,40,28,29,0
56766,53,34150,53,204,104,100,2,30,1,1,0
6666,138,0,0,60,60,0,1,0,1,0,1
58688,53,58261,53,184,78,106,2,30,1,1,0
34335,23,0,0,60,60,0,1,0,1,0,1
57470,53756,4202,53756,132,132,0,3,1199,3,0,0
49692,53,65365,53,212,110,102,2,30,1,1,0
49996,53,6579,53,183,94,89,2,30,1,1,0
38661,15000,5688,15000,138,78,60,2,5,1,1,0
42644,443,8391,443,8384,2161,6223,24,255,12,12,0
49699,64147,0,0,62,62,0,1,0,1,0,1
64181,53,18587,53,194,102,92,2,31,1,1,0
50561,80,19741,80,318,192,126,6,26,4,2,0
54371,443,51699,443,6120,1305,4815,20,983,10,10,0
65176,53,64926,53,183,94,89,2,29,1,1,0
41597,53,41597,53,213,79,134,2,32,1,1,0
39545,443,12909,443,5596,3797,1799,27,96,14,13,0
48509,443,53083,443,4922,950,3972,17,34,10,7,0
14343,6881,0,0,62,62,0,1,0,1,0,1
53470,445,0,0,70,70,0,1,0,1,0,2
54085,443,49010,443,4128,1929,2199,38,48,21,17,0
63879,80,50871,80,314,192,122,6,15,4,2,0
30960,45724,8617,45724,330,330,0,6,3609,6,0,0
47152,443,10144,443,11278,2044,9234,32,178,17,15,0
59016,443,23931,443,12676,4222,8454,36,87,20,16,0
50368,443,46131,443,8048,1189,6859,19,25,10,9,0
65264,53,51558,53,198,94,104,2,29,1,1,0
54769,80,54769,80,23168,3380,19788,36,19,18,18,0
45908,33330,0,0,60,60,0,1,0,1,0,1
51046,25174,0,0,66,66,0,1,0,1,0,1
2267,53,56692,53,204,118,86,2,30,1,1,0
56505,443,54192,443,78426,3219,75207,98,96,37,61,0
13178,37965,0,0,62,62,0,1,0,1,0,1
37683,53,37683,53,240,98,142,2,30,1,1,0
56056,53,42855,53,164,86,78,2,29,1,1,0
53750,25174,0,0,66,66,0,1,0,1,0,1
52965,445,0,0,66,66,0,1,0,1,0,2
57051,53,56096,53,185,102,83,2,30,1,1,0
41474,443,44338,443,190,70,120,4,15,2,2,0
46439,443,34571,443,8246,1739,6507,21,17,11,10,0
58638,5900,0,0,62,62,0,1,0,1,0,1
56970,80,14502,80,1783,841,942,10,20,6,4,0
52701,445,0,0,70,70,0,1,0,1,0,2
55592,443,17919,443,8049,1560,6489,19,150,9,10,0
45682,8055,0,0,159,159,0,1,0,1,0,1
58812,445,0,0,70,70,0,1,0,1,0,2
54997,443,59177,443,10817,4402,6415,31,23,17,14,0
39100,2767,0,0,62,62,0,1,0,1,0,1
52142,445,0,0,70,70,0,1,0,1,0,2
57240,445,0,0,66,66,0,1,0,1,0,2
55273,53,29948,53,167,86,81,2,30,1,1,0
50334,445,0,0,70,70,0,1,0,1,0,2
63729,80,63729,80,7324,1017,6307,16,20,8,8,0
55205,53,56363,53,167,86,81,2,30,1,1,0
49217,53,50933,53,282,93,189,4,45,2,2,0
63741,50584,0,0,66,66,0,1,0,1,0,1
63745,39800,55951,39800,504,382,122,8,16,6,2,0
57661,445,0,0,70,70,0,1,0,1,0,2
1537,22114,0,0,62,62,0,1,0,1,0,1
58638,5900,0,0,62,62,0,1,0,1,0,1
53235,445,0,0,70,70,0,1,0,1,0,2
443,35385,0,0,161,161,0,1,0,1,0,1
64132,445,0,0,66,66,0,1,0,1,0,2
46216,443,9972,443,161,101,60,2,5,1,1,0
55113,53,29716,53,196,100,96,2,31,1,1,0
6712,44818,0,0,66,66,0,1,0,1,0,1
49710,53,28433,53,480,93,387,4,50,2,2,0
3478,61463,0,0,1302,1302,0,1,0,1,0,1
55188,443,45668,443,6649,1556,5093,23,24,13,10,0
36498,80,36498,80,161054,3432,157622,140,158,24,116,0
52980,445,0,0,66,66,0,1,0,1,0,2
52363,123,30662,123,184,94,90,2,30,1,1,0
63873,44847,0,0,66,66,0,1,0,1,0,1
53020,61903,0,0,159,159,0,1,0,1,0,1
56575,443,16584,443,14284,5729,8555,31,61,19,12,0
49001,48983,0,0,161,161,0,1,0,1,0,1
64819,445,0,0,70,70,0,1,0,1,0,2
49881,445,0,0,70,70,0,1,0,1,0,2
28668,8696,0,0,60,60,0,1,0,1,0,1
23758,44847,0,0,62,62,0,1,0,1,0,1
57397,53,3449,53,183,94,89,2,30,1,1,0
443,62732,0,0,199,199,0,1,0,1,0,1
49532,80,7798,80,4577,3951,626,11,25,6,5,0
55429,25174,0,0,66,66,0,1,0,1,0,1
51328,443,46063,443,6021,1981,4040,21,15,9,12,0
49230,443,49230,443,123041,10988,112053,185,67,86,99,0
54200,443,47040,443,499,425,74,4,0,3,1,0
43402,53,65461,53,241,78,163,2,30,1,1,0
60195,80,59592,80,70,70,0,1,5,1,0,0
58638,5900,0,0,62,62,0,1,0,1,0,1
61457,21247,0,0,66,66,0,1,0,1,0,1
50482,445,0,0,70,70,0,1,0,1,0,2
64811,53,21833,53,193,102,91,2,30,1,1,0
56754,14715,43516,14715,66,66,0,1,5,1,0,0
56986,53,21320,53,177,94,83,2,31,1,1,0
50373,443,36496,443,4695,859,3836,17,30,9,8,0
53049,443,20030,443,7393,2050,5343,34,92,16,18,0
61060,53,35678,53,311,94,217,2,30,1,1,0
45627,443,27902,443,6410,1610,4800,24,17,13,11,0
37008,42707,0,0,62,62,0,1,0,1,0,1
65075,53,1890,53,278,100,178,4,31,2,2,0
60474,443,49891,443,5888,1175,4713,19,76,11,8,0
443,29326,0,0,82,82,0,1,0,1,0,1
26435,39004,0,0,62,62,0,1,0,1,0,1
55179,53,17808,53,183,94,89,2,30,1,1,0
56572,443,48876,443,10325,2594,7731,28,27,16,12,0
63083,25174,0,0,62,62,0,1,0,1,0,1
59841,80,53537,80,711697,18422,693275,716,50,253,463,0
49734,53,51597,53,259,110,149,2,30,1,1,0
33793,80,7506,80,1286,782,504,12,361,7,5,0
55654,443,49899,443,186406,10415,175991,218,123,79,139,0
51806,49530,42413,49530,66,66,0,1,5,1,0,0
4269,26672,0,0,60,60,0,1,0,1,0,1
58102,443,20475,443,14197,9283,4914,28,122,15,13,0
49893,25174,0,0,66,66,0,1,0,1,0,1
55165,445,0,0,70,70,0,1,0,1,0,2
59076,25174,0,0,62,62,0,1,0,1,0,1
52903,445,0,0,66,66,0,1,0,1,0,2
61693,443,50704,443,12203,3519,8684,65,18,35,30,0
33405,37965,0,0,62,62,0,1,0,1,0,1
33896,57470,0,0,74,74,0,1,0,1,0,1
61414,445,0,0,70,70,0,1,0,1,0,2
58638,5900,0,0,62,62,0,1,0,1,0,1
41937,53,0,0,82,82,0,1,31,1,0,0
37121,21247,0,0,66,66,0,1,0,1,0,1
35657,48637,0,0,62,62,0,1,0,1,0,1
60593,445,0,0,66,66,0,1,0,1,0,2
56306,57587,0,0,146,146,0,1,0,1,0,1
51903,26467,0,0,62,62,0,1,0,1,0,1
65225,53,20120,53,822,102,720,2,30,1,1,0
58062,445,0,0,70,70,0,1,0,1,0,2
63847,443,57992,443,8012,4410,3602,20,135,10,10,0
48676,53389,0,0,60,60,0,1,0,1,0,1
32496,48817,0,0,148,148,0,1,0,1,0,1
52093,80,7625,80,3019,716,2303,12,23,7,5,0
55921,43890,0,0,66,66,0,1,0,1,0,1
45511,443,41466,443,130,70,60,2,15,1,1,0
49995,53,57379,53,197,102,95,2,30,1,1,0
65384,53,46519,53,197,102,95,2,33,1,1,0
65433,445,0,0,66,66,0,1,0,1,0,2
10331,6881,0,0,146,146,0,1,0,1,0,1
56260,53,6502,53,177,94,83,2,30,1,1,0
56400,53,12520,53,819,102,717,2,30,1,1,0
55713,25174,0,0,146,146,0,1,0,1,0,1
40410,443,37656,443,2975,719,2256,14,136,7,7,0
65007,53,25080,53,180,86,94,2,30,1,1,0
49209,53,10202,53,198,101,97,2,31,1,1,0
57943,1433,0,0,60,60,0,1,0,1,0,1
61017,445,0,0,66,66,0,1,0,1,0,2
56620,53,33976,53,216,110,106,2,31,1,1,0
58970,443,57205,443,3715,1958,1757,23,21,12,11,0
50689,443,50217,443,152,86,66,2,4,1,1,0
62945,445,0,0,70,70,0,1,0,1,0,2
64132,53,20663,53,381,102,279,4,42,2,2,0
56033,443,32455,443,3250,1058,2192,13,136,6,7,0
43129,20220,0,0,62,62,0,1,0,1,0,1
45410,1,0,0,62,62,0,1,0,1,0,1
63817,50808,9849,50808,66,66,0,2,8,2,0,0
52223,11979,36766,11979,70,70,0,2,9,2,0,0
27005,28015,54917,28015,888,126,762,2,30,1,1,0
64157,53,10043,53,323,90,233,4,48,2,2,0
46587,443,46587,443,30701,1538,29163,40,16,14,26,0
36289,53,0,0,86,86,0,1,30,1,0,0
52318,443,6808,443,9453,2797,6656,46,32,25,21,0
7184,15503,0,0,66,66,0,1,0,1,0,1
54118,443,28446,443,115373,6904,108469,171,117,87,84,0
53879,443,22578,443,499,425,74,4,1,3,1,0
123,123,55557,123,184,94,90,2,29,1,1,0
57163,443,13914,443,1779,1375,404,11,40,5,6,0
50229,80,35977,80,1743,979,764,13,81,7,6,0
53189,445,0,0,66,66,0,1,0,1,0,2
62776,62413,0,0,146,146,0,1,0,1,0,1
61616,445,0,0,70,70,0,1,0,1,0,2
60403,60092,47131,60092,70,70,0,2,8,2,0,0
54980,53,25043,53,763,101,662,2,30,1,1,0
58524,445,0,0,70,70,0,1,0,1,0,2
56627,53,14624,53,193,102,91,2,30,1,1,0
49828,53,40540,53,578,286,292,9,15,5,4,0
64940,445,0,0,66,66,0,1,0,1,0,2
59373,445,0,0,70,70,0,1,0,1,0,2
65070,53,12563,53,198,102,96,2,30,1,1,0
49771,53,61386,53,86,86,0,1,30,1,0,0
50265,45682,34420,45682,330,330,0,6,1200,6,0,0
57337,64147,0,0,66,66,0,1,0,1,0,1
57470,39541,8082,39541,792,792,0,13,1200,13,0,0
54198,445,0,0,66,66,0,1,0,1,0,2
64250,53,22733,53,314,102,212,2,29,1,1,0
55147,53,27402,53,184,94,90,2,31,1,1,0
53578,445,0,0,70,70,0,1,0,1,0,2
51096,63710,0,0,66,66,0,1,0,1,0,1
49666,53,7037,53,325,126,199,2,30,1,1,0
2828,35253,0,0,66,66,0,1,0,1,0,1
53937,445,0,0,66,66,0,1,0,1,0,2
25543,22114,0,0,62,62,0,1,0,1,0,1
65112,53,1739,53,209,110,99,2,31,1,1,0
56318,53,8880,53,182,93,89,2,31,1,1,0
57416,53,37012,53,771,101,670,2,31,1,1,0
65241,53,55089,53,200,102,98,2,31,1,1,0
3597,11392,0,0,66,66,0,1,0,1,0,1
56030,53,56239,53,815,95,720,2,31,1,1,0
50518,443,27027,443,1352,691,661,14,47,8,6,0
59002,53,19057,53,238,94,144,2,30,1,1,0
60724,445,0,0,70,70,0,1,0,1,0,2
36672,53,36672,53,234,93,141,2,30,1,1,0
51097,445,0,0,70,70,0,1,0,1,0,2
50530,445,0,0,70,70,0,1,0,1,0,2
56522,53,58867,53,322,134,188,2,30,1,1,0
44363,443,4525,443,10667,2992,7675,32,560,17,15,0
50619,445,0,0,70,70,0,1,0,1,0,2
52107,443,6381,443,12091,3135,8956,30,49,16,14,0
56397,53,56445,53,179,94,85,2,31,1,1,0
65208,53,46888,53,637,178,459,6,70,3,3,0
49714,53,19961,53,490,101,389,4,45,2,2,0
51843,445,0,0,70,70,0,1,0,1,0,2
53049,445,0,0,70,70,0,1,0,1,0,2
50052,65008,0,0,60,60,0,1,0,1,0,1
64824,37965,0,0,62,62,0,1,0,1,0,1
11859,64147,0,0,62,62,0,1,0,1,0,1
41996,5900,0,0,60,60,0,1,0,1,0,1
43523,53,26419,53,168,78,90,2,30,1,1,0
5497,53,2342,53,208,78,130,2,30,1,1,0
57011,49813,0,0,66,66,0,1,0,1,0,1
40102,443,45271,443,29714,2090,27624,43,97,17,26,0
64961,27025,27939,27025,1334,462,872,4,30,2,2,0
62150,23718,0,0,66,66,0,1,0,1,0,1
64439,445,0,0,70,70,0,1,0,1,0,2
35905,443,10061,443,8272,2091,6181,25,331,12,13,0
31130,30188,0,0,62,62,0,1,0,1,0,1
54942,445,0,0,70,70,0,1,0,1,0,2
54318,445,0,0,66,66,0,1,0,1,0,2
58290,445,0,0,70,70,0,1,0,1,0,2
56703,53,34394,53,199,102,97,2,31,1,1,0
62731,21247,0,0,62,62,0,1,0,1,0,1
65049,53,59454,53,184,94,90,2,31,1,1,0
7286,44847,0,0,66,66,0,1,0,1,0,1
53774,443,4137,443,499,425,74,4,0,3,1,0
26435,39004,0,0,62,62,0,1,0,1,0,1
55193,445,0,0,70,70,0,1,0,1,0,2
5223,32965,0,0,167,167,0,1,0,1,0,1
60579,25174,0,0,66,66,0,1,0,1,0,1
53009,80,53009,80,378,180,198,7,17,4,3,0
63813,53455,26592,53455,66,66,0,2,7,2,0,0
51050,445,0,0,66,66,0,1,0,1,0,2
26048,21,0,0,60,60,0,1,0,1,0,1
56560,53,17987,53,199,102,97,2,30,1,1,0
61461,50584,0,0,66,66,0,1,0,1,0,1
49520,53,1147,53,209,110,99,2,30,1,1,0
59192,25174,0,0,66,66,0,1,0,1,0,1
57165,34101,0,0,66,66,0,1,0,1,0,1
57263,53,12000,53,167,86,81,2,30,1,1,0
62970,44847,0,0,62,62,0,1,0,1,0,1
51461,445,0,0,66,66,0,1,0,1,0,2
64166,445,0,0,66,66,0,1,0,1,0,2
35422,443,35422,443,5172,1925,3247,22,39,13,9,0
49790,53,41551,53,195,102,93,2,29,1,1,0
52064,43273,64418,43273,70,70,0,1,5,1,0,0
59370,445,0,0,70,70,0,1,0,1,0,2
54196,443,33780,443,499,425,74,4,0,3,1,0
28370,23,0,0,60,60,0,1,0,1,0,1
45725,443,40804,443,8600,4882,3718,44,225,23,21,0
56562,44847,0,0,66,66,0,1,0,1,0,1
50535,80,30581,80,62768,25796,36972,75,34,33,42,0
56521,32480,0,0,62,62,0,1,0,1,0,1
63113,445,0,0,70,70,0,1,0,1,0,2
16377,21247,0,0,62,62,0,1,0,1,0,1
57797,64147,0,0,62,62,0,1,0,1,0,1
37635,443,29591,443,4266,1768,2498,18,121,8,10,0
42298,40009,56378,40009,148,86,62,2,29,1,1,0
50312,80,40765,80,2699,1007,1692,14,64,7,7,0
64115,80,27951,80,2575,635,1940,12,36,7,5,0
38300,443,24962,443,200383,4673,195710,196,30,58,138,0
50061,443,34942,443,4819,2004,2815,22,80,11,11,0
33098,443,57667,443,6044,780,5264,16,66,8,8,0
50829,443,2487,443,1445207,43930,1401277,1562,219,556,1006,0
50559,53,61943,53,216,110,106,2,30,1,1,0
64171,53,19883,53,174,89,85,2,30,1,1,0
65269,53,55640,53,273,134,139,2,30,1,1,0
53845,443,42345,443,499,425,74,4,0,3,1,0
50049,443,21285,443,7912,3269,4643,23,96,12,11,0
55058,53,43398,53,216,110,106,2,31,1,1,0
27005,27018,24466,27018,882,126,756,2,30,1,1,0
53831,80,61237,80,5774,1483,4291,14,162,8,6,0
65303,53,28109,53,94,94,0,1,29,1,0,0
58638,5900,0,0,62,62,0,1,0,1,0,1
64030,53,24656,53,338,110,228,2,30,1,1,0
6895,57354,0,0,148,148,0,1,0,1,0,1
16387,34137,0,0,60,60,0,1,0,1,0,1
51020,445,0,0,70,70,0,1,0,1,0,2
42951,44847,0,0,66,66,0,1,0,1,0,1
19473,6889,17971,6889,481,150,331,2,1200,1,1,0
64891,22,0,0,60,60,0,1,0,1,0,1
54260,445,0,0,70,70,0,1,0,1,0,2
39796,443,39796,443,4744,1837,2907,19,27,11,8,0
49786,53,64235,53,209,110,99,2,30,1,1,0
51414,22,0,0,60,60,0,1,0,1,0,1
48480,443,23315,443,10409,2670,7739,94,5805,17,77,0
27328,21247,0,0,66,66,0,1,0,1,0,1
60627,443,41376,443,5663,1711,3952,22,17,13,9,0
54360,445,0,0,70,70,0,1,0,1,0,2
11688,23718,0,0,62,62,0,1,0,1,0,1
65311,53,5309,53,198,94,104,2,30,1,1,0
53346,445,0,0,70,70,0,1,0,1,0,2
42792,443,30288,443,7102,1857,5245,28,95,15,13,0
60378,443,38205,443,130,70,60,2,15,1,1,0
52895,443,23981,443,18795,10297,8498,56,118,29,27,0
65143,53,18193,53,184,94,90,2,30,1,1,0
64533,53,56786,53,183,102,81,2,29,1,1,0
60555,445,0,0,70,70,0,1,0,1,0,2
49418,27017,12752,27017,283,71,212,2,31,1,1,0
64310,53,12682,53,404,102,302,2,30,1,1,0
53330,443,1024,443,5454,1157,4297,15,22,9,6,0
53164,48198,7411,48198,320,140,180,6,7,3,3,0
52145,36670,58227,36670,316,136,180,6,6,3,3,0
53667,49160,27701,49160,320,140,180,6,7,3,3,0
54471,445,0,0,70,70,0,1,0,1,0,2
9446,443,50836,443,8672,1863,6809,22,46,11,11,0
65127,53,26912,53,188,96,92,2,31,1,1,0
63931,53,21564,53,380,105,275,4,35,2,2,0
55807,445,0,0,70,70,0,1,0,1,0,2
49934,80,37957,80,1130,613,517,11,15,6,5,0
57180,53,28550,53,305,86,219,2,31,1,1,0
55718,16805,42718,16805,70,70,0,2,8,2,0,0
56292,443,36478,443,10839,2145,8694,32,140,14,18,0
64482,64147,0,0,66,66,0,1,0,1,0,1
57058,445,0,0,70,70,0,1,0,1,0,2
60429,445,0,0,70,70,0,1,0,1,0,2
54336,445,0,0,66,66,0,1,0,1,0,2
44847,51572,8318,51572,509,150,359,2,1200,1,1,0
56704,53,2195,53,177,94,83,2,30,1,1,0
64455,445,0,0,70,70,0,1,0,1,0,2
55713,47783,7321,47783,70,70,0,2,8,2,0,0
56256,62413,0,0,66,66,0,1,0,1,0,1
64997,53,57263,53,166,86,80,2,31,1,1,0
50461,445,0,0,66,66,0,1,0,1,0,2
6881,55108,0,0,143,143,0,1,0,1,0,1
38753,443,17390,443,29887852,586245,29301607,27419,299,7975,19444,0
42904,53,51732,53,308,118,190,2,30,1,1,0
63405,445,0,0,70,70,0,1,0,1,0,2
55156,53,26617,53,194,102,92,2,31,1,1,0
58770,53,51678,53,168,78,90,2,31,1,1,0
58455,80,58455,80,348,132,216,6,15,3,3,0
53968,17904,18186,17904,320,140,180,6,7,3,3,0
56000,53,8849,53,177,94,83,2,31,1,1,0
51179,445,0,0,66,66,0,1,0,1,0,2
49656,53,55066,53,193,102,91,2,30,1,1,0
55745,53,2082,53,198,101,97,2,30,1,1,0
58046,80,28676,80,2306,1112,1194,23,76,12,11,0
51605,443,15283,443,4343,2350,1993,17,36,9,8,0
57282,53,14101,53,199,102,97,2,30,1,1,0
47050,53,14793,53,199,94,105,2,30,1,1,0
19052,7000,19052,7000,2205,815,1390,13,16,7,6,0
25565,62778,0,0,60,60,0,1,0,1,0,1
37009,53,17382,53,78,78,0,1,30,1,0,0
37042,53,37042,53,237,98,139,2,30,1,1,0
56708,443,9469,443,6155,919,5236,18,55,10,8,0
57452,53,53868,53,776,102,674,2,30,1,1,0
50187,53,34456,53,168,78,90,2,30,1,1,0
57093,53,32863,53,711,87,624,2,30,1,1,0
53517,445,0,0,66,66,0,1,0,1,0,2
48389,443,33224,443,6616,3644,2972,18,122,9,9,0
50898,443,4601,443,8480,2236,6244,27,81,15,12,0
56125,53,3352,53,168,86,82,2,30,1,1,0
51167,445,0,0,66,66,0,1,0,1,0,2
57271,443,34428,443,7155,2151,5004,34,33,20,14,0
56862,80,27370,80,2058,589,1469,10,45,6,4,0
55005,53,24549,53,183,94,89,2,30,1,1,0
63475,445,0,0,70,70,0,1,0,1,0,2
63846,445,0,0,66,66,0,1,0,1,0,2
61806,445,0,0,66,66,0,1,0,1,0,2
65015,22114,0,0,66,66,0,1,0,1,0,1
56376,53,35947,53,198,102,96,2,30,1,1,0
15227,26467,0,0,66,66,0,1,0,1,0,1
49262,445,0,0,70,70,0,1,0,1,0,2
7928,80,7928,80,25909,3016,22893,40,83,15,25,0
56493,443,6298,443,10532,6786,3746,55,81,28,27,0
30046,15503,0,0,62,62,0,1,0,1,0,1
58217,445,0,0,70,70,0,1,0,1,0,2
49950,445,0,0,70,70,0,1,0,1,0,2
42664,80,62788,80,63654,7979,55675,90,91,49,41,0
54319,53,54319,53,253,99,154,2,32,1,1,0
64205,53,47320,53,178,94,84,2,31,1,1,0
53201,445,0,0,66,66,0,1,0,1,0,2
56581,445,0,0,66,66,0,1,0,1,0,2
49183,53,46145,53,817,102,715,2,30,1,1,0
55492,80,58922,80,164902,9835,155067,227,32,114,113,0
26527,25174,0,0,62,62,0,1,0,1,0,1
33886,52255,0,0,162,162,0,1,0,1,0,1
39435,443,17310,443,2403265,93626,2309639,2795,243,1103,1692,0
53890,445,0,0,70,70,0,1,0,1,0,2
63789,443,32462,443,4407024,140001,4267023,4628,124,1546,3082,0
63849,16632,40129,16632,66,66,0,1,5,1,0,0
53781,36366,44419,36366,70,70,0,2,8,2,0,0
64748,53,54501,53,183,94,89,2,30,1,1,0
53145,27067,38874,27067,1231702,397859,833843,10382,185,4780,5602,0
26900,27017,46101,27017,422,164,258,6,30,3,3,0
58638,5900,0,0,62,62,0,1,0,1,0,1
38680,443,52567,443,90091,3481,86610,95,15,31,64,0
56805,53,61616,53,178,94,84,2,31,1,1,0
48817,6881,48817,6881,506,152,354,2,1200,1,1,0
27269,53,56522,53,199,94,105,2,31,1,1,0
49841,53,34208,53,264,110,154,2,31,1,1,0
63064,443,24318,443,12008,2367,9641,32,151,18,14,0
5578,53,5578,53,288,83,205,2,31,1,1,0
30188,64511,50224,64511,854,150,704,4,1200,2,2,0
9121,80,6298,80,318,192,126,6,29,4,2,0
62859,35440,0,0,66,66,0,1,0,1,0,1
52070,445,0,0,66,66,0,1,0,1,0,2
43584,24748,0,0,156,156,0,1,0,1,0,1
41477,50584,0,0,66,66,0,1,0,1,0,1
59275,445,0,0,70,70,0,1,0,1,0,2
65073,53,40365,53,293,102,191,2,30,1,1,0
2267,53,13385,53,204,118,86,2,31,1,1,0
56382,53,5952,53,195,102,93,2,31,1,1,0
63937,445,0,0,70,70,0,1,0,1,0,2
52189,53,52189,53,825,99,726,2,30,1,1,0
58638,5900,0,0,62,62,0,1,0,1,0,1
63092,443,8576,443,4771341,155341,4616000,5024,147,1667,3357,0
18653,42707,0,0,66,66,0,1,0,1,0,1
51998,1877,49263,1877,316,136,180,6,6,3,3,0
54651,445,0,0,66,66,0,1,0,1,0,2
53571,445,0,0,70,70,0,1,0,1,0,2
56028,53,49252,53,770,102,668,2,31,1,1,0
46713,53,46713,53,217,87,130,2,31,1,1,0
57578,443,34885,443,13999,3478,10521,33,134,15,18,0
40571,26467,0,0,62,62,0,1,0,1,0,1
63517,445,0,0,70,70,0,1,0,1,0,2
65355,53,61445,53,741,94,647,2,30,1,1,0
63831,31539,8065,31539,312,132,180,6,7,3,3,0
64535,37965,0,0,66,66,0,1,0,1,0,1
44395,443,50721,443,18921,10848,8073,49,401,20,29,0
50875,443,41381,443,1786,172,1614,7,121,3,4,0
49580,445,0,0,70,70,0,1,0,1,0,2
34787,80,1192,80,2989,813,2176,15,166,8,7,0
53827,5889,39241,5889,70,70,0,1,4,1,0,0
57038,445,0,0,70,70,0,1,0,1,0,2
56273,53,61553,53,194,99,95,2,30,1,1,0
52425,80,64946,80,1630,918,712,12,16,7,5,0
49192,80,39568,80,2807,587,2220,13,16,7,6,0
64259,53,65307,53,211,78,133,2,31,1,1,0
49241,53,22091,53,785,110,675,2,30,1,1,0
1036,64147,0,0,145,145,0,1,0,1,0,1
62894,993,44411,993,8840,4151,4689,80,190,41,39,0
59037,51505,0,0,66,66,0,1,0,1,0,1
56789,443,8502,443,7877,1888,5989,20,15,11,9,0
64551,53,2637,53,354,94,260,2,30,1,1,0
50152,80,46738,80,731402,17622,713780,600,97,116,484,0
52933,445,0,0,66,66,0,1,0,1,0,2
51026,37450,0,0,62,62,0,1,0,1,0,1
65144,53,2841,53,210,110,100,2,29,1,1,0
59857,445,0,0,66,66,0,1,0,1,0,2
64991,53,47067,53,625,192,433,6,46,3,3,0
55155,53,23280,53,194,102,92,2,30,1,1,0
52828,51221,0,0,66,66,0,1,0,1,0,1
57772,443,4338,443,6783,3270,3513,22,120,11,11,0
49541,443,61178,443,8464,2891,5573,20,30,10,10,0
49926,53,63439,53,180,94,86,2,30,1,1,0
22300,51505,0,0,62,62,0,1,0,1,0,1
58022,5601,0,0,60,60,0,1,0,1,0,1
52149,80,52149,80,2928,694,2234,13,141,6,7,0
50195,53,23918,53,199,102,97,2,30,1,1,0
9731,64147,0,0,62,62,0,1,0,1,0,1
54517,443,8632,443,11460,2522,8938,19,122,9,10,0
44594,64147,0,0,66,66,0,1,0,1,0,1
54114,445,0,0,70,70,0,1,0,1,0,2
52731,445,0,0,66,66,0,1,0,1,0,2
52451,56205,0,0,66,66,0,1,0,1,0,1
65437,53,61379,53,195,102,93,2,31,1,1,0
46116,51505,0,0,62,62,0,1,0,1,0,1
57351,53,48672,53,184,94,90,2,29,1,1,0
31845,55777,0,0,62,62,0,1,0,1,0,1
62153,35440,0,0,66,66,0,1,0,1,0,1
63983,445,0,0,70,70,0,1,0,1,0,2
7539,30317,0,0,62,62,0,1,0,1,0,1
51414,22,0,0,60,60,0,1,0,1,0,1
35336,443,36436,443,6821,1076,5745,21,27,12,9,0
62952,35440,0,0,66,66,0,1,0,1,0,1
42298,40016,13493,40016,148,86,62,2,30,1,1,0
26953,30317,0,0,62,62,0,1,0,1,0,1
52926,445,0,0,66,66,0,1,0,1,0,2
55496,64097,0,0,62,62,0,1,0,1,0,1
45964,59999,45964,59999,60,60,0,1,5,1,0,0
60962,53,0,0,180,80,100,2,31,1,1,0
51172,443,45149,443,1472,965,507,13,20,7,6,0
57096,445,0,0,66,66,0,1,0,1,0,2
63398,25174,0,0,66,66,0,1,0,1,0,1
65407,445,0,0,66,66,0,1,0,1,0,2
51685,445,0,0,66,66,0,1,0,1,0,2
63933,443,50085,443,6822,3370,3452,21,135,10,11,0
51129,80,6520,80,2794,2075,719,15,30,9,6,0
28549,53,28549,53,194,87,107,2,30,1,1,0
57613,80,57613,80,349583,9149,340434,298,25,62,236,0
57672,445,0,0,66,66,0,1,0,1,0,2
27055,25174,0,0,146,146,0,1,0,1,0,1
49742,53,16673,53,216,110,106,2,30,1,1,0
49250,80,27382,80,1623,629,994,8,75,5,3,0
48817,32794,48817,32794,152,152,0,1,1200,1,0,0
49911,53,26669,53,258,110,148,2,30,1,1,0
49748,53,20050,53,763,102,661,2,30,1,1,0
22948,26467,0,0,62,62,0,1,0,1,0,1
33359,30188,0,0,62,62,0,1,0,1,0,1
23415,11392,0,0,66,66,0,1,0,1,0,1
65488,443,64323,443,92286,4799,87487,107,16,43,64,0
49160,61365,56372,61365,502,150,352,3,1200,2,1,0
60886,445,0,0,70,70,0,1,0,1,0,2
55806,445,0,0,66,66,0,1,0,1,0,2
1029,44847,0,0,62,62,0,1,0,1,0,1
65115,53,30107,53,253,87,166,4,31,2,2,0
50405,445,0,0,70,70,0,1,0,1,0,2
63263,57470,0,0,66,66,0,1,0,1,0,1
65179,44847,0,0,66,66,0,1,0,1,0,1
35101,443,31000,443,4988930,161289,4827641,5384,290,1964,3420,0
53811,445,0,0,66,66,0,1,0,1,0,2
53526,445,0,0,66,66,0,1,0,1,0,2
53590,8999,22601,8999,1207,605,602,10,25,5,5,0
16403,16384,8455,16384,426,186,240,8,30,4,4,0
4876,42920,0,0,146,146,0,1,0,1,0,1
64410,53,32197,53,286,98,188,4,40,2,2,0
23228,443,23228,443,20540,5514,15026,52,76,29,23,0
2088,7010,2088,7010,10300,8829,1471,24,15,13,11,0
41472,443,61400,443,680618,28384,652234,828,84,356,472,0
56762,53,10015,53,168,86,82,2,29,1,1,0
65512,44847,0,0,66,66,0,1,0,1,0,1
36339,443,4245,443,7295,1830,5465,23,316,13,10,0
51845,11201,33761,11201,316,136,180,6,6,3,3,0
55964,443,21962,443,4455,798,3657,17,136,7,10,0
50971,80,41640,80,1094437,6233,1088204,817,36,92,725,0
52643,15941,0,0,66,66,0,1,0,1,0,1
50545,445,0,0,66,66,0,1,0,1,0,2
49441,443,28685,443,2921276,89544,2831732,3090,63,1086,2004,0
54011,445,0,0,66,66,0,1,0,1,0,2
55630,53,39473,53,197,102,95,2,30,1,1,0
55714,443,18718,443,11626,4173,7453,25,121,12,13,0
55262,443,33483,443,28633618,753499,27880119,30116,102,8846,21270,0
58773,445,0,0,70,70,0,1,0,1,0,2
65282,53,57609,53,522,91,431,4,49,2,2,0
53605,443,11722,443,8738,2628,6110,23,154,11,12,0
50781,445,0,0,70,70,0,1,0,1,0,2
52046,59791,37077,59791,70,70,0,2,7,2,0,0
59763,25604,0,0,66,66,0,1,0,1,0,1
56852,53,36624,53,762,101,661,2,31,1,1,0
22220,25174,0,0,62,62,0,1,0,1,0,1
19610,9571,0,0,62,62,0,1,0,1,0,1
49835,53,4123,53,250,86,164,4,30,2,2,0
57990,445,0,0,66,66,0,1,0,1,0,2
49001,40108,0,0,161,161,0,1,0,1,0,1
59060,50584,0,0,66,66,0,1,0,1,0,1
58638,5900,0,0,62,62,0,1,0,1,0,1
53792,443,8707,443,499,425,74,4,0,3,1,0
64251,53,65162,53,177,94,83,2,30,1,1,0
56092,56205,0,0,146,146,0,1,0,1,0,1
65282,53,39898,53,193,102,91,2,30,1,1,0
53980,443,7192,443,4957,1627,3330,17,120,8,9,0
57528,53,37207,53,585,192,393,6,54,3,3,0
62102,443,60782,443,3182,1568,1614,8,121,4,4,0
48817,51414,48817,51414,150,150,0,1,1200,1,0,0
51493,80,21444,80,9524,736,8788,18,131,9,9,0
50265,44843,10747,44843,70,70,0,1,1200,1,0,0
56912,53,3525,53,199,102,97,2,30,1,1,0
55666,35440,0,0,66,66,0,1,0,1,0,1
52246,445,0,0,70,70,0,1,0,1,0,2
123,123,46819,123,184,94,90,2,29,1,1,0
26642,57470,0,0,62,62,0,1,0,1,0,1
57576,445,0,0,70,70,0,1,0,1,0,2
10833,23,0,0,60,60,0,1,0,1,0,1
46405,80,41634,80,1213,755,458,10,15,6,4,0
64808,27098,0,0,66,66,0,1,0,1,0,1
65436,53,8668,53,234,94,140,2,29,1,1,0
50897,445,0,0,70,70,0,1,0,1,0,2
61669,443,27122,443,12453,3460,8993,43,18,24,19,0
45035,80,33169,80,3720,1663,2057,17,186,10,7,0
49964,53,63838,53,380,110,270,2,31,1,1,0
49512,53,60222,53,195,102,93,2,31,1,1,0
50281,53,33175,53,195,102,93,2,30,1,1,0
54956,53,14576,53,194,102,92,2,31,1,1,0
54393,445,0,0,70,70,0,1,0,1,0,2
65386,53,22726,53,184,102,82,2,29,1,1,0
27005,27016,54268,27016,1642,126,1516,4,31,2,2,0
56301,443,56301,443,4378,1471,2907,19,30,11,8,0
57003,443,38569,443,8592,3700,4892,39,108,21,18,0
60683,443,28178,443,17071,1532,15539,17,147,3,14,0
53671,60416,30870,60416,70,70,0,1,4,1,0,0
64988,53,16723,53,196,94,102,2,30,1,1,0
36148,443,59223,443,2233,1237,996,18,75,9,9,0
48458,53,36064,53,289,86,203,2,29,1,1,0
51522,445,0,0,70,70,0,1,0,1,0,2
51578,44847,0,0,66,66,0,1,0,1,0,1
49364,53,61563,53,182,94,88,2,30,1,1,0
49880,53,5726,53,194,102,92,2,30,1,1,0
45051,23,0,0,60,60,0,1,0,1,0,1
58904,123,61821,123,184,94,90,2,30,1,1,0
57509,443,8553,443,5150,3987,1163,18,38,11,7,0
55996,53,10816,53,168,86,82,2,30,1,1,0
63020,445,0,0,70,70,0,1,0,1,0,2
54835,443,32514,443,15578,7071,8507,69,140,33,36,0
50540,80,53400,80,2175,1539,636,13,27,8,5,0
27005,27015,58222,27015,901,126,775,2,30,1,1,0
39852,80,39852,80,576,272,304,9,142,5,4,0
43611,50939,0,0,145,145,0,1,0,1,0,1
65371,53,1608,53,199,102,97,2,30,1,1,0
40803,443,57775,443,1093,662,431,10,46,6,4,0
54216,445,0,0,70,70,0,1,0,1,0,1
56272,53,7235,53,193,102,91,2,30,1,1,0
52985,80,52009,80,3111,1364,1747,28,112,15,13,0
16387,61049,0,0,60,60,0,1,0,1,0,1
31675,19473,0,0,62,62,0,1,0,1,0,1
58742,443,35475,443,5166,700,4466,16,15,7,9,0
56273,53,51229,53,197,102,95,2,33,1,1,0
36906,50584,0,0,146,146,0,1,0,1,0,1
56142,445,0,0,70,70,0,1,0,1,0,2
60258,80,44486,80,3348,2437,911,12,150,7,5,0
39774,443,8618,443,69542,11991,57551,139,157,60,79,0
49805,53,26905,53,296,102,194,2,30,1,1,0
52208,80,51352,80,372,246,126,6,28,4,2,0
65130,445,0,0,66,66,0,1,0,1,0,2
50060,80,8335,80,2425,529,1896,11,75,6,5,0
64023,53,2522,53,179,94,85,2,29,1,1,0
56897,11446,0,0,66,66,0,1,0,1,0,1
52747,445,0,0,66,66,0,1,0,1,0,2
36336,443,11755,443,8111,5060,3051,31,396,11,20,0
59198,445,0,0,66,66,0,1,0,1,0,2
55866,445,0,0,66,66,0,1,0,1,0,2
65055,53,55759,53,1426,98,1328,4,55,2,2,0
27988,40013,46561,40013,148,86,62,2,30,1,1,0
35497,443,49704,443,162,102,60,2,4,1,1,0
35459,443,42175,443,2350,1392,958,17,275,9,8,0
64633,445,0,0,66,66,0,1,0,1,0,2
64957,53,56586,53,196,102,94,2,31,1,1,0
57432,443,22941,443,26468,3325,23143,41,147,16,25,0
33994,443,56656,443,19547,2951,16596,42,82,21,21,0
65143,53,45277,53,184,94,90,2,30,1,1,0
51465,443,37534,443,318,70,248,5,17,1,4,0
50478,51505,0,0,62,62,0,1,0,1,0,1
41270,443,43404,443,14659,5023,9636,46,400,14,32,0
53165,18504,45814,18504,70,70,0,2,8,2,0,0
53437,443,53437,443,4198,2498,1700,25,102,12,13,0
55340,53,17205,53,184,94,90,2,30,1,1,0
59874,445,0,0,66,66,0,1,0,1,0,2
58736,445,0,0,70,70,0,1,0,1,0,2
50270,445,0,0,70,70,0,1,0,1,0,2
19473,61397,60276,61397,323,150,173,2,1200,1,1,0
59600,445,0,0,66,66,0,1,0,1,0,2
51042,22114,0,0,66,66,0,1,0,1,0,1
59467,445,0,0,66,66,0,1,0,1,0,2
56836,1,16144,1,130,70,60,2,5,1,1,0
52034,80,60212,80,366,240,126,7,25,5,2,0
51457,445,0,0,70,70,0,1,0,1,0,2
49442,53,12597,53,326,110,216,2,30,1,1,0
57501,445,0,0,70,70,0,1,0,1,0,2
56513,53,54850,53,215,102,113,2,30,1,1,0
10151,27715,29644,27715,460,150,310,2,1200,1,1,0
53122,29070,40660,29070,758,320,438,11,16,6,5,0
54376,445,0,0,70,70,0,1,0,1,0,2
30188,41184,4045,41184,509,150,359,2,1200,1,1,0
65260,53,63253,53,184,94,90,2,30,1,1,0
57763,445,0,0,70,70,0,1,0,1,0,2
26900,27017,46394,27017,422,164,258,6,30,3,3,0
50203,443,50531,443,3792,871,2921,16,121,7,9,0
55317,445,0,0,70,70,0,1,0,1,0,2
50465,80,51689,80,3688274,86827,3601447,3622,32,1228,2394,0
33289,50584,0,0,146,146,0,1,0,1,0,1
52166,26467,0,0,66,66,0,1,0,1,0,1
1933,53,18812,53,210,78,132,2,29,1,1,0
40185,64147,0,0,66,66,0,1,0,1,0,1
21348,22,0,0,60,60,0,1,0,1,0,1
52091,80,64640,80,2825,716,2109,12,22,7,5,0
64445,53,20808,53,269,94,175,2,30,1,1,0
5227,50584,0,0,146,146,0,1,0,1,0,1
48731,443,51910,443,769074,31261,737813,876,165,356,520,0
40249,443,14843,443,70,70,0,1,5,1,0,0
45766,2323,0,0,60,60,0,1,0,1,0,1
55002,443,46892,443,6953,2447,4506,26,37,15,11,0
60631,445,0,0,70,70,0,1,0,1,0,2
64295,445,0,0,66,66,0,1,0,1,0,2
63830,445,0,0,70,70,0,1,0,1,0,2
51457,445,0,0,70,70,0,1,0,1,0,2
51908,443,56072,443,8481,1976,6505,23,25,13,10,0
54276,39004,0,0,66,66,0,1,0,1,0,1
53257,37450,0,0,66,66,0,1,0,1,0,1
60430,51413,63647,51413,70,70,0,2,8,2,0,0
49718,53,39555,53,793,101,692,2,30,1,1,0
65435,53,59924,53,196,94,102,2,29,1,1,0
64371,53,21841,53,181,86,95,2,30,1,1,0
2267,53,48892,53,204,118,86,2,30,1,1,0
60875,50584,0,0,62,62,0,1,0,1,0,1
43094,443,34606,443,6443,1973,4470,19,16,11,8,0
57698,64147,0,0,66,66,0,1,0,1,0,1
50626,445,0,0,66,66,0,1,0,1,0,2
35817,443,2802,443,3120,1862,1258,18,15,11,7,0
60245,25174,0,0,62,62,0,1,0,1,0,1
65512,53,60205,53,744,95,649,2,31,1,1,0
29178,35440,0,0,62,62,0,1,0,1,0,1
57289,445,0,0,70,70,0,1,0,1,0,2
35229,443,14508,443,9488,4114,5374,27,363,14,13,0
55835,53,7338,53,176,90,86,2,31,1,1,0
10704,25174,0,0,62,62,0,1,0,1,0,1
64249,445,0,0,70,70,0,1,0,1,0,2
49825,443,10152,443,15401,3011,12390,37,65,21,16,0
59488,80,65175,80,1114,534,580,12,16,7,5,0
36679,443,65477,443,466,392,74,4,0,3,1,0
65513,53,51212,53,216,102,114,2,30,1,1,0
63950,53,31406,53,200,102,98,2,30,1,1,0
55260,53,35785,53,183,94,89,2,30,1,1,0
53124,80,20707,80,4198,3534,664,13,19,8,5,0
57034,44847,0,0,66,66,0,1,0,1,0,1
50419,80,40888,80,3664,1440,2224,12,23,6,6,0
56038,53,20578,53,177,94,83,2,29,1,1,0
64050,53,59472,53,389,94,295,2,30,1,1,0
47258,443,16882,443,50898,2733,48165,73,218,33,40,0
52838,37965,0,0,66,66,0,1,0,1,0,1
9327,57470,0,0,62,62,0,1,0,1,0,1
64063,53,31532,53,339,110,229,2,29,1,1,0
49520,445,0,0,70,70,0,1,0,1,0,2
39735,53,51086,53,223,78,145,2,30,1,1,0
64770,53,63194,53,93,93,0,1,31,1,0,0
58318,445,0,0,70,70,0,1,0,1,0,2
61375,445,0,0,70,70,0,1,0,1,0,2
52144,445,0,0,70,70,0,1,0,1,0,2
53409,445,0,0,70,70,0,1,0,1,0,2
61915,445,0,0,70,70,0,1,0,1,0,2
56815,445,0,0,70,70,0,1,0,1,0,2
46324,443,40837,443,24465,3945,20520,39,18,18,21,0
54786,30188,0,0,66,66,0,1,0,1,0,1
53746,7546,50898,7546,70,70,0,1,4,1,0,0
7968,2767,0,0,66,66,0,1,0,1,0,1
60563,445,0,0,66,66,0,1,0,1,0,2
55966,57866,0,0,66,66,0,1,0,1,0,1
59660,445,0,0,66,66,0,1,0,1,0,2
55411,53,35188,53,200,94,106,2,30,1,1,0
57470,46941,64707,46941,899,288,611,4,1199,2,2,0
39995,443,64142,443,6812,2910,3902,31,282,8,23,0
54717,445,0,0,66,66,0,1,0,1,0,2
28000,443,52315,443,5746,1271,4475,25,105,12,13,0
58730,445,0,0,70,70,0,1,0,1,0,2
26900,27017,25587,27017,422,164,258,6,30,3,3,0
64998,27037,52668,27037,3573,2238,1335,16,34,8,8,0
65387,445,0,0,70,70,0,1,0,1,0,2
49141,443,32844,443,2595,1230,1365,18,16,9,9,0
55220,53,13554,53,193,102,91,2,30,1,1,0
64942,445,0,0,70,70,0,1,0,1,0,2
61485,445,0,0,66,66,0,1,0,1,0,2
5938,19141,0,0,60,60,0,1,91,1,0,0
59031,25174,0,0,62,62,0,1,0,1,0,1
55289,53,47764,53,446,94,352,4,44,2,2,0
55233,53,15536,53,215,102,113,2,30,1,1,0
61323,23117,0,0,146,146,0,1,0,1,0,1
23150,53,23150,53,365,233,132,3,32,2,1,0
33156,3478,41500,3478,338,110,228,2,300,1,1,0
49449,53,37523,53,216,110,106,2,29,1,1,0
57890,443,58945,443,3588,1991,1597,27,176,14,13,0
46662,36237,0,0,62,62,0,1,0,1,0,1
59736,51505,0,0,146,146,0,1,0,1,0,1
65419,53,59811,53,200,102,98,2,30,1,1,0
42361,23,0,0,60,60,0,1,0,1,0,1
61808,445,0,0,70,70,0,1,0,1,0,2
61741,443,4502,443,68851,3430,65421,93,121,35,58,0
64977,53,18612,53,334,94,240,2,30,1,1,0
53730,37096,47492,37096,70,70,0,2,7,2,0,0
65098,445,0,0,70,70,0,1,0,1,0,2
48557,37965,0,0,62,62,0,1,0,1,0,1
57352,53,8029,53,192,98,94,2,31,1,1,0
51654,80,46130,80,318,192,126,6,37,4,2,0
64956,53,25279,53,192,98,94,2,30,1,1,0
50177,443,50177,443,5206,1389,3817,22,15,10,12,0
55360,445,0,0,70,70,0,1,0,1,0,2
65269,53,18855,53,226,102,124,2,30,1,1,0
49780,53,7446,53,182,93,89,2,31,1,1,0
5631,80,5631,80,16287,756,15531,23,16,9,14,0
56645,443,5860,443,32966,3481,29485,49,80,21,28,0
60499,51413,63354,51413,70,70,0,1,5,1,0,0
49656,443,50043,443,11810,2769,9041,29,47,15,14,0
53230,443,53230,443,1462,916,546,13,34,7,6,0
27055,25174,0,0,62,62,0,1,0,1,0,1
53524,445,0,0,70,70,0,1,0,1,0,2
50672,445,0,0,70,70,0,1,0,1,0,2
56542,53,32612,53,183,94,89,2,31,1,1,0
57349,53,0,0,222,86,136,2,30,1,1,0
56767,53,58838,53,177,94,83,2,30,1,1,0
57131,8055,0,0,145,145,0,1,0,1,0,1
17750,12550,53024,12550,491,150,341,2,1200,1,1,0
44568,3389,0,0,60,60,0,1,0,1,0,1
56587,53,5530,53,184,94,90,2,31,1,1,0
53169,445,0,0,66,66,0,1,0,1,0,2
59500,445,0,0,70,70,0,1,0,1,0,2
57825,445,0,0,70,70,0,1,0,1,0,2
61961,11392,0,0,66,66,0,1,0,1,0,1
29787,37965,0,0,62,62,0,1,0,1,0,1
60720,443,36383,443,41921,15385,26536,69,34,37,32,0
48740,443,37273,443,7868,2194,5674,26,36,13,13,0
53967,54589,61471,54589,70,70,0,1,5,1,0,0
64122,53,44861,53,212,108,104,2,31,1,1,0
52327,53,21249,53,224,94,130,2,29,1,1,0
59079,445,0,0,70,70,0,1,0,1,0,2
56410,53,65347,53,757,98,659,2,30,1,1,0
11136,57587,0,0,62,62,0,1,0,1,0,1
57973,445,0,0,66,66,0,1,0,1,0,2
52519,80,46745,80,3771,3257,514,12,14,7,5,0
50853,50584,0,0,66,66,0,1,0,1,0,1
64672,53,41499,53,576,195,381,6,51,3,3,0
52523,443,12913,443,4307,2005,2302,37,18,20,17,0
64163,445,0,0,66,66,0,1,0,1,0,2
51548,445,0,0,70,70,0,1,0,1,0,2
44979,443,39259,443,10311,2186,8125,26,186,14,12,0
52797,443,22094,443,8355,1923,6432,32,16,18,14,0
51745,57470,0,0,145,145,0,1,0,1,0,1
29606,53,29606,53,216,90,126,2,30,1,1,0
51525,35440,0,0,66,66,0,1,0,1,0,1
56968,80,44242,80,53181,50384,2797,75,20,39,36,0
50632,80,1606,80,1559,1107,452,9,22,5,4,0
63589,44847,0,0,62,62,0,1,0,1,0,1
64825,445,0,0,70,70,0,1,0,1,0,2
63765,51221,0,0,62,62,0,1,0,1,0,1
24910,64147,0,0,66,66,0,1,0,1,0,1
55727,53,2459,53,195,102,93,2,29,1,1,0
63460,55160,0,0,66,66,0,1,0,1,0,1
44921,443,18740,443,5440,846,4594,15,15,9,6,0
58805,53,42120,53,237,86,151,2,30,1,1,0
40926,53,16373,53,168,78,90,2,30,1,1,0
59430,445,0,0,70,70,0,1,0,1,0,2
47504,443,4278,443,6496,3631,2865,71,606,39,32,0
49649,445,0,0,66,66,0,1,0,1,0,2
63733,47013,45780,47013,66,66,0,2,8,2,0,0
52425,443,43475,443,8454,978,7476,20,15,10,10,0
19699,48817,0,0,143,143,0,1,0,1,0,1
35897,443,1439,443,6692,1642,5050,24,275,11,13,0
57283,53,20762,53,185,102,83,2,29,1,1,0
57140,445,0,0,70,70,0,1,0,1,0,2
61392,50584,0,0,62,62,0,1,0,1,0,1
54592,445,0,0,70,70,0,1,0,1,0,2
11056,6881,0,0,146,146,0,1,0,1,0,1
9336,443,60185,443,4702,674,4028,15,15,8,7,0
36836,443,63140,443,7195,1791,5404,18,99,11,7,0
1404,51180,0,0,145,145,0,1,0,1,0,1
9186,80,65016,80,17643,1063,16580,26,35,11,15,0
58638,5900,0,0,62,62,0,1,0,1,0,1
49724,53,34584,53,210,102,108,2,30,1,1,0
56186,53,13478,53,198,102,96,2,31,1,1,0
50972,3544,50946,3544,258,107,151,2,30,1,1,0
60063,443,64614,443,432803,9264,423539,427,141,135,292,0
53471,445,0,0,70,70,0,1,0,1,0,2
53004,445,0,0,70,70,0,1,0,1,0,2
64797,53,54337,53,182,93,89,2,30,1,1,0
50137,1433,0,0,60,60,0,1,0,1,0,1
52764,445,0,0,70,70,0,1,0,1,0,2
53413,35440,0,0,146,146,0,1,0,1,0,1
58997,443,39971,443,3576,2319,1257,21,23,11,10,0
55691,16410,1413,16410,70,70,0,1,5,1,0,0
60823,445,0,0,66,66,0,1,0,1,0,2
55079,443,57713,443,7156,1187,5969,20,16,10,10,0
23061,23,0,0,60,60,0,1,0,1,0,1
51581,17546,0,0,66,66,0,1,0,1,0,1
53705,445,0,0,66,66,0,1,0,1,0,2
65092,53,28213,53,197,102,95,2,29,1,1,0
57291,53,9525,53,178,94,84,2,30,1,1,0
49941,53,13341,53,193,102,91,2,30,1,1,0
54236,36829,0,0,66,66,0,1,0,1,0,1
40207,80,3053,80,1364,860,504,13,32,8,5,0
58751,443,12034,443,10505,6856,3649,29,16,15,14,0
56096,445,0,0,70,70,0,1,0,1,0,2
55413,53,9671,53,216,110,106,2,31,1,1,0
33794,53,45704,53,168,78,90,2,29,1,1,0
49677,25174,0,0,66,66,0,1,0,1,0,1
26698,25174,0,0,62,62,0,1,0,1,0,1
50076,80,31297,80,1052,612,440,10,15,5,5,0
44913,36866,0,0,148,148,0,1,0,1,0,1
65085,22114,0,0,66,66,0,1,0,1,0,1
42925,443,37247,443,5617,1559,4058,22,138,13,9,0
49703,53,23224,53,288,102,186,2,31,1,1,0
64582,443,48743,443,24686,1935,22751,36,19,17,19,0
62768,443,53717,443,30902,6307,24595,86,269,36,50,0
56322,445,0,0,66,66,0,1,0,1,0,2
12567,53,12567,53,231,90,141,2,30,1,1,0
58638,5900,0,0,62,62,0,1,0,1,0,1
55812,53,26314,53,215,94,121,2,30,1,1,0
27005,27016,42013,27016,893,126,767,2,31,1,1,0
14208,51221,0,0,66,66,0,1,0,1,0,1
65253,53,8346,53,766,102,664,2,30,1,1,0
61165,445,0,0,70,70,0,1,0,1,0,2
7067,22114,0,0,62,62,0,1,0,1,0,1
49964,53,64934,53,749,94,655,2,30,1,1,0
44884,443,49689,443,296,78,218,4,19,1,3,0
33576,443,52498,443,170319,23354,146965,283,34,121,162,0
57319,443,43757,443,134,60,74,3,5,2,1,0
56860,53,63586,53,184,102,82,2,30,1,1,0
53275,21247,0,0,66,66,0,1,0,1,0,1
9494,23,0,0,60,60,0,1,0,1,0,1
3891,53,3891,53,235,90,145,2,32,1,1,0
26879,37965,0,0,62,62,0,1,0,1,0,1
64016,25174,0,0,62,62,0,1,0,1,0,1
52876,445,0,0,66,66,0,1,0,1,0,2
56391,445,0,0,66,66,0,1,0,1,0,2
64406,25174,0,0,62,62,0,1,0,1,0,1
59303,21247,0,0,66,66,0,1,0,1,0,1
53268,443,33392,443,13176,4779,8397,47,17,29,18,0
52193,33027,51097,33027,70,70,0,1,5,1,0,0
64695,53,7882,53,275,118,157,2,30,1,1,0
12951,50584,0,0,66,66,0,1,0,1,0,1
62339,25174,0,0,66,66,0,1,0,1,0,1
48304,443,22064,443,6606,2153,4453,22,95,13,9,0
50542,80,60343,80,1607,970,637,8,16,5,3,0
62489,445,0,0,66,66,0,1,0,1,0,2
14489,25174,0,0,146,146,0,1,0,1,0,1
49211,15576,51582,15576,70,70,0,2,8,2,0,0
60319,23,0,0,60,60,0,1,0,1,0,1
55677,53,59623,53,177,94,83,2,30,1,1,0
63560,443,29520,443,2773,1570,1203,22,275,11,11,0
56069,445,0,0,70,70,0,1,0,1,0,2
53495,37807,0,0,66,66,0,1,0,1,0,1
45816,443,45816,443,4430,1523,2907,19,27,11,8,0
55530,80,60637,80,3334,2314,1020,19,39,11,8,0
55674,48870,28202,48870,70,70,0,1,5,1,0,0
64013,57470,0,0,74,74,0,1,0,1,0,1
27839,53,27839,53,213,87,126,2,31,1,1,0
14336,64147,0,0,62,62,0,1,0,1,0,1
39416,443,22181,443,621104,12188,608916,575,78,149,426,0
55066,80,57629,80,2554,1742,812,15,77,8,7,0
56232,443,31381,443,9920,3980,5940,24,40,12,12,0
52202,64241,11975,64241,164,70,94,2,4,1,1,0
57866,53,0,0,216,80,136,2,30,1,1,0
53143,50584,0,0,66,66,0,1,0,1,0,1
43374,443,52439,443,10176,2162,8014,25,186,14,11,0
59345,25174,0,0,62,62,0,1,0,1,0,1
43600,443,57317,443,172272,14401,157871,254,418,100,154,0
40603,443,49368,443,9462,6402,3060,32,394,11,21,0
61542,443,4330,443,6049,1986,4063,23,19,12,11,0
64955,53,3638,53,210,110,100,2,29,1,1,0
65251,53,53427,53,199,102,97,2,30,1,1,0
2522,64147,0,0,62,62,0,1,0,1,0,1
49178,53,11567,53,822,102,720,2,29,1,1,0
54666,445,0,0,66,66,0,1,0,1,0,2
55171,53,26173,53,762,97,665,2,31,1,1,0
49478,53,32475,53,551,114,437,4,37,2,2,0
57449,80,1245,80,4508,2978,1530,13,15,6,7,0
60517,445,0,0,70,70,0,1,0,1,0,2
55027,48051,0,0,62,62,0,1,0,1,0,1
57285,443,38646,443,21198,9647,11551,97,20,52,45,0
64745,3389,64745,3389,3413,1458,1955,16,18,8,8,0
56680,8100,18544,8100,78,78,0,1,4,1,0,0
51603,443,54804,443,19849,6817,13032,45,37,23,22,0
56876,53,26048,53,283,110,173,2,29,1,1,0
37790,443,42788,443,448,78,370,6,25,1,5,0
49558,53,30601,53,184,94,90,2,30,1,1,0
55399,53,43504,53,180,94,86,2,30,1,1,0
49303,443,12405,443,10844,5117,5727,42,17,25,17,0
50498,80,12035,80,312,192,120,6,25,4,2,0
48817,18529,48817,18529,152,152,0,1,1200,1,0,0
56453,37965,0,0,66,66,0,1,0,1,0,1
1441,51221,0,0,62,62,0,1,0,1,0,1
56601,53,46710,53,177,94,83,2,30,1,1,0
56599,443,36954,443,348780,9144,339636,358,32,123,235,0
38260,443,50232,443,7173,1419,5754,32,383,11,21,0
55918,53,24727,53,184,94,90,2,30,1,1,0
56720,53,21366,53,170,87,83,2,31,1,1,0
50294,80,24616,80,1515,481,1034,11,15,6,5,0
52148,443,33858,443,375357,11451,363906,356,61,100,256,0
57384,53,45393,53,752,93,659,2,31,1,1,0
55349,445,0,0,66,66,0,1,0,1,0,2
49486,53,16915,53,177,94,83,2,30,1,1,0
51752,445,0,0,70,70,0,1,0,1,0,2
65386,443,29589,443,5405,4034,1371,25,43,10,15,0
50874,80,33456,80,331828,15003,316825,363,141,140,223,0
17101,25174,0,0,66,66,0,1,0,1,0,1
49628,53,6846,53,168,86,82,2,31,1,1,0
64056,51266,62758,51266,66,66,0,2,8,2,0,0
1873,37965,0,0,62,62,0,1,0,1,0,1
57301,53,28379,53,177,94,83,2,30,1,1,0
60104,30188,0,0,62,62,0,1,0,1,0,1
62813,25174,0,0,62,62,0,1,0,1,0,1
28236,443,42527,443,9686,2335,7351,28,124,13,15,0
54985,53,45907,53,177,94,83,2,30,1,1,0
7048,25174,0,0,62,62,0,1,0,1,0,1
52680,445,0,0,70,70,0,1,0,1,0,2
56099,53,33681,53,701,88,613,2,30,1,1,0
64791,443,34950,443,4725,1727,2998,11,121,6,5,0
49397,53,28669,53,365,94,271,2,30,1,1,0
26180,35440,0,0,66,66,0,1,0,1,0,1
38549,22114,0,0,62,62,0,1,0,1,0,1
63708,25174,0,0,66,66,0,1,0,1,0,1
54862,445,0,0,70,70,0,1,0,1,0,2
27296,443,26053,443,10243,1659,8584,29,83,13,16,0
58683,445,0,0,70,70,0,1,0,1,0,2
49628,445,0,0,70,70,0,1,0,1,0,2
26900,27017,17453,27017,172,86,86,2,29,1,1,0
57395,53,57395,53,208,82,126,2,30,1,1,0
50988,443,14910,443,6938,2686,4252,25,27,12,13,0
53144,58987,40200,58987,70,70,0,1,5,1,0,0
47894,443,29583,443,295475,14093,281382,413,469,162,251,0
54408,445,0,0,70,70,0,1,0,1,0,2
64911,53,26816,53,209,110,99,2,31,1,1,0
63725,80,55530,80,374,192,182,7,15,4,3,0
51260,80,52216,80,23175,13071,10104,134,1929,67,67,0
51838,443,42521,443,9329,3898,5431,21,39,12,9,0
38715,443,52129,443,403299,12717,390582,439,16,171,268,0
49913,53,6290,53,216,110,106,2,30,1,1,0
55031,445,0,0,66,66,0,1,0,1,0,2
50839,445,0,0,70,70,0,1,0,1,0,2
64249,53,6288,53,181,94,87,2,33,1,1,0
35440,443,40080,443,7419,2136,5283,23,255,11,12,0
34466,443,32529,443,1402,910,492,11,360,6,5,0
57157,53,17035,53,755,94,661,2,31,1,1,0
56946,1,0,0,66,66,0,1,0,1,0,1
52946,445,0,0,70,70,0,1,0,1,0,2
7975,53,7975,53,237,91,146,2,33,1,1,0
54365,443,56544,443,3970,1726,2244,13,134,6,7,0
64842,53,17214,53,802,104,698,2,31,1,1,0
60763,445,0,0,66,66,0,1,0,1,0,2
49810,445,0,0,70,70,0,1,0,1,0,2
56748,53,55168,53,184,94,90,2,30,1,1,0
56278,52752,0,0,62,62,0,1,0,1,0,1
44847,31381,18131,31381,150,150,0,1,1200,1,0,0
64987,53,57288,53,196,102,94,2,31,1,1,0
16387,16862,0,0,60,60,0,1,0,1,0,1
13090,36237,0,0,62,62,0,1,0,1,0,1
58635,51505,0,0,62,62,0,1,0,1,0,1
64707,53,28396,53,757,98,659,2,31,1,1,0
50355,443,60927,443,4137,2232,1905,13,132,8,5,0
42479,80,8740,80,696,413,283,7,15,5,2,0
42980,80,62897,80,944,529,415,11,315,6,5,0
47950,443,47950,443,9159,1627,7532,19,150,11,8,0
51935,445,0,0,70,70,0,1,0,1,0,2
64292,445,0,0,70,70,0,1,0,1,0,2
58515,445,0,0,70,70,0,1,0,1,0,2
61104,445,0,0,70,70,0,1,0,1,0,2
49931,53,19319,53,190,97,93,2,31,1,1,0
50007,445,0,0,70,70,0,1,0,1,0,2
49364,443,26461,443,8376,2198,6178,25,81,14,11,0
63421,53,63421,53,223,86,137,2,30,1,1,0
50341,37965,0,0,62,62,0,1,0,1,0,1
62237,445,0,0,66,66,0,1,0,1,0,2
65100,53,16934,53,199,102,97,2,30,1,1,0
41499,23,0,0,60,60,0,1,0,1,0,1
51236,445,0,0,70,70,0,1,0,1,0,2
17411,43890,0,0,146,146,0,1,0,1,0,1
58034,443,61141,443,4553,856,3697,17,362,9,8,0
60196,53,0,0,88,88,0,1,0,1,0,1
49384,445,0,0,70,70,0,1,0,1,0,2
64431,53,35945,53,177,94,83,2,31,1,1,0
33941,37807,0,0,62,62,0,1,0,1,0,1
59914,65473,0,0,145,145,0,1,0,1,0,1
56752,443,27500,443,11771,2624,9147,50,20,25,25,0
57706,64147,0,0,62,62,0,1,0,1,0,1
61256,445,0,0,70,70,0,1,0,1,0,2
51774,16930,45672,16930,70,70,0,2,8,2,0,0
60308,443,63284,443,2622412,144918,2477494,3052,316,1078,1974,0
61295,443,30551,443,134322,10347,123975,220,304,77,143,0
52043,43578,45799,43578,316,136,180,6,6,3,3,0
56620,53,8741,53,214,102,112,2,30,1,1,0
50903,445,0,0,66,66,0,1,0,1,0,2
59810,6004,0,0,66,66,0,1,0,1,0,1
49396,53,18429,53,177,94,83,2,29,1,1,0
51754,18375,0,0,66,66,0,1,0,1,0,1
42298,40031,8368,40031,157,94,63,2,30,1,1,0
27005,27015,64723,27015,901,126,775,2,30,1,1,0
58638,5900,0,0,62,62,0,1,0,1,0,1
56420,80,57757,80,34636,928,33708,37,104,11,26,0
58638,5900,0,0,62,62,0,1,0,1,0,1
53556,1024,47936,1024,70,70,0,1,4,1,0,0
63447,44847,0,0,66,66,0,1,0,1,0,1
61280,26467,0,0,66,66,0,1,0,1,0,1
64763,53,53321,53,214,110,104,2,30,1,1,0
54189,64147,0,0,66,66,0,1,0,1,0,1
2267,53,49774,53,826,826,0,8,44,8,0,0
49966,445,0,0,70,70,0,1,0,1,0,2
61802,443,61802,443,4521,1614,2907,19,26,11,8,0
38634,443,16123,443,9096,1676,7420,20,18,10,10,0
54545,49344,0,0,66,66,0,1,0,1,0,1
53292,445,0,0,70,70,0,1,0,1,0,2
50496,80,19242,80,318,192,126,6,25,4,2,0
50017,443,54344,443,51055,17321,33734,147,612,77,70,0
64974,53,51198,53,493,111,382,4,57,2,2,0
54326,27054,42842,27054,924,924,0,3,30,3,0,0
60934,445,0,0,66,66,0,1,0,1,0,2
3766,25174,0,0,146,146,0,1,0,1,0,1
38330,44847,0,0,66,66,0,1,0,1,0,1
31362,23,31362,23,60,60,0,1,5,1,0,0
25523,35974,0,0,62,62,0,1,0,1,0,1
43750,443,22954,443,248384,70243,178141,544,588,246,298,0
53211,22114,0,0,66,66,0,1,0,1,0,1
58853,443,20470,443,155516,6298,149218,174,107,49,125,0
56306,445,0,0,66,66,0,1,0,1,0,2
1660,8696,0,0,62,62,0,1,0,1,0,1
36080,26467,0,0,62,62,0,1,0,1,0,1
36166,80,26343,80,1614,1300,314,10,15,5,5,0
10669,49756,0,0,60,60,0,1,0,1,0,1
52677,53,52677,53,233,91,142,2,31,1,1,0
64092,14447,29856,14447,66,66,0,1,5,1,0,0
51779,49525,24742,49525,70,70,0,2,8,2,0,0
50292,22114,0,0,62,62,0,1,0,1,0,1
60717,443,21678,443,61464,11538,49926,87,32,41,46,0
60303,445,0,0,70,70,0,1,0,1,0,2
55776,53,14354,53,271,93,178,4,31,2,2,0
57510,443,62415,443,16532,2229,14303,26,133,11,15,0
48706,23393,0,0,60,60,0,1,0,1,0,1
56858,32330,59933,32330,66,66,0,1,5,1,0,0
63853,10659,14752,10659,66,66,0,2,8,2,0,0
50161,445,0,0,66,66,0,1,0,1,0,2
64904,53,60868,53,198,101,97,2,31,1,1,0
52649,443,45569,443,6292,1492,4800,22,17,11,11,0
57840,53,57840,53,183,82,101,2,30,1,1,0
55994,53,14780,53,182,93,89,2,30,1,1,0
5588,5588,0,0,3354,1792,1562,46,193,23,23,0
51763,80,41535,80,3830,2255,1575,16,74,10,6,0
65108,53,46911,53,195,94,101,2,29,1,1,0
55855,53,27713,53,182,102,80,2,30,1,1,0
53305,50584,0,0,66,66,0,1,0,1,0,1
51878,9999,7906,9999,66,66,0,1,5,1,0,0
52462,25174,0,0,62,62,0,1,0,1,0,1
58498,445,0,0,66,66,0,1,0,1,0,2
63131,34880,2031,34880,316,190,126,5,15,3,2,0
53635,22383,54338,22383,492,306,186,8,17,5,3,0
45405,161,0,0,5858,2302,3556,22,30,11,11,0
30960,45739,64773,45739,330,330,0,6,3609,6,0,0
48282,8080,0,0,184,78,106,3,9,2,1,0
56326,53,47935,53,177,94,83,2,31,1,1,0
49230,445,0,0,70,70,0,1,0,1,0,2
55616,56205,0,0,66,66,0,1,0,1,0,1
53333,445,0,0,70,70,0,1,0,1,0,2
64115,2767,0,0,62,62,0,1,0,1,0,1
55224,53,5980,53,209,110,99,2,30,1,1,0
48071,25174,0,0,62,62,0,1,0,1,0,1
24301,6881,0,0,146,146,0,1,0,1,0,1
18415,37965,0,0,62,62,0,1,0,1,0,1
56490,80,11731,80,43084,3056,40028,60,135,27,33,0
43570,53,0,0,86,86,0,1,30,1,0,0
63086,53,16338,53,512,166,346,2,30,1,1,0
57511,123,47594,123,184,94,90,2,29,1,1,0
59732,445,0,0,70,70,0,1,0,1,0,2
56674,80,12315,80,156,156,0,3,8,3,0,0
3478,61463,0,0,164,164,0,1,0,1,0,1
64343,53,64343,53,216,98,118,2,30,1,1,0
56322,53,2088,53,209,110,99,2,30,1,1,0
50102,53,50102,53,216,90,126,2,29,1,1,0
46415,443,41654,443,9307,2265,7042,31,325,13,18,0
45540,8100,64668,8100,78,78,0,1,4,1,0,0
50789,445,0,0,70,70,0,1,0,1,0,2
55955,53,59392,53,164,86,78,2,30,1,1,0
55689,443,55689,443,177498,9805,167693,244,80,119,125,0
56789,445,0,0,70,70,0,1,0,1,0,2
50008,445,0,0,70,70,0,1,0,1,0,2
6289,44847,0,0,66,66,0,1,0,1,0,1
60720,445,0,0,70,70,0,1,0,1,0,2
58174,443,55907,443,11141,2777,8364,33,58,14,19,0
57470,29500,37295,29500,2772,2772,0,43,2311,43,0,0
63081,53,24594,53,304,86,218,2,30,1,1,0
62338,443,61578,443,13396186,148566,13247620,10474,59,1498,8976,0
49631,53,0,0,82,82,0,1,30,1,0,0
38160,443,10215,443,8185,2274,5911,18,135,8,10,0
55286,37965,0,0,66,66,0,1,0,1,0,1
80,13987,0,0,66,66,0,1,0,1,0,1
1558,80,1558,80,6377,703,5674,13,15,6,7,0
34400,39004,0,0,74,74,0,1,0,1,0,1
49862,53,52956,53,715,94,621,2,31,1,1,0
50770,443,41782,443,6350,1369,4981,18,151,9,9,0
80,53945,0,0,60,60,0,1,0,1,0,1
57069,443,33403,443,15125,2482,12643,53,38,27,26,0
59987,445,0,0,70,70,0,1,0,1,0,2
56614,445,0,0,70,70,0,1,0,1,0,2
55678,32468,0,0,66,66,0,1,0,1,0,1
63975,24874,47562,24874,70,70,0,1,5,1,0,0
46230,53,46230,53,257,101,156,2,33,1,1,0
53479,445,0,0,66,66,0,1,0,1,0,2
51993,80,56681,80,482,300,182,9,25,6,3,0
54828,53,54828,53,404,259,145,3,33,2,1,0
49292,443,18411,443,80199,66182,14017,134,163,87,47,0
54294,445,0,0,66,66,0,1,0,1,0,2
51106,445,0,0,66,66,0,1,0,1,0,2
64839,53,19060,53,208,106,102,2,31,1,1,0
64281,53,18314,53,212,108,104,2,30,1,1,0
56441,53,4935,53,209,110,99,2,29,1,1,0
25497,44847,0,0,146,146,0,1,0,1,0,1
56823,50291,65479,50291,316,136,180,6,6,3,3,0
50393,8080,50393,8080,378,180,198,7,31,4,3,0
26504,443,26504,443,1251,722,529,11,147,6,5,0
53239,443,22787,443,982624,22331,960293,976,137,293,683,0
57164,445,0,0,70,70,0,1,0,1,0,2
61420,64097,0,0,62,62,0,1,0,1,0,1
60946,445,0,0,70,70,0,1,0,1,0,2
51693,22114,0,0,62,62,0,1,0,1,0,1
56008,53,22150,53,230,86,144,2,30,1,1,0
54167,50584,0,0,66,66,0,1,0,1,0,1
53595,445,0,0,70,70,0,1,0,1,0,2
21145,11392,0,0,62,62,0,1,0,1,0,1
57596,80,43063,80,1231,726,505,10,18,6,4,0
62089,8604,0,0,66,66,0,1,0,1,0,1
57431,80,59179,80,11357,5000,6357,22,30,11,11,0
65386,53,35268,53,197,102,95,2,33,1,1,0
56186,57470,0,0,62,62,0,1,0,1,0,1
60224,443,54670,443,9079,3570,5509,68,152,34,34,0
49418,33058,55897,33058,244,78,166,2,30,1,1,0
56968,80,38598,80,2273,1511,762,7,29,4,3,0
1024,48817,0,0,148,148,0,1,0,1,0,1
44911,443,42749,443,10194,2176,8018,25,186,14,11,0
52425,443,26865,443,6527,1142,5385,23,32,13,10,0
55877,47528,12404,47528,491,150,341,2,1200,1,1,0
22714,30188,0,0,62,62,0,1,0,1,0,1
56937,8200,52360,8200,78,78,0,1,30,1,0,0
65028,53,59262,53,183,94,89,2,31,1,1,0
49408,443,34465,443,7967,2176,5791,27,125,14,13,0
49288,443,9666,443,7846,2369,5477,23,385,10,13,0
36146,443,42647,443,2514,1249,1265,19,76,9,10,0
48017,443,12876,443,198,78,120,4,6,2,2,0
50494,80,52508,80,18059,13615,4444,29,27,16,13,0
49696,53,54642,53,172,88,84,2,30,1,1,0
49488,53,56220,53,194,102,92,2,31,1,1,0
51518,443,51518,443,15967,3046,12921,39,173,15,24,0
37653,5223,53311,5223,70,70,0,1,5,1,0,0
50626,80,27963,80,1366,865,501,8,15,5,3,0
56924,26467,0,0,62,62,0,1,0,1,0,1
42981,44847,0,0,62,62,0,1,0,1,0,1
59596,3389,59596,3389,3523,1714,1809,17,34,8,9,0
57550,445,0,0,70,70,0,1,0,1,0,2
58638,5900,0,0,62,62,0,1,0,1,0,1
65355,443,1822,443,3563945,186679,3377266,4424,723,1877,2547,0
65444,53,15259,53,86,86,0,1,30,1,0,0
42119,36237,0,0,66,66,0,1,0,1,0,1
65196,445,0,0,66,66,0,1,0,1,0,2
65277,53,2071,53,775,102,673,2,30,1,1,0
65501,53,16521,53,443,182,261,6,29,3,3,0
9100,443,50468,443,4945,431,4514,12,15,6,6,0
55151,53,16947,53,285,102,183,2,30,1,1,0
50265,53606,10997,53606,528,528,0,9,1200,9,0,0
50511,445,0,0,70,70,0,1,0,1,0,2
56100,53,9631,53,177,94,83,2,30,1,1,0
46741,53,52840,53,221,75,146,2,30,1,1,0
64762,53,23924,53,200,94,106,2,30,1,1,0
57452,443,52384,443,6990,2193,4797,15,120,7,8,0
55717,13517,54958,13517,70,70,0,1,5,1,0,0
58638,5900,0,0,62,62,0,1,0,1,0,1
59381,53,57847,53,189,78,111,2,30,1,1,0
65278,53,45335,53,264,110,154,2,30,1,1,0
41167,443,51918,443,8869,1938,6931,21,17,12,9,0
62736,80,60766,80,1516,481,1035,11,15,6,5,0
59991,445,0,0,66,66,0,1,0,1,0,2
60995,443,4422,443,1351,846,505,12,19,7,5,0
40786,53,0,0,82,82,0,1,30,1,0,0
49768,53,39040,53,459,103,356,4,43,2,2,0
50273,53,27219,53,718,94,624,2,30,1,1,0
63951,55255,6079,55255,1277,856,421,9,15,6,3,0
61504,443,15507,443,16708,2331,14377,31,21,14,17,0
56314,53,50014,53,183,94,89,2,30,1,1,0
65329,53,20205,53,278,102,176,2,29,1,1,0
50986,80,14169,80,8074,2261,5813,22,19,13,9,0
53454,443,37572,443,10416,3195,7221,32,46,18,14,0
53765,443,24226,443,16482,9312,7170,39,141,19,20,0
55524,46232,0,0,66,66,0,1,0,1,0,1
54563,445,0,0,70,70,0,1,0,1,0,2
18357,51180,0,0,62,62,0,1,0,1,0,1
55174,445,0,0,66,66,0,1,0,1,0,2
64747,445,0,0,70,70,0,1,0,1,0,2
53670,445,0,0,70,70,0,1,0,1,0,2
9687,57470,0,0,78,78,0,1,0,1,0,1
38000,49152,22175,49152,156,156,0,3,8,3,0,0
59618,46824,0,0,66,66,0,1,0,1,0,1
51197,30188,0,0,66,66,0,1,0,1,0,1
55347,443,36174,443,3811,2320,1491,33,735,18,15,0
57108,53,37838,53,193,102,91,2,30,1,1,0
11478,51221,0,0,66,66,0,1,0,1,0,1
49959,80,5453,80,9763,749,9014,17,15,8,9,0
56569,53,23106,53,182,93,89,2,31,1,1,0
61530,445,0,0,70,70,0,1,0,1,0,2
443,64347,0,0,131,131,0,1,0,1,0,1
50311,80,32414,80,366,180,186,7,57,4,3,0
51717,63436,12791,63436,70,70,0,2,8,2,0,0
64904,53,1451,53,211,102,109,2,30,1,1,0
53227,64097,0,0,66,66,0,1,0,1,0,1
46670,51505,0,0,62,62,0,1,0,1,0,1
56783,53,24430,53,199,102,97,2,31,1,1,0
57444,53,13400,53,198,94,104,2,29,1,1,0
65352,445,0,0,66,66,0,1,0,1,0,2
61478,445,0,0,70,70,0,1,0,1,0,2
13907,57470,0,0,66,66,0,1,0,1,0,1
57588,53,31636,53,165,78,87,2,30,1,1,0
49898,443,53027,443,44110,4769,39341,90,108,46,44,0
61896,34021,0,0,66,66,0,1,91,1,0,0
59864,445,0,0,70,70,0,1,0,1,0,2
42151,53,3505,53,168,78,90,2,30,1,1,0
53195,443,48069,443,1462,965,497,13,18,7,6,0
50265,25490,26928,25490,1766,1332,434,22,1200,15,7,0
50040,445,0,0,70,70,0,1,0,1,0,2
1114,37965,0,0,62,62,0,1,0,1,0,1
59535,445,0,0,70,70,0,1,0,1,0,2
51567,445,0,0,70,70,0,1,0,1,0,2
62294,445,0,0,70,70,0,1,0,1,0,2
53182,443,48630,443,6094,1073,5021,19,15,10,9,0
60591,53,64106,53,78,78,0,1,29,1,0,0
60976,22114,0,0,66,66,0,1,0,1,0,1
53936,443,5510,443,886,70,816,14,166,2,12,0
56492,53,12334,53,184,94,90,2,29,1,1,0
51820,53738,51101,53738,66,66,0,2,8,2,0,0
53629,445,0,0,70,70,0,1,0,1,0,2
58638,5900,0,0,62,62,0,1,0,1,0,1
52399,445,0,0,66,66,0,1,0,1,0,2
55893,45711,0,0,78,78,0,1,0,1,0,1
58486,57470,0,0,66,66,0,1,0,1,0,1
56450,443,16622,443,1786,172,1614,7,120,3,4,0
49356,443,28911,443,5946,1254,4692,20,33,10,10,0
57371,53,9888,53,755,93,662,2,31,1,1,0
57577,443,27380,443,39421,4980,34441,57,144,23,34,0
64192,53,23253,53,308,110,198,2,29,1,1,0
55763,8060,49115,8060,70,70,0,2,7,2,0,0
8907,443,50464,443,7594,1457,6137,26,404,10,16,0
56183,445,0,0,70,70,0,1,0,1,0,2
52974,445,0,0,70,70,0,1,0,1,0,2
55130,53,9076,53,216,110,106,2,31,1,1,0
40742,2967,0,0,62,62,0,1,0,1,0,1
54434,445,0,0,70,70,0,1,0,1,0,2
50422,53,50422,53,194,87,107,2,30,1,1,0
55427,53,31506,53,200,102,98,2,30,1,1,0
15235,36237,0,0,62,62,0,1,0,1,0,1
48015,443,20608,443,138,78,60,2,4,1,1,0
50940,443,27136,443,29500,27698,1802,51,17,29,22,0
53779,51505,0,0,66,66,0,1,0,1,0,1
63771,445,0,0,70,70,0,1,0,1,0,2
38320,51505,0,0,66,66,0,1,0,1,0,1
49533,445,0,0,70,70,0,1,0,1,0,2
55400,445,0,0,66,66,0,1,0,1,0,2
39009,443,34628,443,12197,2338,9859,34,122,14,20,0
64128,53,26433,53,193,102,91,2,30,1,1,0
55595,445,0,0,70,70,0,1,0,1,0,2
41508,53,41508,53,244,98,146,2,32,1,1,0
57731,443,57731,443,5508,2261,3247,22,38,13,9,0
42298,40022,27294,40022,156,94,62,2,30,1,1,0
52386,445,0,0,70,70,0,1,0,1,0,2
51100,80,29611,80,12300,4454,7846,26,30,13,13,0
56787,443,11653,443,5639,846,4793,18,27,10,8,0
56660,445,0,0,66,66,0,1,0,1,0,2
43220,5222,35739,5222,5415,2041,3374,53,467,23,30,0
43632,80,17222,80,2000,710,1290,8,15,5,3,0
49406,53,22949,53,215,102,113,2,30,1,1,0
60389,80,65223,80,2499,531,1968,11,125,6,5,0
55586,17332,63048,17332,70,70,0,2,8,2,0,0
56667,53,25410,53,250,86,164,4,29,2,2,0
57170,38303,0,0,66,66,0,1,0,1,0,1
56409,53,61903,53,199,102,97,2,31,1,1,0
49671,53,37210,53,182,93,89,2,31,1,1,0
56177,443,61837,443,6826,5299,1527,22,330,12,10,0
443,14591,0,0,131,131,0,1,0,1,0,1
57287,53,47799,53,305,102,203,2,29,1,1,0
65009,53,56985,53,737,94,643,2,30,1,1,0
50876,80,52453,80,121344,7345,113999,144,141,61,83,0
52861,445,0,0,70,70,0,1,0,1,0,2
47132,1433,0,0,60,60,0,1,0,1,0,1
58043,80,57225,80,378,192,186,7,20,4,3,0
49676,53,32954,53,197,102,95,2,30,1,1,0
52298,445,0,0,66,66,0,1,0,1,0,2
52158,3841,53385,3841,70,70,0,1,5,1,0,0
60750,42707,0,0,62,62,0,1,0,1,0,1
55227,53,15557,53,183,102,81,2,31,1,1,0
50211,445,0,0,70,70,0,1,0,1,0,2
50603,445,0,0,66,66,0,1,0,1,0,2
60399,123,27117,123,184,94,90,2,30,1,1,0
63578,5228,10061,5228,8544,2633,5911,51,154,28,23,0
64534,445,0,0,66,66,0,1,0,1,0,2
44792,80,52125,80,1295,781,514,12,16,6,6,0
49687,53,13204,53,197,102,95,2,31,1,1,0
49480,443,58193,443,1160,638,522,13,113,7,6,0
57090,51505,0,0,62,62,0,1,0,1,0,1
54522,443,63026,443,4728282,133897,4594385,4756,80,1650,3106,0
55866,443,45291,443,53845,7300,46545,80,31,38,42,0
58636,445,0,0,70,70,0,1,0,1,0,2
50353,443,15424,443,1775,169,1606,7,121,3,4,0
63176,445,0,0,66,66,0,1,0,1,0,2
54769,50584,0,0,62,62,0,1,0,1,0,1
46046,443,33761,443,11019,4673,6346,32,423,17,15,0
65395,53,34335,53,754,94,660,2,30,1,1,0
64122,445,0,0,70,70,0,1,0,1,0,2
51427,445,0,0,70,70,0,1,0,1,0,2
53723,51501,50854,51501,70,70,0,2,7,2,0,0
26882,443,64713,443,10633,2672,7961,31,20,16,15,0
39762,123,46956,123,184,94,90,2,30,1,1,0
62673,34159,0,0,66,66,0,1,0,1,0,1
54849,445,0,0,70,70,0,1,0,1,0,2
56330,445,0,0,70,70,0,1,0,1,0,2
56717,443,27833,443,8006,1986,6020,20,15,11,9,0
49534,53,11716,53,193,102,91,2,31,1,1,0
63282,445,0,0,70,70,0,1,0,1,0,2
64913,53,23262,53,194,102,92,2,29,1,1,0
62729,51558,61898,51558,70,70,0,1,4,1,0,0
65355,53,46648,53,592,105,487,4,50,2,2,0
55488,445,0,0,70,70,0,1,0,1,0,2
37664,443,11325,443,3338,2337,1001,18,45,11,7,0
52998,443,44367,443,22480,2705,19775,49,109,22,27,0
49365,445,0,0,70,70,0,1,0,1,0,2
27005,1304,58771,1304,859,126,733,2,29,1,1,0
57491,445,0,0,66,66,0,1,0,1,0,2
61288,445,0,0,70,70,0,1,0,1,0,2
49234,53,17767,53,167,86,81,2,30,1,1,0
49276,51505,0,0,66,66,0,1,0,1,0,1
41803,443,1948,443,11804,4009,7795,41,150,21,20,0
39531,19473,0,0,62,62,0,1,0,1,0,1
53220,445,0,0,70,70,0,1,0,1,0,2
64924,53,49056,53,292,126,166,2,30,1,1,0
28824,44847,0,0,66,66,0,1,0,1,0,1
64694,53,58763,53,361,107,254,4,37,2,2,0
64874,445,0,0,70,70,0,1,0,1,0,2
51558,37965,0,0,72,72,0,1,0,1,0,1
54106,80,38158,80,78,78,0,1,5,1,0,0
62150,445,0,0,70,70,0,1,0,1,0,2
49865,443,1213,443,8535,1936,6599,22,87,12,10,0
59403,445,0,0,66,66,0,1,0,1,0,2
56576,9000,0,0,60,60,0,1,0,1,0,1
56206,445,0,0,70,70,0,1,0,1,0,2
64561,53,17308,53,461,91,370,4,60,2,2,0
56756,13973,64423,13973,70,70,0,1,5,1,0,0
40834,50584,0,0,62,62,0,1,0,1,0,1
50824,80,46115,80,36051,11695,24356,109,265,55,54,0
39839,22114,0,0,146,146,0,1,0,1,0,1
58638,5900,0,0,62,62,0,1,0,1,0,1
3377,50584,0,0,66,66,0,1,0,1,0,1
64251,53,6102,53,177,94,83,2,30,1,1,0
60466,445,0,0,66,66,0,1,0,1,0,2
51978,80,13488,80,24474,2101,22373,38,48,19,19,0
60716,443,33650,443,6898,2843,4055,21,17,11,10,0
62767,57470,0,0,74,74,0,1,0,1,0,1
62999,445,0,0,66,66,0,1,0,1,0,2
58949,445,0,0,66,66,0,1,0,1,0,2
50739,445,0,0,66,66,0,1,0,1,0,2
53815,443,57260,443,499,425,74,4,0,3,1,0
4781,443,51838,443,1191,692,499,12,40,7,5,0
55642,445,0,0,70,70,0,1,0,1,0,2
55836,443,16714,443,3538,2015,1523,28,323,14,14,0
36690,443,36517,443,1520,1058,462,12,29,8,4,0
1024,29892,0,0,145,145,0,1,0,1,0,1
60075,41705,0,0,66,66,0,1,0,1,0,1
65184,53,13116,53,166,86,80,2,30,1,1,0
62535,445,0,0,70,70,0,1,0,1,0,2
61550,5529,0,0,145,145,0,1,0,1,0,1
50355,445,0,0,70,70,0,1,0,1,0,2
53779,51505,0,0,66,66,0,1,0,1,0,1
53268,80,36603,80,2960,1928,1032,13,75,8,5,0
56711,53,25495,53,209,110,99,2,30,1,1,0
50455,445,0,0,70,70,0,1,0,1,0,2
2932,44847,0,0,62,62,0,1,0,1,0,1
52322,53,58058,53,86,86,0,1,30,1,0,0
64724,53,50975,53,195,102,93,2,31,1,1,0
56812,53,46886,53,767,102,665,2,30,1,1,0
57870,443,40542,443,1373,734,639,17,125,10,7,0
49710,443,63933,443,7691,1797,5894,22,137,12,10,0
65131,53,4831,53,168,86,82,2,30,1,1,0
53134,42369,45499,42369,70,70,0,2,8,2,0,0
64180,445,0,0,70,70,0,1,0,1,0,2
56796,443,60351,443,8074,2054,6020,20,15,11,9,0
64172,445,0,0,70,70,0,1,0,1,0,2
40877,443,50860,443,6451,1003,5448,21,360,11,10,0
28509,80,28509,80,10145,1446,8699,23,29,11,12,0
44929,443,44929,443,5469,2222,3247,22,38,13,9,0
49275,53,55214,53,283,97,186,4,30,2,2,0
49242,22114,0,0,62,62,0,1,0,1,0,1
51098,443,32791,443,7250,2813,4437,21,62,12,9,0
34531,443,54332,443,135231,5033,130198,149,216,55,94,0
34779,443,25876,443,34914,5279,29635,47,543,18,29,0
50095,53,10662,53,168,86,82,2,30,1,1,0
64726,53,58493,53,352,94,258,2,30,1,1,0
40192,443,40192,443,11928,3226,8702,23,160,11,12,0
49225,8080,49225,8080,43790,20134,23656,73,400,45,28,0
50677,80,32544,80,3664,1440,2224,12,20,6,6,0
64997,53,31899,53,166,86,80,2,30,1,1,0
54962,53,15807,53,194,102,92,2,30,1,1,0
62927,445,0,0,70,70,0,1,0,1,0,2
3818,37965,0,0,66,66,0,1,0,1,0,1
53283,443,51039,443,3369,1036,2333,11,121,5,6,0
55290,445,0,0,66,66,0,1,0,1,0,2
57122,53,5518,53,295,101,194,4,31,2,2,0
50646,80,29942,80,1328,917,411,10,25,6,4,0
50299,445,0,0,70,70,0,1,0,1,0,2
49672,443,34216,443,10080,2728,7352,28,188,14,14,0
10552,25174,0,0,62,62,0,1,0,1,0,1
59605,445,0,0,66,66,0,1,0,1,0,2
61670,57470,0,0,74,74,0,1,0,1,0,1
64092,443,64092,443,5643,2397,3246,26,159,14,12,0
56869,17637,0,0,66,66,0,1,0,1,0,1
5151,50584,0,0,62,62,0,1,0,1,0,1
51946,445,0,0,70,70,0,1,0,1,0,2
56572,53,22035,53,177,94,83,2,29,1,1,0
49177,443,40595,443,840,700,140,13,59,11,2,0
65229,53,50750,53,193,102,91,2,31,1,1,0
32346,53,32346,53,194,87,107,2,30,1,1,0
55752,53,44697,53,200,102,98,2,30,1,1,0
64299,53,26079,53,268,84,184,4,42,2,2,0
61279,443,45971,443,4076,1378,2698,14,136,7,7,0
56385,53,50019,53,249,85,164,4,56,2,2,0
54902,80,36045,80,1107,630,477,10,16,6,4,0
51738,7000,51738,7000,3550,1983,1567,15,16,8,7,0
55854,54369,0,0,74,74,0,1,0,1,0,1
61476,443,42404,443,230640,12863,217777,253,62,98,155,0
52273,445,0,0,66,66,0,1,0,1,0,2
50780,445,0,0,70,70,0,1,0,1,0,2
2332,35440,0,0,66,66,0,1,0,1,0,1
26752,64147,0,0,62,62,0,1,0,1,0,1
65206,53,9006,53,762,98,664,2,30,1,1,0
51594,53,51594,53,219,92,127,2,30,1,1,0
33059,58962,0,0,774,774,0,1,0,1,0,1
49482,22,0,0,60,60,0,1,0,1,0,1
60765,445,0,0,66,66,0,1,0,1,0,2
50460,445,0,0,70,70,0,1,0,1,0,2
6247,51221,0,0,78,78,0,1,0,1,0,1
48815,22114,0,0,146,146,0,1,0,1,0,1
61332,23,0,0,60,60,0,1,0,1,0,1
3996,57470,0,0,62,62,0,1,0,1,0,1
59399,445,0,0,66,66,0,1,0,1,0,2
65292,445,0,0,66,66,0,1,0,1,0,2
59570,443,54074,443,6713,3052,3661,49,5974,15,34,0
58778,443,47598,443,5168,700,4468,16,15,7,9,0
58638,5900,0,0,62,62,0,1,0,1,0,1
49254,53,55219,53,265,110,155,2,30,1,1,0
64403,53,33316,53,193,102,91,2,30,1,1,0
62424,445,0,0,66,66,0,1,0,1,0,2
58932,53,21682,53,168,78,90,2,31,1,1,0
58114,445,0,0,66,66,0,1,0,1,0,2
58874,443,22621,443,4738,1023,3715,18,66,10,8,0
56912,53,5094,53,199,102,97,2,29,1,1,0
63672,445,0,0,70,70,0,1,0,1,0,2
55799,445,0,0,70,70,0,1,0,1,0,2
51634,443,38565,443,3174,346,2828,12,121,5,7,0
4545,1900,0,0,136,136,0,1,0,1,0,1
50875,53,15135,53,234,234,0,4,47,4,0,0
49657,443,35292,443,2800,1557,1243,33,53,19,14,0
19983,18242,0,0,146,146,0,1,0,1,0,3
57131,26296,0,0,145,145,0,1,0,1,0,1
55604,44235,60786,44235,504,318,186,8,15,5,3,0
50601,53,58017,53,760,97,663,2,30,1,1,0
55744,80,6834,80,5146,3694,1452,20,249,10,10,0
28668,8696,0,0,60,60,0,1,0,1,0,1
35760,11392,0,0,146,146,0,1,0,1,0,1
51580,80,9107,80,1752,786,966,16,17,9,7,0
50267,53,48112,53,734,94,640,2,31,1,1,0
53624,53,53624,53,832,106,726,2,29,1,1,0
62739,21416,0,0,145,145,0,1,0,1,0,1
52110,35411,30183,35411,66,66,0,1,5,1,0,0
64020,53,44407,53,192,98,94,2,31,1,1,0
50470,61463,0,0,86,86,0,1,0,1,0,1
57802,80,24943,80,2762,2628,134,8,17,6,2,0
65360,53,6269,53,763,102,661,2,30,1,1,0
55958,53,30538,53,275,86,189,2,29,1,1,0
49900,445,0,0,70,70,0,1,0,1,0,2
27005,32063,51455,32063,889,126,763,3,31,2,1,0
6037,43890,0,0,70,70,0,1,0,1,0,1
64306,64147,0,0,62,62,0,1,0,1,0,1
50899,80,62536,80,13974043,173337,13800706,11715,134,2429,9286,0
61619,445,0,0,70,70,0,1,0,1,0,2
51721,35426,42015,35426,70,70,0,2,8,2,0,0
61141,445,0,0,70,70,0,1,0,1,0,2
56458,53,9119,53,196,102,94,2,31,1,1,0
56502,443,5913,443,5414,1010,4404,17,33,9,8,0
26048,21,0,0,60,60,0,1,0,1,0,1
56423,443,49453,443,6294,1494,4800,22,17,11,11,0
51792,445,0,0,70,70,0,1,0,1,0,2
54410,445,0,0,66,66,0,1,0,1,0,2
40967,443,61086,443,1786,172,1614,7,121,3,4,0
52944,23,0,0,60,60,0,1,0,1,0,1
52374,445,0,0,70,70,0,1,0,1,0,2
58993,443,16211,443,1437,736,701,15,28,7,8,0
49282,53,14515,53,178,94,84,2,30,1,1,0
32704,46824,0,0,66,66,0,1,0,1,0,1
51584,445,0,0,70,70,0,1,0,1,0,2
51083,445,0,0,70,70,0,1,0,1,0,2
50608,445,0,0,66,66,0,1,0,1,0,2
28004,443,21121,443,5517,1390,4127,18,15,9,9,0
50285,80,56429,80,4064,607,3457,12,45,6,6,0
62493,445,0,0,66,66,0,1,0,1,0,2
42574,53,42574,53,262,106,156,2,32,1,1,0
59843,443,50473,443,1427,726,701,17,46,8,9,0
7226,50584,0,0,146,146,0,1,0,1,0,1
64934,53,64886,53,197,102,95,2,30,1,1,0
49461,445,0,0,66,66,0,1,0,1,0,2
60243,445,0,0,70,70,0,1,0,1,0,2
45406,80,51652,80,573,499,74,6,15,5,1,0
60991,445,0,0,70,70,0,1,0,1,0,2
52345,445,0,0,66,66,0,1,0,1,0,2
49818,37965,0,0,62,62,0,1,0,1,0,1
63951,53,53032,53,345,106,239,4,38,2,2,0
61945,445,0,0,70,70,0,1,0,1,0,2
27005,33111,35417,33111,895,126,769,2,31,1,1,0
1026,30188,0,0,62,62,0,1,0,1,0,1
63587,443,60950,443,10576,3685,6891,46,92,24,22,0
55727,445,0,0,66,66,0,1,0,1,0,2
65089,53,28362,53,199,102,97,2,30,1,1,0
64923,25174,0,0,66,66,0,1,0,1,0,1
39718,443,11292,443,10186,3128,7058,26,16,13,13,0
63461,443,13278,443,622,310,312,11,59,6,5,0
51214,443,63195,443,7924,3247,4677,32,71,19,13,0
49422,53,52820,53,719,208,511,6,32,3,3,0
45682,37965,0,0,62,62,0,1,0,1,0,1
60897,443,29377,443,10706,1679,9027,27,46,15,12,0
50480,443,52040,443,14848,6716,8132,32,30,17,15,0
51242,80,19033,80,3506,2280,1226,24,50,13,11,0
57083,53,56856,53,755,94,661,2,31,1,1,0
44378,995,0,0,60,60,0,1,0,1,0,1
56412,445,0,0,70,70,0,1,0,1,0,2
55917,53,22277,53,177,94,83,2,30,1,1,0
52526,30188,0,0,62,62,0,1,0,1,0,1
60281,445,0,0,70,70,0,1,0,1,0,2
61730,25320,0,0,62,62,0,1,0,1,0,1
64561,53,6022,53,209,110,99,2,30,1,1,0
27005,32038,39933,32038,868,126,742,2,30,1,1,0
57275,53,14863,53,177,94,83,2,30,1,1,0
64374,53,21299,53,194,94,100,2,30,1,1,0
17289,25174,0,0,146,146,0,1,0,1,0,1
32395,30188,0,0,62,62,0,1,0,1,0,1
5235,34592,6891,34592,247495,256,247239,361,49,5,356,0
64502,53,7896,53,374,101,273,4,42,2,2,0
65067,53,28760,53,86,86,0,1,30,1,0,0
49654,53,5508,53,184,94,90,2,30,1,1,0
61722,445,0,0,70,70,0,1,0,1,0,2
59096,57866,0,0,62,62,0,1,0,1,0,1
49776,53,43757,53,182,94,88,2,29,1,1,0
34100,443,31456,443,2044,1024,1020,17,80,9,8,0
57021,445,0,0,70,70,0,1,0,1,0,2
33563,14037,0,0,78,78,0,1,0,1,0,1
54642,445,0,0,70,70,0,1,0,1,0,2
64685,53,12212,53,534,193,341,6,78,3,3,0
27005,27015,9469,27015,887,126,761,2,30,1,1,0
50584,6889,32589,6889,311,311,0,3,1200,3,0,0
39154,80,25294,80,1504,926,578,15,36,9,6,0
55976,53,37566,53,758,96,662,2,31,1,1,0
49272,53,30273,53,168,86,82,2,31,1,1,0
52931,443,32527,443,23112,6278,16834,140,115,55,85,0
45186,443,63714,443,5959,169,5790,10,121,3,7,0
17270,44847,0,0,146,146,0,1,0,1,0,1
59592,37965,0,0,62,62,0,1,0,1,0,1
54020,443,45905,443,17529,8138,9391,39,31,17,22,0
54538,445,0,0,70,70,0,1,0,1,0,2
56643,445,0,0,66,66,0,1,0,1,0,2
2064,22114,0,0,146,146,0,1,0,1,0,1
55467,53,6293,53,320,95,225,4,41,2,2,0
9017,6881,0,0,62,62,0,1,0,1,0,1
58327,445,0,0,70,70,0,1,0,1,0,2
25010,30188,0,0,62,62,0,1,0,1,0,1
58638,5900,0,0,62,62,0,1,0,1,0,1
53677,10657,26875,10657,70,70,0,2,8,2,0,0
56722,80,63327,80,41658,23230,18428,114,798,66,48,0
51110,80,32972,80,23850,1662,22188,36,15,19,17,0
31112,50584,0,0,62,62,0,1,0,1,0,1
55101,443,55990,443,1786,172,1614,7,120,3,4,0
30129,37965,0,0,72,72,0,1,0,1,0,1
62900,993,6178,993,12900,4980,7920,91,117,51,40,0
55072,53,38583,53,86,86,0,1,30,1,0,0
56946,443,38559,443,10408,4790,5618,34,322,16,18,0
49860,443,20445,443,10754,2778,7976,38,59,19,19,0
2995,26467,0,0,62,62,0,1,0,1,0,1
40204,40027,54251,40027,245,182,63,2,30,1,1,0
61955,445,0,0,70,70,0,1,0,1,0,2
52223,11979,45106,11979,70,70,0,1,5,1,0,0
49972,53,23300,53,184,94,90,2,30,1,1,0
33761,25174,0,0,62,62,0,1,0,1,0,1
60883,445,0,0,70,70,0,1,0,1,0,2
50755,80,64278,80,1783,1346,437,7,15,5,2,0
65176,53,2902,53,186,95,91,2,30,1,1,0
53825,443,49613,443,499,425,74,4,0,3,1,0
55375,53,47639,53,214,110,104,2,30,1,1,0
55377,53,45027,53,195,102,93,2,30,1,1,0
56326,53,18129,53,177,94,83,2,29,1,1,0
54236,36829,0,0,66,66,0,1,0,1,0,1
46857,443,55410,443,280,140,140,5,129,3,2,0
55999,53,41388,53,774,101,673,2,30,1,1,0
50052,65008,0,0,60,60,0,1,0,1,0,1
56419,80,4193,80,34098,808,33290,34,104,9,25,0
37555,16386,23177,16386,130,70,60,2,30,1,1,0
65427,53,25865,53,677,188,489,6,57,3,3,0
44388,63874,0,0,62,62,0,1,0,1,0,1
55452,53,7661,53,184,94,90,2,30,1,1,0
57683,53,53315,53,243,94,149,2,30,1,1,0
55741,445,0,0,66,66,0,1,0,1,0,2
51881,445,0,0,66,66,0,1,0,1,0,2
53121,443,1605,443,10893,7149,3744,31,45,18,13,0
64406,53,8536,53,102,102,0,2,31,2,0,0
45964,2666,0,0,60,60,0,1,0,1,0,1
55771,53,21538,53,283,98,185,4,52,2,2,0
51754,7000,51754,7000,4727,2346,2381,19,16,12,7,0
58731,443,5711,443,2383,1460,923,18,201,10,8,0
45641,443,12763,443,99276,88410,10866,143,333,78,65,0
34500,23,0,0,60,60,0,1,0,1,0,1
52584,445,0,0,70,70,0,1,0,1,0,2
53692,44512,0,0,66,66,0,1,0,1,0,1
56456,445,0,0,70,70,0,1,0,1,0,2
9185,80,20640,80,17855,1067,16788,26,35,11,15,0
58070,443,16488,443,5041,2002,3039,14,120,7,7,0
58080,443,57943,443,646,358,288,10,133,6,4,0
58933,80,48784,80,2055,1651,404,8,76,5,3,0
51063,445,0,0,66,66,0,1,0,1,0,2
62934,445,0,0,70,70,0,1,0,1,0,2
57670,445,0,0,66,66,0,1,0,1,0,2
55085,443,57915,443,5803,4960,843,19,124,11,8,0
52176,17572,9912,17572,70,70,0,1,5,1,0,0
50423,80,33009,80,23470,2457,21013,31,22,13,18,0
57570,443,58853,443,6226,4213,2013,30,79,18,12,0
51115,80,32483,80,1426,930,496,10,22,7,3,0
60851,443,17568,443,36974,3935,33039,56,61,27,29,0
443,29326,0,0,82,82,0,1,0,1,0,1
55796,53,36094,53,196,102,94,2,30,1,1,0
40709,443,57804,443,256802,11839,244963,329,173,136,193,0
50021,80,33696,80,10026538,185017,9841521,9515,195,2989,6526,0
9132,80,49560,80,318,192,126,6,30,4,2,0
52975,23718,0,0,66,66,0,1,0,1,0,1
50865,53,50865,53,242,98,144,2,30,1,1,0
56739,53,56739,53,825,99,726,2,30,1,1,0
65085,53,45076,53,258,102,156,2,30,1,1,0
52072,445,0,0,70,70,0,1,0,1,0,2
27005,27025,23287,27025,895,126,769,2,30,1,1,0
49580,443,38727,443,442,262,180,8,42,5,3,0
49418,27118,47467,27118,78,78,0,1,30,1,0,0
49667,53,65184,53,448,184,264,6,30,3,3,0
56142,53,42662,53,194,102,92,2,31,1,1,0
39252,53,39252,53,197,90,107,2,29,1,1,0
56672,53,28355,53,198,101,97,2,31,1,1,0
51996,35440,0,0,66,66,0,1,0,1,0,1
49892,443,33274,443,5737,1602,4135,23,86,13,10,0
63830,445,0,0,66,66,0,1,0,1,0,2
49710,53,37323,53,179,94,85,2,30,1,1,0
19473,14168,34740,14168,491,150,341,2,1200,1,1,0
56922,53,43765,53,86,86,0,1,30,1,0,0
56544,53,62437,53,760,97,663,2,31,1,1,0
27345,53,27345,53,398,255,143,3,33,2,1,0
57022,443,20898,443,4228,1470,2758,19,131,9,10,0
50237,53,53638,53,183,94,89,2,31,1,1,0
50684,443,36548,443,6909,2495,4414,20,15,11,9,0
50077,53,56181,53,261,97,164,4,44,2,2,0
60838,445,0,0,70,70,0,1,0,1,0,2
50505,445,0,0,70,70,0,1,0,1,0,2
61850,445,0,0,70,70,0,1,0,1,0,2
55684,53,8013,53,214,110,104,2,30,1,1,0
58315,445,0,0,66,66,0,1,0,1,0,2
17760,50584,0,0,62,62,0,1,0,1,0,1
13907,57470,0,0,62,62,0,1,0,1,0,1
9473,443,29099,443,6100,777,5323,17,26,9,8,0
57866,53,0,0,627,80,547,2,29,1,1,0
443,23133,0,0,97,97,0,1,0,1,0,1
60613,443,54092,443,154465,11473,142992,244,212,101,143,0
52858,445,0,0,70,70,0,1,0,1,0,2
55921,53,64539,53,177,94,83,2,29,1,1,0
56632,443,5495,443,7941,1952,5989,20,15,11,9,0
10436,53,10436,53,237,91,146,2,32,1,1,0
49451,53,64804,53,211,102,109,2,30,1,1,0
44516,443,57254,443,4709,2451,2258,18,304,8,10,0
56952,53,60759,53,193,102,91,2,30,1,1,0
62668,445,0,0,66,66,0,1,0,1,0,2
36369,51505,0,0,66,66,0,1,0,1,0,1
65046,53,1859,53,211,94,117,2,31,1,1,0
50611,443,62610,443,11152,2086,9066,33,93,17,16,0
28742,53,28742,53,365,233,132,3,32,2,1,0
53252,443,33448,443,41435,6615,34820,85,193,46,39,0
28364,23,0,0,60,60,0,1,0,1,0,1
49418,52013,5997,52013,257,71,186,2,30,1,1,0
64658,53,60447,53,195,102,93,2,29,1,1,0
49308,53,5550,53,195,94,101,2,29,1,1,0
61002,37965,0,0,145,145,0,1,0,1,0,1
6881,55981,51460,55981,228,118,110,2,1200,1,1,0
58703,443,1950,443,15202,6356,8846,40,119,22,18,0
62056,30317,0,0,146,146,0,1,0,1,0,1
52492,37965,0,0,66,66,0,1,0,1,0,1
64048,53,63585,53,326,92,234,4,31,2,2,0
55445,445,0,0,66,66,0,1,0,1,0,2
56909,443,38825,443,31860,21778,10082,84,190,42,42,0
6881,6881,0,0,62,62,0,1,0,1,0,1
51155,56205,0,0,62,62,0,1,0,1,0,1
62267,445,0,0,70,70,0,1,0,1,0,2
52695,26467,0,0,66,66,0,1,0,1,0,1
542,46783,0,0,62,62,0,1,0,1,0,1
59194,445,0,0,66,66,0,1,0,1,0,2
49625,53,64446,53,251,102,149,2,30,1,1,0
55273,53,3281,53,764,99,665,2,31,1,1,0
50591,445,0,0,70,70,0,1,0,1,0,2
52957,445,0,0,70,70,0,1,0,1,0,2
63530,3389,63530,3389,3489,1534,1955,17,19,9,8,0
53924,445,0,0,70,70,0,1,0,1,0,2
64716,53,5161,53,718,94,624,2,30,1,1,0
63139,53,8265,53,78,78,0,2,31,2,0,0
57470,49160,41673,49160,132,132,0,3,1199,3,0,0
54300,22114,0,0,62,62,0,1,0,1,0,1
10348,25604,0,0,62,62,0,1,0,1,0,1
56143,445,0,0,66,66,0,1,0,1,0,2
53921,18183,42637,18183,826,386,440,12,15,6,6,0
58638,5900,0,0,62,62,0,1,0,1,0,1
56962,53,51903,53,170,87,83,2,30,1,1,0
59645,53,23128,53,263,94,169,2,30,1,1,0
6666,50070,0,0,60,60,0,1,0,1,0,1
61163,445,0,0,66,66,0,1,0,1,0,2
57204,53,65520,53,195,102,93,2,30,1,1,0
54889,445,0,0,70,70,0,1,0,1,0,2
57199,445,0,0,70,70,0,1,0,1,0,2
54542,25604,0,0,66,66,0,1,0,1,0,1
54420,80,23681,80,1596,511,1085,10,15,5,5,0
51263,443,3091,443,8247,2116,6131,23,360,11,12,0
62044,443,20776,443,10530,2001,8529,29,47,14,15,0
42412,443,55628,443,204,70,134,4,26,2,2,0
62443,445,0,0,70,70,0,1,0,1,0,2
9528,44847,0,0,146,146,0,1,0,1,0,1
22350,25174,0,0,62,62,0,1,0,1,0,1
3765,64147,0,0,66,66,0,1,0,1,0,1
60442,49556,41273,49556,624,318,306,10,15,5,5,0
53800,445,0,0,70,70,0,1,0,1,0,2
51334,445,0,0,70,70,0,1,0,1,0,2
56975,80,23804,80,214,140,74,4,35,3,1,0
36053,443,36053,443,79562,17054,62508,111,109,54,57,0
56127,443,17365,443,6103,2710,3393,58,212,28,30,0
50807,443,17833,443,9328,1709,7619,18,139,8,10,0
56621,53,19745,53,177,94,83,2,30,1,1,0
50098,53,37375,53,199,102,97,2,30,1,1,0
443,62732,0,0,332,332,0,1,0,1,0,1
51042,445,0,0,66,66,0,1,0,1,0,2
26449,80,26449,80,642,338,304,10,33,6,4,0
63237,443,45268,443,1369,670,699,17,141,9,8,0
55286,37965,0,0,66,66,0,1,0,1,0,1
62242,44512,0,0,66,66,0,1,0,1,0,1
63194,445,0,0,70,70,0,1,0,1,0,2
49624,53,37843,53,216,94,122,2,30,1,1,0
55605,53,6586,53,195,102,93,2,30,1,1,0
9318,443,40235,443,3649,424,3225,12,15,6,6,0
64980,53,10354,53,200,102,98,2,29,1,1,0
58638,5900,0,0,62,62,0,1,0,1,0,1
63955,53,0,0,219,81,138,2,30,1,1,0
47817,443,11040,443,18158,2080,16078,34,122,19,15,0
57970,445,0,0,66,66,0,1,0,1,0,2
53469,36237,0,0,62,62,0,1,0,1,0,1
0,0,0,0,98,98,0,1,0,1,0,1
65403,445,0,0,66,66,0,1,0,1,0,2
57183,53,5484,53,199,94,105,2,29,1,1,0
56742,445,0,0,70,70,0,1,0,1,0,2
32928,443,19319,443,1527,940,587,14,90,8,6,0
55224,53,48169,53,182,94,88,2,30,1,1,0
57340,53,41414,53,711,87,624,2,30,1,1,0
64898,35993,0,0,74,74,0,1,0,1,0,1
65357,53,38110,53,194,102,92,2,29,1,1,0
53450,443,18001,443,5931,1750,4181,24,48,14,10,0
52165,49740,56721,49740,70,70,0,2,8,2,0,0
56928,53,56928,53,823,98,725,2,30,1,1,0
52327,443,53473,443,134,60,74,3,6,2,1,0
58821,445,0,0,70,70,0,1,0,1,0,2
58638,5900,0,0,62,62,0,1,0,1,0,1
56952,53,7156,53,186,95,91,2,30,1,1,0
23719,22114,0,0,146,146,0,1,0,1,0,1
53132,443,46008,443,6515,1516,4999,23,16,12,11,0
58309,53,16090,53,255,86,169,2,30,1,1,0
49981,44847,0,0,62,62,0,1,0,1,0,1
60477,445,0,0,70,70,0,1,0,1,0,2
42672,443,42672,443,4378,1471,2907,19,30,11,8,0
49849,53,18692,53,173,94,79,2,30,1,1,0
61091,443,61091,443,18924,5378,13546,33,18,19,14,0
7110,25174,0,0,66,66,0,1,0,1,0,1
50638,443,50638,443,4544,1637,2907,19,26,11,8,0
62489,23117,0,0,66,66,0,1,0,1,0,1
49684,445,0,0,66,66,0,1,0,1,0,2
28999,37807,0,0,62,62,0,1,0,1,0,1
13020,26467,0,0,66,66,0,1,0,1,0,1
49349,53,12679,53,405,110,295,4,38,2,2,0
61370,445,0,0,70,70,0,1,0,1,0,2
53324,44847,0,0,66,66,0,1,0,1,0,1
57470,20015,34460,20015,150,150,0,1,1199,1,0,0
58021,17,0,0,60,60,0,1,0,1,0,1
61838,443,61838,443,36811,5190,31621,60,150,24,36,0
50862,445,0,0,70,70,0,1,0,1,0,2
57143,53,17926,53,184,94,90,2,30,1,1,0
52397,445,0,0,70,70,0,1,0,1,0,2
4961,62741,0,0,66,66,0,1,0,1,0,1
62073,443,32648,443,9559,3243,6316,28,46,16,12,0
49874,53,37266,53,173,94,79,2,30,1,1,0
57188,53,44023,53,186,95,91,2,30,1,1,0
34028,443,47575,443,7804,1583,6221,26,981,13,13,0
57299,445,0,0,70,70,0,1,0,1,0,2
50502,123,1103,123,184,94,90,2,30,1,1,0
50106,31573,0,0,66,66,0,1,0,1,0,1
57996,53,57996,53,265,114,151,2,30,1,1,0
61800,445,0,0,66,66,0,1,0,1,0,2
49775,80,20586,80,1302,849,453,10,126,6,4,0
64985,53,10267,53,86,86,0,1,60,1,0,0
60291,445,0,0,70,70,0,1,0,1,0,2
53652,443,55573,443,11041,3217,7824,26,24,15,11,0
26263,8168,0,0,66,66,0,1,0,1,0,1
54849,445,0,0,70,70,0,1,0,1,0,2
65040,53,33364,53,178,94,84,2,30,1,1,0
55156,53,61392,53,188,96,92,2,30,1,1,0
58482,445,0,0,70,70,0,1,0,1,0,2
59477,36829,0,0,66,66,0,1,0,1,0,1
49873,80,19431,80,9540,2954,6586,18,88,8,10,0
53225,443,23994,443,6659,1215,5444,17,15,9,8,0
64798,53,14494,53,178,94,84,2,30,1,1,0
27064,51221,0,0,72,72,0,1,0,1,0,1
57762,445,0,0,66,66,0,1,0,1,0,2
64124,443,56676,443,1411,852,559,13,25,7,6,0
42555,443,40081,443,14262,5874,8388,31,138,15,16,0
49418,27015,25593,27015,258,78,180,2,30,1,1,0
38710,443,50238,443,89931,3417,86514,94,15,30,64,0
59587,25174,0,0,146,146,0,1,0,1,0,1
39207,80,48256,80,234,234,0,4,12,4,0,0
53645,445,0,0,66,66,0,1,0,1,0,2
56738,443,13897,443,7863,1874,5989,20,15,11,9,0
44256,3389,44256,3389,4145,1976,2169,22,18,13,9,0
50052,65008,0,0,60,60,0,1,0,1,0,1
64543,50265,0,0,66,66,0,1,0,1,0,1
49963,53,54838,53,279,96,183,4,59,2,2,0
63978,53,35845,53,214,110,104,2,30,1,1,0
61306,445,0,0,70,70,0,1,0,1,0,2
58678,445,0,0,70,70,0,1,0,1,0,2
49215,53,25508,53,214,102,112,2,30,1,1,0
58638,5900,0,0,62,62,0,1,0,1,0,1
51866,23431,28853,23431,70,70,0,1,5,1,0,0
43679,44847,0,0,62,62,0,1,0,1,0,1
59435,37807,0,0,62,62,0,1,0,1,0,1
52975,23718,0,0,62,62,0,1,0,1,0,1
37965,54777,17164,54777,158,158,0,1,1200,1,0,0
57150,53,64897,53,177,94,83,2,30,1,1,0
59945,80,11723,80,1197,419,778,9,16,5,4,0
50962,5900,0,0,60,60,0,1,0,1,0,1
50859,53,0,0,286,79,207,2,30,1,1,0
57227,445,0,0,70,70,0,1,0,1,0,2
16361,60888,0,0,146,146,0,1,0,1,0,1
10445,46824,0,0,62,62,0,1,0,1,0,1
52227,445,0,0,70,70,0,1,0,1,0,2
50574,80,28738,80,318,192,126,6,25,4,2,0
46936,35440,0,0,62,62,0,1,0,1,0,1
56480,53,53765,53,755,94,661,2,31,1,1,0
58120,25174,0,0,66,66,0,1,0,1,0,1
56737,443,49751,443,7915,1926,5989,20,16,11,9,0
49690,53,31414,53,216,110,106,2,30,1,1,0
56696,53,25639,53,757,98,659,2,31,1,1,0
41490,25174,0,0,62,62,0,1,0,1,0,1
60547,445,0,0,70,70,0,1,0,1,0,2
60383,445,0,0,66,66,0,1,0,1,0,2
65307,53,36094,53,811,94,717,2,29,1,1,0
65465,445,0,0,70,70,0,1,0,1,0,2
55761,445,0,0,70,70,0,1,0,1,0,2
45775,443,19122,443,8706,1430,7276,23,316,9,14,0
65228,53,0,0,88,88,0,1,0,1,0,1
50645,53,59508,53,177,94,83,2,30,1,1,0
55771,53,58272,53,283,98,185,4,51,2,2,0
63062,11392,0,0,62,62,0,1,0,1,0,1
58808,445,0,0,66,66,0,1,0,1,0,2
11136,19910,0,0,62,62,0,1,0,1,0,1
35775,443,51834,443,6665,3913,2752,33,98,19,14,0
56046,53,55070,53,193,102,91,2,31,1,1,0
30859,53,30859,53,213,79,134,2,32,1,1,0
37647,443,55661,443,697381,19797,677584,725,106,247,478,0
51722,445,0,0,70,70,0,1,0,1,0,2
7482,57470,0,0,66,66,0,1,0,1,0,1
50936,80,62610,80,10423067,111935,10311132,8558,119,1601,6957,0
60397,43129,42698,43129,70,70,0,1,5,1,0,0
57375,445,0,0,70,70,0,1,0,1,0,2
36932,443,8229,443,280,140,140,5,130,3,2,0
56498,80,33330,80,174021,11443,162578,197,63,81,116,0
29988,44847,0,0,66,66,0,1,0,1,0,1
53875,445,0,0,70,70,0,1,0,1,0,2
60097,22114,0,0,62,62,0,1,0,1,0,1
51995,50031,39289,50031,70,70,0,2,8,2,0,0
64416,53,56387,53,291,110,181,2,30,1,1,0
58334,5223,0,0,148,148,0,1,0,1,0,1
49534,53,33345,53,186,95,91,2,31,1,1,0
52540,443,62112,443,153,93,60,2,5,1,1,0
27153,50584,0,0,146,146,0,1,0,1,0,1
57777,445,0,0,70,70,0,1,0,1,0,2
62183,57470,0,0,74,74,0,1,0,1,0,1
49246,53,63715,53,286,102,184,2,31,1,1,0
65444,445,0,0,70,70,0,1,0,1,0,2
59787,445,0,0,66,66,0,1,0,1,0,2
56664,80,50394,80,234,234,0,4,11,4,0,0
17008,35440,0,0,146,146,0,1,0,1,0,1
48422,53,48422,53,229,89,140,2,30,1,1,0
62456,443,40302,443,8678,3253,5425,22,25,11,11,0
62724,443,47821,443,87797,47766,40031,754,453,303,451,0
60802,40010,3447,40010,316,136,180,6,6,3,3,0
62019,445,0,0,70,70,0,1,0,1,0,2
51911,14543,57115,14543,70,70,0,2,8,2,0,0
48556,80,48556,80,19225,817,18408,29,15,13,16,0
53101,443,37557,443,8071,1789,6282,20,326,10,10,0
49590,445,0,0,66,66,0,1,0,1,0,2
60165,445,0,0,70,70,0,1,0,1,0,2
51602,445,0,0,70,70,0,1,0,1,0,2
52080,443,29531,443,3052,2014,1038,16,15,9,7,0
50676,445,0,0,66,66,0,1,0,1,0,2
49772,80,38136,80,70,70,0,2,8,2,0,0
443,62451,0,0,199,199,0,1,0,1,0,1
50312,80,15679,80,17102,1099,16003,19,16,5,14,0
61350,445,0,0,70,70,0,1,0,1,0,2
51724,25807,42911,25807,66,66,0,1,5,1,0,0
26081,53,34120,53,75510,75228,282,904,90,902,2,0
50169,25174,0,0,62,62,0,1,0,1,0,1
55673,54815,52506,54815,316,190,126,5,15,3,2,0
55170,53,27773,53,250,94,156,2,30,1,1,0
52165,49740,12957,49740,70,70,0,1,5,1,0,0
13110,52126,0,0,145,145,0,1,0,1,0,1
57789,30188,0,0,62,62,0,1,0,1,0,1
3052,7302,0,0,66,66,0,1,0,1,0,1
60714,445,0,0,70,70,0,1,0,1,0,2
56623,443,54121,443,7982,1962,6020,20,15,11,9,0
16654,50265,0,0,62,62,0,1,0,1,0,1
52156,445,0,0,66,66,0,1,0,1,0,2
58503,445,0,0,66,66,0,1,0,1,0,2
53251,443,53251,443,1404,697,707,17,121,8,9,0
52340,64147,0,0,66,66,0,1,0,1,0,1
55759,53,16569,53,177,94,83,2,30,1,1,0
64884,53,27376,53,195,102,93,2,31,1,1,0
38168,443,45970,443,6136,1404,4732,20,979,10,10,0
63067,53,20594,53,384,166,218,2,30,1,1,0
49668,443,23437,443,7978,2204,5774,20,58,10,10,0
65382,443,15464,443,15607,5238,10369,36,126,19,17,0
53724,64923,33470,64923,70,70,0,2,8,2,0,0
55325,53,5383,53,199,102,97,2,30,1,1,0
48606,443,28779,443,4160,2675,1485,25,95,14,11,0
59116,443,24457,443,48923,5417,43506,61,122,25,36,0
55702,80,29070,80,70,70,0,1,5,1,0,0
28009,36237,0,0,62,62,0,1,0,1,0,1
57235,15187,23276,15187,1269359015,948477220,320881795,1036116,9283,747520,288596,0
65511,443,62661,443,430254,12640,417614,442,16,155,287,0
6882,3800,7427,3800,150,150,0,2,1201,2,0,0
58922,443,2924,443,14553,9653,4900,38,19,22,16,0
0,0,0,0,200,102,98,2,0,1,1,0
56206,445,0,0,70,70,0,1,0,1,0,2
60869,445,0,0,70,70,0,1,0,1,0,2
55678,5618,0,0,145,145,0,1,0,1,0,3
61221,35440,0,0,66,66,0,1,0,1,0,1
51712,445,0,0,70,70,0,1,0,1,0,2
49163,36069,48102,36069,5990,5698,292,17,51,14,3,0
50630,53,37346,53,754,94,660,2,30,1,1,0
60959,445,0,0,70,70,0,1,0,1,0,2
27005,27017,60411,27017,1644,126,1518,4,30,2,2,0
51498,443,51057,443,29265,2836,26429,47,16,21,26,0
63999,10552,38263,10552,70,70,0,1,4,1,0,0
55653,443,8699,443,7267,2312,4955,16,120,7,9,0
64113,445,0,0,70,70,0,1,0,1,0,2
58638,5900,0,0,62,62,0,1,0,1,0,1
39540,37965,0,0,66,66,0,1,0,1,0,1
26528,51221,0,0,78,78,0,1,0,1,0,1
51879,445,0,0,70,70,0,1,0,1,0,2
64204,53,37090,53,193,102,91,2,31,1,1,0
60464,11385,6156,11385,1090,712,378,16,26,10,6,0
53120,25174,0,0,62,62,0,1,0,1,0,1
43382,53,39674,53,86,86,0,1,30,1,0,0
43323,1,0,0,62,62,0,1,0,1,0,1
40898,5555,0,0,60,60,0,1,0,1,0,1
57886,80,60119,80,6526,1210,5316,15,17,8,7,0
54101,443,19141,443,4013,2840,1173,23,27,13,10,0
58051,443,3762,443,8930,1529,7401,21,19,9,12,0
56529,443,43021,443,266757,6935,259822,274,19,97,177,0
57334,53,29836,53,204,104,100,2,31,1,1,0
16905,57866,0,0,66,66,0,1,0,1,0,1
10192,25174,0,0,66,66,0,1,0,1,0,1
56125,80,62901,80,2091,799,1292,10,15,6,4,0
65496,53,41450,53,280,96,184,4,34,2,2,0
57233,50934,0,0,66,66,0,1,0,1,0,1
56682,53,37640,53,168,86,82,2,30,1,1,0
46734,53,39721,53,168,78,90,2,30,1,1,0
65169,53,4248,53,211,102,109,2,30,1,1,0
39345,80,26537,80,918,461,457,9,16,6,3,0
43028,443,42197,443,6748,1643,5105,26,138,14,12,0
60666,123,38509,123,184,94,90,2,30,1,1,0
49941,80,49941,80,493003,23995,469008,578,22,246,332,0
45169,14037,0,0,74,74,0,1,0,1,0,1
55089,53,56950,53,199,102,97,2,30,1,1,0
5227,50584,0,0,62,62,0,1,0,1,0,1
49983,53,2734,53,211,110,101,2,30,1,1,0
64273,445,0,0,66,66,0,1,0,1,0,2
62731,21247,0,0,66,66,0,1,0,1,0,1
14042,22114,0,0,62,62,0,1,0,1,0,1
57653,445,0,0,70,70,0,1,0,1,0,2
60697,445,0,0,66,66,0,1,0,1,0,2
51732,54299,38142,54299,70,70,0,1,5,1,0,0
6546,37965,0,0,62,62,0,1,0,1,0,1
38857,443,38857,443,115031,5628,109403,143,104,55,88,0
50223,445,0,0,66,66,0,1,0,1,0,2
15319,51505,0,0,66,66,0,1,0,1,0,1
27005,1105,65392,1105,855,126,729,2,29,1,1,0
57208,53,19470,53,183,94,89,2,30,1,1,0
61788,445,0,0,70,70,0,1,0,1,0,2
54329,443,7872,443,7827,2416,5411,18,136,8,10,0
52982,25174,0,0,146,146,0,1,0,1,0,1
50315,445,0,0,66,66,0,1,0,1,0,2
56592,445,0,0,70,70,0,1,0,1,0,2
54564,445,0,0,70,70,0,1,0,1,0,2
49920,80,51045,80,3649288,78688,3570600,2923,179,528,2395,0
49313,53,49710,53,199,102,97,2,30,1,1,0
60133,1,0,0,62,62,0,1,0,1,0,1
56529,80,56529,80,1915,1466,449,10,20,6,4,0
57183,53,27398,53,172,88,84,2,30,1,1,0
49377,445,0,0,70,70,0,1,0,1,0,2
65411,53,35148,53,771,101,670,2,30,1,1,0
33133,443,21005,443,8138,2101,6037,17,121,9,8,0
55151,445,0,0,70,70,0,1,0,1,0,2
35864,44847,0,0,78,78,0,1,0,1,0,1
50682,80,52857,80,5237,680,4557,12,170,6,6,0
56504,443,16127,443,4467051,102279,4364772,4340,46,1452,2888,0
50699,445,0,0,66,66,0,1,0,1,0,2
6889,47807,0,0,143,143,0,1,0,1,0,1
50216,443,23002,443,6796,1796,5000,26,257,14,12,0
61622,445,0,0,70,70,0,1,0,1,0,2
443,60496,0,0,320,320,0,1,0,1,0,1
59570,445,0,0,70,70,0,1,0,1,0,2
39716,443,56404,443,131171,10346,120825,183,150,93,90,0
19747,37965,0,0,62,62,0,1,0,1,0,1
65239,445,0,0,70,70,0,1,0,1,0,2
36011,25174,0,0,66,66,0,1,0,1,0,1
58638,5900,0,0,62,62,0,1,0,1,0,1
50806,445,0,0,70,70,0,1,0,1,0,2
56239,53,24103,53,176,90,86,2,31,1,1,0
49418,27015,50232,27015,286,78,208,2,31,1,1,0
50584,42504,10356,42504,161,161,0,2,1199,2,0,0
63380,443,31712,443,4704,2139,2565,13,119,7,6,0
51813,63933,50803,63933,70,70,0,2,8,2,0,0
47682,20541,0,0,62,62,0,1,0,1,0,1
50884,443,50884,443,187790,7733,180057,229,128,90,139,0
49262,53,27998,53,168,86,82,2,31,1,1,0
56670,443,11392,443,8006,1986,6020,20,15,11,9,0
56662,443,9856,443,8007,1987,6020,20,15,11,9,0
50,64147,0,0,66,66,0,1,0,1,0,1
51101,80,9411,80,366,240,126,7,20,5,2,0
52896,80,13613,80,3020,1414,1606,30,118,16,14,0
51244,445,0,0,66,66,0,1,0,1,0,2
64106,64147,0,0,62,62,0,1,0,1,0,1
56943,44847,0,0,62,62,0,1,0,1,0,1
58658,53,27150,53,260,86,174,2,30,1,1,0
14993,50584,0,0,62,62,0,1,0,1,0,1
57052,53,31599,53,711,87,624,2,31,1,1,0
64968,445,0,0,70,70,0,1,0,1,0,2
56342,53,27382,53,733,93,640,2,31,1,1,0
53672,20380,47465,20380,70,70,0,1,4,1,0,0
54896,445,0,0,70,70,0,1,0,1,0,2
55065,80,56775,80,306,180,126,6,28,4,2,0
63923,59177,22656,59177,70,70,0,1,4,1,0,0
55577,53,12118,53,199,102,97,2,30,1,1,0
42642,443,27903,443,6826,1804,5022,21,137,11,10,0
64069,53,35417,53,183,86,97,2,29,1,1,0
50584,63591,44593,63591,161,161,0,2,1200,2,0,0
49193,80,37184,80,6158,654,5504,15,16,8,7,0
11136,15503,0,0,145,145,0,1,0,1,0,1
56880,53,13587,53,209,110,99,2,30,1,1,0
55684,53,10799,53,186,95,91,2,30,1,1,0
52021,32202,28754,32202,66,66,0,1,5,1,0,0
52928,443,12845,443,56910,3384,53526,85,115,33,52,0
55144,443,25818,443,6918,2826,4092,26,21,16,10,0
56700,80,19955,80,51889,4253,47636,68,64,31,37,0
53003,11392,0,0,66,66,0,1,0,1,0,1
55329,53,39839,53,210,102,108,2,29,1,1,0
23710,41615,0,0,145,145,0,1,0,1,0,1
55254,50584,0,0,66,66,0,1,0,1,0,1
56752,443,37907,443,8007,1987,6020,20,15,11,9,0
54768,445,0,0,70,70,0,1,0,1,0,1
2919,57866,0,0,62,62,0,1,0,1,0,1
5819,53,5819,53,197,90,107,2,30,1,1,0
16387,41860,0,0,60,60,0,1,0,1,0,1
49527,53,42526,53,268,94,174,2,29,1,1,0
58447,445,0,0,70,70,0,1,0,1,0,2
56443,53,48417,53,250,86,164,4,29,2,2,0
65000,27019,62331,27019,728,462,266,2,30,1,1,0
52149,445,0,0,66,66,0,1,0,1,0,2
34331,443,11872,443,120,60,60,3,4,2,1,0
64751,53,57978,53,178,94,84,2,30,1,1,0
34932,38608,0,0,62,62,0,1,0,1,0,1
50319,53,65506,53,194,102,92,2,30,1,1,0
56730,53,28037,53,177,94,83,2,30,1,1,0
59529,445,0,0,70,70,0,1,0,1,0,2
43784,443,17789,443,10458,1688,8770,30,15,17,13,0
51311,445,0,0,70,70,0,1,0,1,0,2
64547,53,28372,53,367,102,265,2,31,1,1,0
51721,35426,54780,35426,70,70,0,1,5,1,0,0
49981,53,44663,53,360,102,258,2,30,1,1,0
58612,445,0,0,70,70,0,1,0,1,0,2
56664,80,24275,80,1056,682,374,10,15,6,4,0
59776,443,24367,443,966,480,486,17,29,9,8,0
55997,445,0,0,70,70,0,1,0,1,0,2
49878,80,42487,80,2086,1214,872,8,88,5,3,0
49961,53,12419,53,377,107,270,4,45,2,2,0
57325,60043,0,0,62,62,0,1,0,1,0,1
49540,50584,0,0,66,66,0,1,0,1,0,1
55311,53,55274,53,298,101,197,4,31,2,2,0
49676,53,9085,53,200,94,106,2,30,1,1,0
55056,443,52975,443,8309,1561,6748,26,204,14,12,0
60735,28080,14759,28080,70,70,0,1,5,1,0,0
56601,80,22349,80,234,234,0,4,12,4,0,0
37712,443,12957,443,7660,2239,5421,32,255,16,16,0
65103,445,0,0,66,66,0,1,0,1,0,2
57139,53,1323,53,164,84,80,2,31,1,1,0
55077,53,19465,53,277,90,187,4,32,2,2,0
50143,35253,0,0,62,62,0,1,0,1,0,1
58942,443,33385,443,5168,700,4468,16,15,7,9,0
38475,11392,0,0,66,66,0,1,0,1,0,1
62506,445,0,0,66,66,0,1,0,1,0,2
63895,445,0,0,70,70,0,1,0,1,0,2
51636,445,0,0,70,70,0,1,0,1,0,2
60772,40010,29000,40010,316,136,180,6,5,3,3,0
55539,53,25818,53,249,94,155,2,31,1,1,0
60426,80,65008,80,4515,3889,626,11,27,6,5,0
48071,25174,0,0,62,62,0,1,0,1,0,1
40936,5900,0,0,60,60,0,1,0,1,0,1
50607,443,39884,443,25263,2606,22657,41,90,19,22,0
58638,5900,0,0,62,62,0,1,0,1,0,1
56687,443,42301,443,7889,1900,5989,20,15,11,9,0
64368,443,54903,443,4741,1306,3435,26,300,14,12,0
51796,80,13753,80,2188,1282,906,13,47,8,5,0
49418,27015,65524,27015,287,78,209,2,30,1,1,0
62912,26467,0,0,62,62,0,1,0,1,0,1
49162,53,33526,53,183,94,89,2,30,1,1,0
51853,30585,59624,30585,136,136,0,3,14,3,0,0
59861,445,0,0,70,70,0,1,0,1,0,2
56512,445,0,0,66,66,0,1,0,1,0,2
56855,64607,58491,64607,316,136,180,6,6,3,3,0
56704,53,49275,53,177,94,83,2,31,1,1,0
50739,443,62875,443,6335,1376,4959,19,165,9,10,0
20741,64147,0,0,62,62,0,1,0,1,0,1
55076,53,14239,53,183,94,89,2,30,1,1,0
35104,53,13881,53,168,78,90,2,29,1,1,0
44482,443,27809,443,16517,3254,13263,37,271,18,19,0
53133,445,0,0,70,70,0,1,0,1,0,2
55441,53,20729,53,216,110,106,2,30,1,1,0
11030,17372,0,0,62,62,0,1,0,1,0,1
56472,53,13780,53,167,86,81,2,31,1,1,0
58022,8080,0,0,60,60,0,1,0,1,0,1
52166,80,3955,80,2110,1066,1044,12,15,7,5,0
65204,443,43176,443,1786,172,1614,7,120,3,4,0
51615,25174,0,0,66,66,0,1,0,1,0,1
56946,1,0,0,66,66,0,1,0,1,0,1
60194,443,58489,443,8894,1633,7261,18,16,9,9,0
53146,50393,43018,50393,70,70,0,1,5,1,0,0
60287,80,11423,80,130,70,60,2,15,1,1,0
56267,445,0,0,70,70,0,1,0,1,0,2
53071,25174,0,0,66,66,0,1,0,1,0,1
1026,30188,0,0,62,62,0,1,0,1,0,1
50005,80,43332,80,2088,1160,928,10,86,6,4,0
26457,80,26457,80,17147,1829,15318,28,17,15,13,0
61622,80,61622,80,48702,2799,45903,74,110,38,36,0
59494,443,29596,443,338,278,60,2,5,1,1,0
34517,443,44047,443,5996,1967,4029,17,99,10,7,0
50520,443,34844,443,9942,1211,8731,26,77,14,12,0
64312,53,41455,53,225,110,115,2,30,1,1,0
52422,443,1583,443,1043,556,487,10,15,6,4,0
42718,443,45721,443,7341,2111,5230,18,135,8,10,0
59166,123,2980,123,184,94,90,2,30,1,1,0
56577,53,47746,53,198,110,88,2,30,1,1,0
62922,993,33264,993,9484,4222,5262,86,45,40,46,0
50523,53,31491,53,199,102,97,2,30,1,1,0
52956,443,14626,443,15659,3294,12365,60,114,25,35,0
46618,443,48794,443,9505,3214,6291,33,19,19,14,0
65469,53,36424,53,308,110,198,2,30,1,1,0
64595,53,56793,53,182,93,89,2,30,1,1,0
11295,40018,57800,40018,213,89,124,4,31,2,2,0
51903,35904,6046,35904,70,70,0,2,8,2,0,0
64825,53,5593,53,728,96,632,2,31,1,1,0
52077,443,25258,443,6317,2196,4121,19,15,10,9,0
62053,445,0,0,66,66,0,1,0,1,0,2
2267,53,57413,53,204,118,86,2,31,1,1,0
57596,443,20240,443,8154,1791,6363,21,187,11,10,0
52232,35126,34717,35126,70,70,0,1,5,1,0,0
17306,25174,0,0,66,66,0,1,0,1,0,1
19875,30170,0,0,145,145,0,1,0,1,0,1
56370,443,46541,443,3715,1791,1924,23,203,12,11,0
50750,445,0,0,70,70,0,1,0,1,0,2
64881,445,0,0,66,66,0,1,0,1,0,2
58677,28678,3047,28678,1806,1806,0,22,225,22,0,0
58349,445,0,0,70,70,0,1,0,1,0,2
50556,445,0,0,70,70,0,1,0,1,0,2
27005,27015,45042,27015,878,126,752,2,30,1,1,0
57778,443,43252,443,6182,3879,2303,53,3828,31,22,0
59738,445,0,0,66,66,0,1,0,1,0,2
49856,80,12008,80,13992,1645,12347,23,89,10,13,0
65469,445,0,0,66,66,0,1,0,1,0,2
64305,445,0,0,70,70,0,1,0,1,0,2
38283,443,38283,443,6981,948,6033,17,54,10,7,0
59791,443,43640,443,6603,1085,5518,23,28,11,12,0
22904,56205,0,0,62,62,0,1,0,1,0,1
56627,53,58271,53,193,102,91,2,29,1,1,0
58467,53,16449,53,235,95,140,2,31,1,1,0
60342,7000,60342,7000,3114,1659,1455,17,15,9,8,0
51069,80,24367,80,254,128,126,5,15,3,2,0
0,0,0,0,182,182,0,1,0,1,0,1
49182,21247,0,0,66,66,0,1,0,1,0,1
65463,445,0,0,70,70,0,1,0,1,0,2
1987,26467,0,0,62,62,0,1,0,1,0,1
55145,443,65048,443,13231,6169,7062,38,120,19,19,0
60425,443,26007,443,1541,1004,537,14,26,8,6,0
60219,53,60219,53,414,268,146,3,32,2,1,0
49878,24855,0,0,66,66,0,1,91,1,0,0
63029,445,0,0,70,70,0,1,0,1,0,2
55364,445,0,0,70,70,0,1,0,1,0,2
49636,53,21781,53,176,90,86,2,31,1,1,0
64817,445,0,0,70,70,0,1,0,1,0,2
51980,80,2288,80,366,240,126,7,25,5,2,0
5,47993,0,0,62,62,0,1,0,1,0,1
53706,80,53481,80,1398,590,808,9,111,6,3,0
51652,80,57447,80,141220,4280,136940,159,17,59,100,0
55836,445,0,0,66,66,0,1,0,1,0,2
49211,15576,30482,15576,70,70,0,1,5,1,0,0
56082,53,27828,53,182,94,88,2,30,1,1,0
64241,445,0,0,70,70,0,1,0,1,0,2
49353,443,32645,443,7030,1195,5835,20,76,10,10,0
50976,80,46012,80,1094127,5977,1088150,812,35,88,724,0
64393,53,13343,53,183,94,89,2,31,1,1,0
50578,80,53375,80,1114,534,580,12,16,7,5,0
57258,53,4190,53,177,94,83,2,29,1,1,0
49196,25174,0,0,66,66,0,1,0,1,0,1
62297,445,0,0,70,70,0,1,0,1,0,2
55490,443,55467,443,3080,1018,2062,10,120,5,5,0
65130,53,25428,53,646,200,446,6,62,3,3,0
60389,443,56749,443,8166,1734,6432,23,81,12,11,0
58396,443,53120,443,138065,109491,28574,429,186,230,199,0
53108,22114,0,0,146,146,0,1,0,1,0,1
26900,27017,15895,27017,254,82,172,4,30,2,2,0
6666,21,0,0,60,60,0,1,0,1,0,1
28136,443,42266,443,8805,3429,5376,33,475,16,17,0
56163,53,47774,53,194,102,92,2,30,1,1,0
443,63113,0,0,100,100,0,1,0,1,0,1
10273,21247,0,0,66,66,0,1,0,1,0,1
61507,445,0,0,70,70,0,1,0,1,0,2
62328,443,62328,443,1210,637,573,14,51,7,7,0
49752,53,64105,53,193,102,91,2,30,1,1,0
59907,445,0,0,70,70,0,1,0,1,0,2
36010,443,44715,443,5689,1505,4184,24,19,13,11,0
55732,53,62249,53,188,96,92,2,31,1,1,0
57731,53,26408,53,237,86,151,2,30,1,1,0
56282,3389,56282,3389,3425,1470,1955,16,16,8,8,0
17244,22114,0,0,62,62,0,1,0,1,0,1
33734,53,33734,53,257,101,156,2,33,1,1,0
41432,53,63040,53,202,83,119,2,30,1,1,0
27005,33038,15973,33038,892,126,766,2,31,1,1,0
36712,53,0,0,138,69,69,2,30,1,1,0
50360,80,16489,80,318,192,126,6,28,4,2,0
64035,445,0,0,66,66,0,1,0,1,0,2
50804,1,0,0,62,62,0,1,0,1,0,1
3212,22114,0,0,146,146,0,1,0,1,0,1
49686,80,54142,80,2611,1811,800,13,15,7,6,0
52115,445,0,0,70,70,0,1,0,1,0,2
53896,48027,30657,48027,70,70,0,1,5,1,0,0
61651,123,29529,123,184,94,90,2,30,1,1,0
55084,53,64405,53,177,94,83,2,29,1,1,0
52881,445,0,0,70,70,0,1,0,1,0,2
50309,53,52592,53,816,102,714,2,29,1,1,0
58638,5900,0,0,62,62,0,1,0,1,0,1
3225,64147,0,0,62,62,0,1,0,1,0,1
60382,62582,18649,62582,70,70,0,2,8,2,0,0
55704,53,8827,53,177,94,83,2,31,1,1,0
60612,445,0,0,70,70,0,1,0,1,0,2
63750,63343,38388,63343,66,66,0,2,8,2,0,0
49948,53,31894,53,755,102,653,2,30,1,1,0
56628,445,0,0,70,70,0,1,0,1,0,2
32806,53,32806,53,194,87,107,2,31,1,1,0
6338,23117,0,0,66,66,0,1,0,1,0,1
55282,445,0,0,70,70,0,1,0,1,0,2
0,0,0,0,124,64,60,2,0,1,1,0
53626,30317,0,0,66,66,0,1,0,1,0,1
49929,26467,0,0,66,66,0,1,0,1,0,1
52989,53,36046,53,406,94,312,2,30,1,1,0
63053,445,0,0,66,66,0,1,0,1,0,2
55762,53,8136,53,196,86,110,2,29,1,1,0
35584,80,52820,80,1507,454,1053,10,15,5,5,0
43129,20220,0,0,62,62,0,1,0,1,0,1
65327,445,0,0,66,66,0,1,0,1,0,2
64725,445,0,0,70,70,0,1,0,1,0,2
60251,445,0,0,66,66,0,1,0,1,0,2
56428,30317,0,0,66,66,0,1,0,1,0,1
63985,43081,42263,43081,66,66,0,2,7,2,0,0
61572,53,61572,53,213,79,134,2,33,1,1,0
57020,53,49369,53,738,86,652,2,31,1,1,0
60483,443,59259,443,3089,866,2223,11,121,6,5,0
57917,44847,0,0,66,66,0,1,0,1,0,1
443,35385,0,0,97,97,0,1,0,1,0,1
58638,5900,0,0,62,62,0,1,0,1,0,1
48734,443,7322,443,256887,11565,245322,293,56,112,181,0
52891,443,27899,443,320255,9207,311048,343,117,107,236,0
33415,53,42301,53,164,78,86,2,29,1,1,0
55136,11392,0,0,66,66,0,1,0,1,0,1
56465,443,52483,443,6081,844,5237,17,15,9,8,0
49608,53,46552,53,177,94,83,2,30,1,1,0
53751,22266,31272,22266,754,502,252,11,20,7,4,0
50108,53,40711,53,179,94,85,2,30,1,1,0
56446,443,39205,443,15813,5998,9815,30,120,14,16,0
59693,443,23790,443,1867,250,1617,8,120,4,4,0
49181,2710,53031,2710,70,70,0,2,8,2,0,0
2425,23117,0,0,66,66,0,1,0,1,0,1
65189,27017,19229,27017,239,78,161,2,30,1,1,0
47120,443,47120,443,4604,1697,2907,19,29,11,8,0
36579,30188,0,0,66,66,0,1,0,1,0,1
14924,44847,0,0,62,62,0,1,0,1,0,1
51105,50584,0,0,66,66,0,1,0,1,0,1
53769,8999,60336,8999,70,70,0,1,5,1,0,0
34914,26467,0,0,62,62,0,1,0,1,0,1
52374,445,0,0,70,70,0,1,0,1,0,2
65340,53,24167,53,313,110,203,4,34,2,2,0
59048,57470,0,0,66,66,0,1,0,1,0,1
58409,53,57147,53,307,86,221,2,30,1,1,0
55335,445,0,0,70,70,0,1,0,1,0,2
50698,80,42687,80,54871,28320,26551,231,174,116,115,0
3697,80,55800,80,6688,1208,5480,20,104,12,8,0
51891,80,21420,80,7434,3830,3604,17,30,9,8,0
27005,33051,7331,33051,887,126,761,2,31,1,1,0
51829,36134,0,0,66,66,0,1,0,1,0,1
56720,53,11601,53,177,94,83,2,29,1,1,0
49418,27058,37318,27058,263,78,185,2,30,1,1,0
64221,53,19919,53,262,102,160,2,30,1,1,0
65229,53,47918,53,195,102,93,2,30,1,1,0
1117,37965,0,0,62,62,0,1,0,1,0,1
29045,41864,0,0,159,159,0,1,0,1,0,1
56893,53,21610,53,177,94,83,2,30,1,1,0
56712,53,47464,53,177,94,83,2,30,1,1,0
28832,36237,0,0,66,66,0,1,0,1,0,1
35011,37965,0,0,62,62,0,1,0,1,0,1
54047,50011,0,0,66,66,0,1,0,1,0,1
58638,5900,0,0,62,62,0,1,0,1,0,1
55889,53,50897,53,199,102,97,2,29,1,1,0
62208,443,62208,443,4497,1590,2907,19,29,11,8,0
57470,59216,60669,59216,594,594,0,10,1200,10,0,0
56910,53,22546,53,199,102,97,2,29,1,1,0
56491,80,30431,80,37154,2381,34773,50,135,23,27,0
34692,80,34692,80,3530,2851,679,13,20,8,5,0
1091,37965,0,0,62,62,0,1,0,1,0,1
64467,53,41082,53,548,194,354,6,63,3,3,0
49410,53,65177,53,172,88,84,2,31,1,1,0
50861,443,62102,443,1501,590,911,12,26,6,6,0
18592,44612,0,0,62,62,0,1,0,1,0,1
62177,445,0,0,66,66,0,1,0,1,0,2
63404,445,0,0,70,70,0,1,0,1,0,2
53640,25174,0,0,66,66,0,1,0,1,0,1
43880,80,10125,80,2693,841,1852,13,16,8,5,0
52088,35605,27322,35605,70,70,0,1,5,1,0,0
57983,443,8445,443,315701,12378,303323,358,137,129,229,0
50801,443,41271,443,6893,1384,5509,19,140,9,10,0
3352,50584,0,0,62,62,0,1,0,1,0,1
13441,57470,0,0,62,62,0,1,0,1,0,1
7482,57470,0,0,66,66,0,1,0,1,0,1
53032,445,0,0,70,70,0,1,0,1,0,2
38633,51221,0,0,62,62,0,1,0,1,0,1
49989,53,14607,53,778,103,675,2,30,1,1,0
52064,22114,0,0,66,66,0,1,0,1,0,1
33771,53,38746,53,506,316,190,3,30,2,1,0
62816,445,0,0,66,66,0,1,0,1,0,2
22767,53,22767,53,226,106,120,2,30,1,1,0
60399,445,0,0,70,70,0,1,0,1,0,2
53355,23117,0,0,62,62,0,1,0,1,0,1
9212,51505,0,0,62,62,0,1,0,1,0,1
52892,443,17240,443,41925,30922,11003,68,186,38,30,0
56689,443,16946,443,7890,1901,5989,20,15,11,9,0
55752,53,39716,53,177,94,83,2,30,1,1,0
51690,993,38356,993,15022,5202,9820,113,36,53,60,0
63059,445,0,0,70,70,0,1,0,1,0,2
65179,53,56146,53,184,94,90,2,30,1,1,0
61792,443,46504,443,12526,7202,5324,28,99,15,13,0
58735,443,63211,443,1413,876,537,12,26,6,6,0
50692,80,35406,80,57678,29714,27964,241,175,120,121,0
15274,19473,0,0,62,62,0,1,0,1,0,1
60206,443,52179,443,4706,2475,2231,13,120,7,6,0
52340,22114,0,0,66,66,0,1,0,1,0,1
49722,443,18328,443,9698,3026,6672,54,618,27,27,0
58739,443,43331,443,22751,17995,4756,67,73,42,25,0
59952,53,59952,53,215,80,135,2,32,1,1,0
53855,445,0,0,70,70,0,1,0,1,0,2
45602,443,17240,443,4417,3084,1333,17,361,9,8,0
44805,443,37165,443,6975,2168,4807,20,15,11,9,0
34141,53,34141,53,217,87,130,2,30,1,1,0
50584,1070,63097,1070,161,161,0,2,1200,2,0,0
53591,445,0,0,70,70,0,1,0,1,0,2
1024,21854,0,0,157,157,0,1,0,1,0,3
61469,445,0,0,66,66,0,1,0,1,0,2
55496,64097,0,0,66,66,0,1,0,1,0,1
27005,27015,51947,27015,879,126,753,2,30,1,1,0
51203,443,62126,443,5737,1829,3908,22,18,13,9,0
27005,27017,35539,27017,873,126,747,2,31,1,1,0
56096,443,56096,443,5493,2246,3247,22,39,13,9,0
51705,59244,12307,59244,66,66,0,1,5,1,0,0
49289,53,50733,53,322,118,204,2,30,1,1,0
64941,53,15219,53,199,102,97,2,30,1,1,0
58638,5900,0,0,62,62,0,1,0,1,0,1
60265,53,3375,53,215,86,129,2,30,1,1,0
56131,445,0,0,70,70,0,1,0,1,0,2
50009,80,24998,80,186,64,122,4,29,2,2,0
57470,54343,65136,54343,330,330,0,6,1200,6,0,0
65503,53,13139,53,177,94,83,2,30,1,1,0
51610,443,19441,443,6952,3608,3344,27,21,14,13,0
56440,53,14356,53,742,88,654,2,30,1,1,0
50143,35253,0,0,66,66,0,1,0,1,0,1
58638,5900,0,0,62,62,0,1,0,1,0,1
57987,56125,0,0,90,90,0,1,0,1,0,1
56711,25174,0,0,62,62,0,1,0,1,0,1
36194,443,29201,443,5674,1556,4118,23,271,13,10,0
51026,37450,0,0,66,66,0,1,0,1,0,1
63598,445,0,0,66,66,0,1,0,1,0,2
59936,445,0,0,66,66,0,1,0,1,0,2
6355,25174,0,0,62,62,0,1,0,1,0,1
57003,80,40780,80,526,304,222,8,35,5,3,0
50293,445,0,0,70,70,0,1,0,1,0,2
64036,23718,0,0,66,66,0,1,0,1,0,1
49349,80,16332,80,2391,532,1859,11,76,6,5,0
50913,445,0,0,66,66,0,1,0,1,0,2
49420,53,26234,53,364,102,262,2,30,1,1,0
24606,55783,0,0,72,72,0,1,0,1,0,1
63904,18268,47003,18268,66,66,0,2,7,2,0,0
44893,53,32339,53,199,94,105,2,30,1,1,0
57389,53,29962,53,193,102,91,2,30,1,1,0
64741,53,19831,53,420,110,310,2,30,1,1,0
58730,443,58122,443,5110,950,4160,21,48,10,11,0
55962,445,0,0,70,70,0,1,0,1,0,2
55081,53,2837,53,711,87,624,2,31,1,1,0
52749,443,45343,443,148418,107579,40839,315,6090,107,208,0
49900,443,38776,443,8417,1173,7244,18,86,9,9,0
53711,443,24841,443,499,425,74,4,0,3,1,0
52502,445,0,0,70,70,0,1,0,1,0,2
52557,44847,0,0,62,62,0,1,0,1,0,1
55887,53,33560,53,166,86,80,2,31,1,1,0
36258,443,41571,443,1128432,47396,1081036,1242,142,458,784,0
56418,41615,0,0,143,143,0,1,0,1,0,1
59271,443,60275,443,26414,4349,22065,41,149,17,24,0
22461,34021,0,0,62,62,0,1,0,1,0,3
57177,53,20677,53,179,94,85,2,29,1,1,0
49418,32038,58741,32038,235,78,157,2,30,1,1,0
52116,445,0,0,70,70,0,1,0,1,0,2
57931,445,0,0,70,70,0,1,0,1,0,2
57575,443,3355,443,707158,36853,670305,902,148,310,592,0
49371,445,0,0,70,70,0,1,0,1,0,2
58200,445,0,0,70,70,0,1,0,1,0,2
49839,443,44506,443,7021,1767,5254,26,224,13,13,0
57221,445,0,0,66,66,0,1,0,1,0,2
61433,443,33532,443,41274,18956,22318,90,171,43,47,0
57351,62413,0,0,66,66,0,1,0,1,0,1
38501,53,38501,53,233,91,142,2,31,1,1,0
50534,80,11143,80,318,192,126,6,25,4,2,0
32381,50584,0,0,66,66,0,1,0,1,0,1
1594,44847,0,0,62,62,0,1,0,1,0,1
53417,443,8874,443,9193,6294,2899,27,121,14,13,0
34415,443,34473,443,6397,1590,4807,23,315,12,11,0
56821,53,37054,53,199,102,97,2,29,1,1,0
3851,53,3851,53,235,90,145,2,33,1,1,0
64691,25320,0,0,62,62,0,1,0,1,0,1
52233,80,14705,80,1674,708,966,18,392,6,12,0
64896,53,10637,53,716,95,621,2,31,1,1,0
49380,443,11402,443,2382775,72482,2310293,2485,252,843,1642,0
45472,8168,0,0,62,62,0,1,0,1,0,1
54121,25174,0,0,66,66,0,1,0,1,0,1
53403,445,0,0,70,70,0,1,0,1,0,2
64645,53,50507,53,391,96,295,4,49,2,2,0
60936,443,12668,443,1864,250,1614,8,120,4,4,0
41486,1433,0,0,60,60,0,1,0,1,0,1
47943,50584,0,0,74,74,0,1,0,1,0,1
62877,53,36980,53,248,78,170,2,30,1,1,0
51985,445,0,0,70,70,0,1,0,1,0,2
58910,445,0,0,70,70,0,1,0,1,0,2
63573,445,0,0,70,70,0,1,0,1,0,2
58294,445,0,0,66,66,0,1,0,1,0,2
65486,53,53853,53,193,102,91,2,30,1,1,0
55243,443,31338,443,36501,26194,10307,76,71,47,29,0
60976,22114,0,0,62,62,0,1,0,1,0,1
65530,53,2612,53,102,102,0,1,30,1,0,0
32346,53,32346,53,200,90,110,2,30,1,1,0
55624,53,14345,53,198,101,97,2,31,1,1,0
64096,443,64096,443,5661,2415,3246,26,160,14,12,0
62225,445,0,0,70,70,0,1,0,1,0,2
58166,53,23423,53,224,94,130,2,30,1,1,0
58754,53,0,0,627,80,547,2,30,1,1,0
58638,5900,0,0,62,62,0,1,0,1,0,1
53737,443,33568,443,12192,3674,8518,53,454,26,27,0
34212,11392,0,0,66,66,0,1,0,1,0,1
7532,53,7532,53,228,90,138,2,31,1,1,0
50584,64368,19845,64368,161,161,0,2,1200,2,0,0
49767,53,47243,53,185,102,83,2,30,1,1,0
62286,445,0,0,66,66,0,1,0,1,0,2
56114,53,2423,53,216,110,106,2,30,1,1,0
56464,53,12026,53,177,94,83,2,30,1,1,0
52657,53,48551,53,302,210,92,3,30,2,1,0
63952,50734,54501,50734,66,66,0,2,8,2,0,0
57783,445,0,0,70,70,0,1,0,1,0,2
56387,25174,0,0,62,62,0,1,0,1,0,1
65276,445,0,0,70,70,0,1,0,1,0,2
53743,443,64755,443,495,421,74,4,1,3,1,0
52573,80,52573,80,3487,696,2791,13,142,6,7,0
50000,53,12799,53,216,110,106,2,31,1,1,0
60529,445,0,0,70,70,0,1,0,1,0,2
64586,53,2228,53,173,94,79,2,30,1,1,0
49839,53,21176,53,315,102,213,2,30,1,1,0
54996,53,14810,53,168,86,82,2,31,1,1,0
56778,443,16345,443,8654,2150,6504,20,15,11,9,0
2085,7010,2085,7010,3342,1983,1359,16,15,8,8,0
56261,445,0,0,70,70,0,1,0,1,0,2
64041,53,24835,53,200,102,98,2,29,1,1,0
35824,443,2741,443,7237,2204,5033,15,120,7,8,0
58638,5900,58638,5900,62,62,0,1,5,1,0,0
49897,445,0,0,66,66,0,1,0,1,0,2
36154,47807,0,0,146,146,0,1,0,1,0,1
49160,31652,0,0,146,146,0,1,0,1,0,3
19594,23117,0,0,62,62,0,1,0,1,0,1
3717,25174,0,0,62,62,0,1,0,1,0,1
57362,53,3531,53,177,94,83,2,30,1,1,0
38428,443,25567,443,9483,2964,6519,23,17,13,10,0
21189,53,21189,53,374,240,134,3,32,2,1,0
55246,445,0,0,70,70,0,1,0,1,0,2
18398,21247,0,0,66,66,0,1,0,1,0,1
48755,80,48755,80,630,264,366,10,44,5,5,0
65118,445,0,0,70,70,0,1,0,1,0,2
55961,53,7584,53,214,102,112,2,30,1,1,0
52380,443,20377,443,8659,3601,5058,34,80,18,16,0
6189,53,29429,53,229,86,143,2,30,1,1,0
64828,53,23782,53,372,94,278,2,30,1,1,0
60473,22170,57823,22170,1599,743,856,13,36,7,6,0
443,45788,0,0,332,332,0,1,0,1,0,1
64002,2880,14112,2880,66,66,0,1,5,1,0,0
53223,443,54102,443,7457,1726,5731,25,65,13,12,0
60374,57470,0,0,62,62,0,1,0,1,0,1
54506,80,60844,80,254,128,126,5,15,3,2,0
62832,445,0,0,70,70,0,1,0,1,0,2
3478,61463,0,0,1094,1094,0,1,0,1,0,1
14252,35993,0,0,66,66,0,1,0,1,0,1
61897,445,0,0,66,66,0,1,0,1,0,2
55815,445,0,0,70,70,0,1,0,1,0,2
31956,53,16501,53,268,94,174,2,30,1,1,0
57956,445,0,0,70,70,0,1,0,1,0,2
51684,80,23150,80,1515,481,1034,11,15,6,5,0
50582,80,62835,80,53959,2683,51276,69,16,30,39,0
49776,53,42364,53,182,94,88,2,30,1,1,0
61518,445,0,0,66,66,0,1,0,1,0,2
50486,443,7512,443,1043,556,487,10,16,6,4,0
58889,443,6054,443,7871,5455,2416,24,18,13,11,0
50112,123,33230,123,184,94,90,2,30,1,1,0
38863,443,38863,443,36313,5931,30382,72,108,36,36,0
58077,36653,53473,36653,204,64,140,4,11,2,2,0
50357,80,43010,80,764,698,66,6,15,5,1,0
50321,443,43498,443,8156,1586,6570,24,82,11,13,0
55056,56205,0,0,66,66,0,1,0,1,0,1
49982,37965,0,0,66,66,0,1,0,1,0,1
53841,443,33528,443,499,425,74,4,0,3,1,0
6881,6881,14545,6881,492,150,342,2,1200,1,1,0
64324,53,40799,53,179,94,85,2,29,1,1,0
50222,445,0,0,70,70,0,1,0,1,0,2
53490,62413,0,0,66,66,0,1,0,1,0,1
59419,443,5544,443,2854,1732,1122,16,15,8,8,0
45663,53,45663,53,507,129,378,2,30,1,1,0
64341,57470,0,0,62,62,0,1,0,1,0,1
53640,25174,0,0,66,66,0,1,0,1,0,1
52026,26467,0,0,60,60,0,1,0,1,0,1
58744,443,58147,443,14878,4225,10653,83,330,41,42,0
51411,443,26944,443,509,329,180,6,8,3,3,0
53868,53,29458,53,86,86,0,1,30,1,0,0
56753,44847,0,0,146,146,0,1,0,1,0,1
6721,37965,0,0,66,66,0,1,0,1,0,1
64620,53,58577,53,166,86,80,2,30,1,1,0
49175,2710,9134,2710,66,66,0,1,5,1,0,0
56396,53,44233,53,182,93,89,2,31,1,1,0
55452,445,0,0,70,70,0,1,0,1,0,2
53007,443,38198,443,25010,3519,21491,42,135,17,25,0
56928,53,11160,53,178,94,84,2,31,1,1,0
51846,41510,18249,41510,70,70,0,2,8,2,0,0
57629,80,39284,80,1115,534,581,12,16,7,5,0
64078,443,31734,443,4458,1569,2889,24,138,10,14,0
58638,5900,0,0,62,62,0,1,0,1,0,1
14397,37965,0,0,62,62,0,1,0,1,0,1
51952,50967,36786,50967,70,70,0,2,7,2,0,0
49304,443,13306,443,12436,7656,4780,41,17,23,18,0
60013,443,65408,443,145369,7769,137600,224,21,106,118,0
11585,56205,0,0,62,62,0,1,0,1,0,1
50552,445,0,0,70,70,0,1,0,1,0,2
54371,443,18994,443,11828,2811,9017,31,76,16,15,0
2890,443,2890,443,6915,882,6033,16,134,9,7,0
60027,443,59128,443,25215,5119,20096,55,144,26,29,0
37549,443,18373,443,203299,6930,196369,231,16,92,139,0
54343,50584,0,0,66,66,0,1,0,1,0,1
60871,443,15673,443,95311,21869,73442,140,62,61,79,0
64567,53,15933,53,198,101,97,2,30,1,1,0
2522,64147,0,0,62,62,0,1,0,1,0,1
43363,26467,0,0,66,66,0,1,0,1,0,1
33932,443,50545,443,54451,2603,51848,70,16,30,40,0
50553,80,13843,80,378,192,186,7,26,4,3,0
52740,443,65500,443,168753,7954,160799,212,26,95,117,0
49468,443,51693,443,6940,1302,5638,20,119,10,10,0
60849,80,64699,80,9729,876,8853,21,45,11,10,0
52000,80,35679,80,3604,2064,1540,15,40,10,5,0
34709,443,21963,443,2119,1310,809,21,27,12,9,0
31066,57470,0,0,74,74,0,1,0,1,0,1
51745,57470,0,0,62,62,0,1,0,1,0,1
60569,445,0,0,70,70,0,1,0,1,0,2
61520,23718,0,0,66,66,0,1,0,1,0,1
50425,53,24348,53,199,102,97,2,30,1,1,0
49763,443,47715,443,12767,8343,4424,31,122,17,14,0
4903,42873,0,0,70,70,0,1,0,1,0,1
48565,53,48565,53,197,90,107,2,30,1,1,0
56738,53,36120,53,264,87,177,4,37,2,2,0
7246,59858,0,0,66,66,0,1,0,1,0,1
57834,443,16694,443,6214,1733,4481,13,121,6,7,0
63945,53,52680,53,216,110,106,2,31,1,1,0
61701,15503,0,0,62,62,0,1,0,1,0,1
17873,23117,0,0,62,62,0,1,0,1,0,1
38866,443,54319,443,16577,10269,6308,33,17,20,13,0
59896,445,0,0,70,70,0,1,0,1,0,2
53932,80,32355,80,1134,465,669,9,18,6,3,0
28036,443,58065,443,5780,4574,1206,20,16,11,9,0
49769,445,0,0,70,70,0,1,0,1,0,2
55242,445,0,0,66,66,0,1,0,1,0,2
55003,445,0,0,70,70,0,1,0,1,0,2
64524,53,20476,53,274,94,180,4,33,2,2,0
10586,37965,0,0,62,62,0,1,0,1,0,1
57149,53,45353,53,222,86,136,2,30,1,1,0
57422,80,40149,80,10454,4931,5523,21,30,10,11,0
37628,443,37587,443,5783,1761,4022,24,46,14,10,0
38723,37838,0,0,146,146,0,1,0,1,0,1
48817,51413,48817,51413,479,152,327,2,1200,1,1,0
43864,443,38853,443,4922,2860,2062,25,39,14,11,0
57377,53,64833,53,1165,94,1071,2,30,1,1,0
60575,443,23365,443,5994,1594,4400,23,42,12,11,0
58964,80,7375,80,5541,4758,783,16,16,8,8,0
64257,53,1307,53,168,86,82,2,30,1,1,0
56039,50584,0,0,66,66,0,1,0,1,0,1
59583,445,0,0,70,70,0,1,0,1,0,2
56371,445,0,0,66,66,0,1,0,1,0,2
58079,50584,0,0,66,66,0,1,0,1,0,1
38660,15000,20760,15000,138,78,60,2,5,1,1,0
54518,25174,0,0,62,62,0,1,0,1,0,1
60602,5222,39358,5222,5564,2206,3358,50,310,20,30,0
56615,53,58132,53,170,87,83,2,30,1,1,0
34937,443,49817,443,10059,2039,8020,23,186,12,11,0
52283,445,0,0,66,66,0,1,0,1,0,2
60367,443,45021,443,4847,963,3884,22,63,11,11,0
50388,53,36843,53,177,94,83,2,30,1,1,0
56142,53,19071,53,194,102,92,2,29,1,1,0
50584,18066,56366,18066,1705,536,1169,5,1200,4,1,0
54978,80,11814,80,1448,539,909,17,32,9,8,0
49234,53,62807,53,167,86,81,2,29,1,1,0
51528,445,0,0,66,66,0,1,0,1,0,2
56216,50584,0,0,62,62,0,1,0,1,0,1
61142,445,0,0,66,66,0,1,0,1,0,2
49764,53,36622,53,199,102,97,2,31,1,1,0
11337,15503,0,0,62,62,0,1,0,1,0,1
58793,443,26304,443,5167,700,4467,16,15,7,9,0
50527,53,64659,53,969,86,883,2,30,1,1,0
63453,445,0,0,66,66,0,1,0,1,0,2
53152,443,44569,443,16706,6162,10544,39,29,19,20,0
5588,5588,0,0,3562,1936,1626,48,194,24,24,0
56613,443,6770,443,6016,1284,4732,18,984,8,10,0
50920,60182,0,0,62,62,0,1,0,1,0,1
51853,80,50403,80,4903,4061,842,11,26,6,5,0
60014,443,60627,443,4275,1488,2787,17,143,9,8,0
45458,443,14560,443,7144,4917,2227,36,561,18,18,0
56341,445,0,0,66,66,0,1,0,1,0,2
55061,80,17010,80,486,240,246,9,28,5,4,0
31738,51505,0,0,62,62,0,1,0,1,0,1
51953,443,6688,443,7571,3372,4199,33,88,17,16,0
59000,443,41990,443,9876,5325,4551,25,131,14,11,0
37176,80,24453,80,941,526,415,11,315,6,5,0
27005,33084,40774,33084,906,126,780,2,31,1,1,0
63774,445,0,0,70,70,0,1,0,1,0,2
10151,60419,62503,60419,479,150,329,2,1200,1,1,0
64899,53,16096,53,199,102,97,2,30,1,1,0
59733,443,63033,443,7310,967,6343,18,25,10,8,0
52887,37807,0,0,66,66,0,1,0,1,0,1
60811,40010,33835,40010,316,136,180,6,5,3,3,0
61419,57470,0,0,66,66,0,1,0,1,0,1
51434,445,0,0,70,70,0,1,0,1,0,2
11907,57470,0,0,66,66,0,1,0,1,0,1
54992,53,62120,53,195,102,93,2,30,1,1,0
50585,80,63970,80,1726,963,763,13,80,7,6,0
55223,53,54493,53,168,86,82,2,31,1,1,0
44883,53,44883,53,216,90,126,2,29,1,1,0
10886,51505,0,0,62,62,0,1,0,1,0,1
50620,445,0,0,66,66,0,1,0,1,0,2
59885,443,10109,443,1401,864,537,12,28,6,6,0
53155,443,52565,443,3866,2774,1092,21,28,12,9,0
44208,26467,0,0,62,62,0,1,0,1,0,1
50420,80,36435,80,5048,4344,704,11,26,6,5,0
43348,443,43348,443,46356,1595,44761,52,17,15,37,0
60587,445,0,0,70,70,0,1,0,1,0,2
37168,443,5501,443,4871,923,3948,19,360,10,9,0
61691,445,0,0,70,70,0,1,0,1,0,2
54287,443,13671,443,122,62,60,2,15,1,1,0
34416,443,60300,443,10255,2803,7452,35,26,18,17,0
27288,53,2459,53,199,94,105,2,30,1,1,0
53771,37965,0,0,66,66,0,1,0,1,0,1
56656,53,40908,53,255,88,167,4,53,2,2,0
59544,445,0,0,70,70,0,1,0,1,0,2
53408,445,0,0,70,70,0,1,0,1,0,2
65165,53,27998,53,783,96,687,2,31,1,1,0
57434,50584,0,0,62,62,0,1,0,1,0,1
50146,445,0,0,70,70,0,1,0,1,0,2
57470,43836,52896,43836,402,132,270,6,1209,3,3,0
64000,53,28661,53,241,102,139,2,30,1,1,0
57858,445,0,0,70,70,0,1,0,1,0,2
19698,502,0,0,60,60,0,1,0,1,0,1
57165,34101,0,0,66,66,0,1,0,1,0,1
65373,53,60314,53,194,99,95,2,31,1,1,0
65211,53,49175,53,216,102,114,2,30,1,1,0
42298,40020,47579,40020,148,86,62,2,31,1,1,0
57653,445,0,0,70,70,0,1,0,1,0,2
56813,445,0,0,70,70,0,1,0,1,0,2
65048,53,7806,53,194,102,92,2,30,1,1,0
50404,445,0,0,70,70,0,1,0,1,0,2
59601,445,0,0,66,66,0,1,0,1,0,2
64587,43890,0,0,66,66,0,1,0,1,0,1
60557,445,0,0,70,70,0,1,0,1,0,2
65299,445,0,0,70,70,0,1,0,1,0,2
61675,443,61675,443,8512,2483,6029,21,18,12,9,0
65315,53,35548,53,178,94,84,2,29,1,1,0
40189,80,30791,80,5043,1656,3387,18,205,10,8,0
35078,53,22216,53,198,93,105,2,30,1,1,0
58288,443,58288,443,4661,1754,2907,19,26,11,8,0
41898,22114,0,0,146,146,0,1,0,1,0,1
50902,80,26223,80,12578792,132594,12446198,10198,133,1845,8353,0
53984,445,0,0,70,70,0,1,0,1,0,2
61730,25320,0,0,66,66,0,1,0,1,0,1
60428,55172,58181,55172,320,140,180,6,7,3,3,0
61268,445,0,0,70,70,0,1,0,1,0,2
51717,63436,58721,63436,66,66,0,1,5,1,0,0
49734,445,0,0,66,66,0,1,0,1,0,2
55617,53,30754,53,212,108,104,2,31,1,1,0
37965,54371,6962,54371,132,132,0,3,1199,3,0,0
54286,123,33034,123,184,94,90,2,30,1,1,0
57144,8525,57144,8525,138,78,60,2,5,1,1,0
34942,443,50978,443,4317,2189,2128,29,82,15,14,0
17280,22114,0,0,62,62,0,1,0,1,0,1
56928,53,51278,53,178,94,84,2,30,1,1,0
12531,22114,0,0,62,62,0,1,0,1,0,1
61024,445,0,0,66,66,0,1,0,1,0,2
53373,445,0,0,70,70,0,1,0,1,0,2
49483,53,61034,53,319,94,225,2,29,1,1,0
52348,62413,0,0,66,66,0,1,0,1,0,1
6881,6883,20913,6883,259,150,109,2,1200,1,1,0
62057,445,0,0,70,70,0,1,0,1,0,2
60079,80,9698,80,31418,1784,29634,37,126,14,23,0
65524,445,0,0,66,66,0,1,0,1,0,2
27005,27015,24637,27015,1630,126,1504,4,31,2,2,0
52940,445,0,0,66,66,0,1,0,1,0,2
56771,53,50189,53,166,86,80,2,30,1,1,0
56242,80,56242,80,101354,1343,100011,89,15,19,70,0
49891,53,34490,53,166,86,80,2,30,1,1,0
51430,25174,0,0,146,146,0,1,0,1,0,1
62705,445,0,0,70,70,0,1,0,1,0,2
50250,53,63565,53,178,94,84,2,31,1,1,0
59061,445,0,0,70,70,0,1,0,1,0,2
65364,53,50447,53,226,110,116,2,29,1,1,0
64742,445,0,0,66,66,0,1,0,1,0,2
58987,445,0,0,70,70,0,1,0,1,0,2
49738,443,60730,443,5572,1446,4126,17,129,10,7,0
32296,443,32296,443,5421,2444,2977,20,15,11,9,0
51091,80,6090,80,3324,663,2661,12,15,7,5,0
41047,443,9579,443,6423,744,5679,16,16,9,7,0
55068,53,59463,53,196,102,94,2,29,1,1,0
56980,53,33367,53,267,87,180,4,38,2,2,0
55463,445,0,0,70,70,0,1,0,1,0,2
64793,53,53457,53,184,94,90,2,30,1,1,0
57127,53,17390,53,193,102,91,2,31,1,1,0
56255,53,37256,53,701,88,613,2,31,1,1,0
51797,80,9284,80,1929,796,1133,21,135,11,10,0
54582,445,0,0,66,66,0,1,0,1,0,2
61523,37807,0,0,66,66,0,1,0,1,0,1
59403,443,13461,443,2866,1684,1182,16,15,8,8,0
44739,443,37697,443,6220,1790,4430,19,120,10,9,0
64613,53,11249,53,212,102,110,2,30,1,1,0
64651,445,0,0,66,66,0,1,0,1,0,2
63996,45759,55251,45759,66,66,0,2,8,2,0,0
55082,25174,0,0,66,66,0,1,0,1,0,1
27005,32056,3703,32056,886,126,760,2,30,1,1,0
47932,443,21603,443,9467,2741,6726,24,20,15,9,0
64546,53,39505,53,183,94,89,2,31,1,1,0
43227,443,35933,443,1139403,49178,1090225,1155,108,353,802,0
64171,53,42919,53,211,102,109,2,29,1,1,0
64375,445,0,0,66,66,0,1,0,1,0,2
37965,8999,11644,8999,402,132,270,6,1208,3,3,0
56493,80,12499,80,65864,3286,62578,76,135,30,46,0
45354,443,16907,443,81504,6111,75393,108,20,53,55,0
50734,443,16701,443,1726,668,1058,13,2033,4,9,0
50485,445,0,0,70,70,0,1,0,1,0,2
36538,64147,0,0,62,62,0,1,0,1,0,1
50666,80,35544,80,2937,1241,1696,12,22,7,5,0
64622,36829,0,0,66,66,0,1,0,1,0,1
53862,36120,51667,36120,2254,1281,973,17,17,10,7,0
58638,5900,58638,5900,160,66,94,2,9,1,1,0
49418,27015,55530,27015,244,78,166,2,30,1,1,0
43853,443,27275,443,6156,4764,1392,17,231,11,6,0
61433,443,18649,443,7796,766,7030,16,27,8,8,0
3478,61463,0,0,921,921,0,1,0,1,0,1
65464,443,36070,443,395647,11870,383777,409,16,144,265,0
62228,443,62228,443,296688,57600,239088,332,96,141,191,0
51325,445,0,0,66,66,0,1,0,1,0,2
50523,53,7142,53,168,86,82,2,31,1,1,0
56273,53,28560,53,183,94,89,2,30,1,1,0
64053,445,0,0,70,70,0,1,0,1,0,2
50516,80,41134,80,502,256,246,9,25,5,4,0
57602,445,0,0,70,70,0,1,0,1,0,2
53728,443,11260,443,499,425,74,4,0,3,1,0
50412,80,11804,80,22200,11865,10335,38,86,24,14,0
56771,53,26482,53,166,86,80,2,30,1,1,0
49686,445,0,0,70,70,0,1,0,1,0,2
42190,53,42190,53,639,86,553,2,31,1,1,0
64384,53,46498,53,350,94,256,2,30,1,1,0
57493,443,0,0,60,60,0,1,0,1,0,1
50767,80,50767,80,30767,854,29913,38,15,13,25,0
64284,445,0,0,70,70,0,1,0,1,0,2
49511,80,32515,80,1693924,34466,1659458,1627,230,522,1105,0
50289,445,0,0,66,66,0,1,0,1,0,2
32912,53,0,0,82,82,0,1,31,1,0,0
6881,6881,0,0,62,62,0,1,0,1,0,1
62592,443,27957,443,11741,7040,4701,40,172,22,18,0
62566,35993,0,0,62,62,0,1,0,1,0,1
56767,443,38617,443,7941,1952,5989,20,15,11,9,0
60016,443,40510,443,134,60,74,3,6,2,1,0
59972,443,22705,443,7152,1299,5853,22,16,12,10,0
55220,53,48038,53,193,102,91,2,31,1,1,0
54525,445,0,0,66,66,0,1,0,1,0,2
56268,443,24537,443,10226,4435,5791,50,256,24,26,0
3478,61463,0,0,822,822,0,1,0,1,0,1
49855,443,64909,443,28887,9850,19037,96,60,41,55,0
58549,445,0,0,70,70,0,1,0,1,0,2
53776,53,0,0,82,82,0,2,40,2,0,0
62278,445,0,0,70,70,0,1,0,1,0,2
62020,64147,0,0,145,145,0,1,0,1,0,1
6882,55839,0,0,146,146,0,1,0,1,0,1
64633,53,20577,53,255,102,153,2,30,1,1,0
41114,53,0,0,82,82,0,1,30,1,0,0
48706,23393,0,0,60,60,0,1,0,1,0,1
12465,11392,0,0,62,62,0,1,0,1,0,1
61838,37965,0,0,62,62,0,1,0,1,0,1
52162,443,20113,443,1461,924,537,13,31,7,6,0
55451,56205,0,0,66,66,0,1,0,1,0,1
54601,26467,0,0,62,62,0,1,0,1,0,1
62580,23,0,0,60,60,0,1,0,1,0,1
63585,443,56391,443,123421,11745,111676,267,125,108,159,0
50391,8080,50391,8080,1614,785,829,11,54,6,5,0
64524,53,53824,53,235,102,133,2,30,1,1,0
55048,53,59185,53,780,104,676,2,30,1,1,0
47809,53,47809,53,260,106,154,2,32,1,1,0
29203,26467,0,0,62,62,0,1,0,1,0,1
65451,53,43825,53,172,88,84,2,31,1,1,0
49418,27020,23482,27020,248,78,170,2,30,1,1,0
62084,445,0,0,70,70,0,1,0,1,0,2
56235,80,56235,80,44756,824,43932,45,15,12,33,0
60840,53,50587,53,255,86,169,2,31,1,1,0
64091,53,52948,53,172,88,84,2,30,1,1,0
56986,53,31308,53,177,94,83,2,29,1,1,0
10151,11888,57602,11888,491,150,341,2,1200,1,1,0
54195,443,37622,443,499,425,74,4,0,3,1,0
55445,53,54858,53,96,96,0,2,31,2,0,0
50678,80,40361,80,300,174,126,5,15,3,2,0
64810,53,44808,53,272,93,179,4,33,2,2,0
57197,445,0,0,70,70,0,1,0,1,0,2
16944,50584,0,0,146,146,0,1,0,1,0,1
37672,5223,15708,5223,110,110,0,1,5,1,0,0
57689,445,0,0,66,66,0,1,0,1,0,2
51104,443,47911,443,5220,3063,2157,14,135,7,7,0
53995,445,0,0,70,70,0,1,0,1,0,2
52635,443,48519,443,8993,5205,3788,48,167,25,23,0
50914,443,57800,443,22211,8661,13550,173,854,77,96,0
56209,445,0,0,70,70,0,1,0,1,0,2
49908,445,0,0,70,70,0,1,0,1,0,2
57044,445,0,0,66,66,0,1,0,1,0,2
10126,57470,0,0,62,62,0,1,0,1,0,1
38238,443,28773,443,33229,5348,27881,55,125,26,29,0
54060,445,0,0,66,66,0,1,0,1,0,2
49732,443,11249,443,592433,191668,400765,1555,1157,608,947,0
45493,5223,26430,5223,4196,1378,2818,21,3002,12,9,0
52332,445,0,0,70,70,0,1,0,1,0,2
50072,53,22723,53,779,86,693,2,30,1,1,0
54501,80,17667,80,254,128,126,5,16,3,2,0
65354,53,12903,53,168,86,82,2,30,1,1,0
33671,443,8770,443,12536,1564,10972,30,809,13,17,0
49036,44847,0,0,146,146,0,1,0,1,0,1
51919,80,35345,80,16004,8270,7734,32,57,17,15,0
17640,55442,0,0,66,66,0,1,0,1,0,1
56674,443,42391,443,7889,1900,5989,20,15,11,9,0
30861,46783,0,0,62,62,0,1,0,1,0,1
56380,36829,0,0,66,66,0,1,0,1,0,1
65469,53,34501,53,195,102,93,2,29,1,1,0
42558,64147,0,0,62,62,0,1,0,1,0,1
55757,53,56073,53,177,94,83,2,29,1,1,0
46774,51050,0,0,62,62,0,1,0,1,0,1
49787,53,40556,53,258,110,148,2,29,1,1,0
56272,53,13597,53,193,102,91,2,31,1,1,0
64628,53,57301,53,198,101,97,2,31,1,1,0
65397,445,0,0,70,70,0,1,0,1,0,2
53521,443,50004,443,130,70,60,2,15,1,1,0
19473,12430,61068,12430,491,150,341,2,1200,1,1,0
49911,445,0,0,66,66,0,1,0,1,0,2
18725,35440,0,0,62,62,0,1,0,1,0,1
64816,53,50363,53,166,86,80,2,30,1,1,0
37350,53,37350,53,213,87,126,2,30,1,1,0
0,0,0,0,320,320,0,5,0,5,0,0
49978,445,0,0,70,70,0,1,0,1,0,2
61291,53,61291,53,261,106,155,2,29,1,1,0
56943,80,45580,80,2817,2024,793,12,75,7,5,0
49998,53,44432,53,94,94,0,1,30,1,0,0
55311,53,15716,53,298,101,197,4,31,2,2,0
56899,443,29729,443,29904,3111,26793,68,164,35,33,0
44409,53,42084,53,199,94,105,2,30,1,1,0
62345,445,0,0,66,66,0,1,0,1,0,2
42117,80,40456,80,1056,682,374,10,15,6,4,0
60502,445,0,0,66,66,0,1,0,1,0,2
64790,53,64538,53,779,86,693,2,30,1,1,0
49540,53,53210,53,198,110,88,2,30,1,1,0
53431,445,0,0,70,70,0,1,0,1,0,2
36685,35440,0,0,62,62,0,1,0,1,0,1
27005,27222,42780,27222,890,126,764,2,30,1,1,0
37213,36237,0,0,66,66,0,1,0,1,0,1
49777,53,14014,53,166,86,80,2,30,1,1,0
58972,443,21151,443,5979,3487,2492,21,168,10,11,0
50532,445,0,0,66,66,0,1,0,1,0,2
50169,53,35420,53,223,78,145,2,30,1,1,0
53035,443,43721,443,3473,881,2592,13,121,6,7,0
60903,443,60903,443,3672,2294,1378,23,17,13,10,0
25849,53,25849,53,404,259,145,3,32,2,1,0
49482,53,59102,53,196,94,102,2,30,1,1,0
22571,51505,0,0,62,62,0,1,0,1,0,1
16319,44847,0,0,62,62,0,1,0,1,0,1
11295,40002,59394,40002,209,85,124,4,34,2,2,0
64220,445,0,0,66,66,0,1,0,1,0,2
56677,53,31185,53,767,102,665,2,31,1,1,0
52172,7353,21812,7353,70,70,0,1,5,1,0,0
53028,80,62533,80,70,70,0,1,5,1,0,0
49936,80,9467,80,1130,613,517,11,15,6,5,0
56304,53,62384,53,443,182,261,6,31,3,3,0
28878,51505,0,0,62,62,0,1,0,1,0,1
56572,53,56572,53,253,99,154,2,32,1,1,0
30179,57470,0,0,60,60,0,1,0,1,0,1
50523,443,11789,443,1579,988,591,13,45,7,6,0
52402,53,52402,53,212,98,114,2,30,1,1,0
61379,445,0,0,70,70,0,1,0,1,0,2
56434,53,56434,53,243,94,149,2,32,1,1,0
57670,80,41385,80,2274,1660,614,21,15,11,10,0
52021,445,0,0,66,66,0,1,0,1,0,2
65308,445,0,0,70,70,0,1,0,1,0,2
56151,445,0,0,70,70,0,1,0,1,0,2
64997,53,9569,53,164,84,80,2,31,1,1,0
55531,445,0,0,70,70,0,1,0,1,0,2
37558,16385,3655,16385,432,192,240,8,30,4,4,0
123,123,15177,123,184,94,90,2,30,1,1,0
65238,53,15919,53,168,86,82,2,31,1,1,0
58738,443,24230,443,12382,9652,2730,43,58,26,17,0
58727,443,14813,443,26922,13251,13671,50,18,26,24,0
4748,64147,0,0,62,62,0,1,0,1,0,1
24219,1900,0,0,60,60,0,1,0,1,0,1
51221,3054,33559,3054,870,330,540,12,1320,6,6,0
62236,445,0,0,66,66,0,1,0,1,0,2
49997,53,42386,53,264,102,162,2,30,1,1,0
32787,80,54491,80,1412,848,564,14,316,8,6,0
49789,53,65450,53,177,94,83,2,30,1,1,0
52065,80,16889,80,81670,2359,79311,89,621,30,59,0
56676,53,39365,53,178,94,84,2,31,1,1,0
56256,445,0,0,66,66,0,1,0,1,0,2
56615,53,39007,53,177,94,83,2,29,1,1,0
55759,5900,0,0,60,60,0,1,0,1,0,1
53685,38978,33015,38978,70,70,0,1,5,1,0,0
9087,53,9087,53,178,82,96,2,30,1,1,0
53729,40721,59100,40721,70,70,0,2,8,2,0,0
49450,53,42470,53,330,118,212,2,30,1,1,0
50979,445,0,0,66,66,0,1,0,1,0,2
45238,44847,0,0,62,62,0,1,0,1,0,1
37965,52608,29898,52608,1577,594,983,20,2766,10,10,0
58638,5900,0,0,62,62,0,1,0,1,0,1
11919,53,11919,53,213,79,134,2,32,1,1,0
3478,61463,0,0,982,982,0,1,0,1,0,1
65328,53,23014,53,179,94,85,2,30,1,1,0
43611,1879,0,0,145,145,0,1,0,1,0,1
64915,443,15491,443,4659604,120303,4539301,4651,74,1586,3065,0
59761,445,0,0,66,66,0,1,0,1,0,2
38755,22114,0,0,66,66,0,1,0,1,0,1
55007,443,13149,443,14030,7043,6987,32,123,18,14,0
35555,53,35555,53,194,87,107,2,30,1,1,0
46758,123,10814,123,184,94,90,2,30,1,1,0
56592,53,38145,53,200,102,98,2,30,1,1,0
9373,80,65080,80,1643,485,1158,10,15,5,5,0
58001,445,0,0,70,70,0,1,0,1,0,2
58754,53,0,0,258,80,178,2,30,1,1,0
35747,443,32307,443,8676,3499,5177,31,373,17,14,0
59741,443,12538,443,384,166,218,2,30,1,1,0
59365,42873,0,0,74,74,0,1,0,1,0,1
41593,53,64892,53,243,86,157,2,29,1,1,0
54432,445,0,0,70,70,0,1,0,1,0,2
50095,53,59595,53,250,86,164,4,30,2,2,0
58528,445,0,0,70,70,0,1,0,1,0,2
49392,80,13895,80,156587,46628,109959,307,314,203,104,0
64379,37965,0,0,66,66,0,1,0,1,0,1
55825,52700,0,0,66,66,0,1,0,1,0,1
51761,19136,25240,19136,70,70,0,1,5,1,0,0
55155,2767,0,0,62,62,0,1,0,1,0,1
59316,443,4398,443,17547,11857,5690,34,159,20,14,0
55603,32520,10079,32520,5982,1890,4092,30,75,15,15,0
56635,445,0,0,66,66,0,1,0,1,0,2
58476,443,24063,443,25370,5607,19763,40,138,18,22,0
59100,445,0,0,70,70,0,1,0,1,0,2
55808,53,62686,53,174,89,85,2,30,1,1,0
21322,25174,0,0,146,146,0,1,0,1,0,1
55390,53,32407,53,778,103,675,2,31,1,1,0
53922,42285,1496,42285,70,70,0,1,4,1,0,0
49321,53,65339,53,225,102,123,2,30,1,1,0
2434,443,2434,443,8209,1695,6514,21,23,13,8,0
58830,445,0,0,66,66,0,1,0,1,0,2
43163,443,21681,443,10100,3072,7028,25,16,14,11,0
49649,443,64805,443,5964,674,5290,16,60,7,9,0
64549,445,0,0,66,66,0,1,0,1,0,2
38685,443,17432,443,749731,23099,726632,823,16,326,497,0
39802,443,21011,443,3025,1958,1067,26,49,14,12,0
50640,443,7427,443,1533,950,583,14,85,8,6,0
443,50238,0,0,286,286,0,1,0,1,0,1
61403,445,0,0,66,66,0,1,0,1,0,2
51574,443,25990,443,3021,960,2061,14,135,7,7,0
17378,44847,0,0,66,66,0,1,0,1,0,1
59855,445,0,0,70,70,0,1,0,1,0,2
50483,445,0,0,66,66,0,1,0,1,0,2
10265,64147,0,0,62,62,0,1,0,1,0,1
14618,6881,0,0,66,66,0,1,0,1,0,1
57992,445,0,0,66,66,0,1,0,1,0,2
65075,53,31161,53,293,94,199,2,29,1,1,0
52907,445,0,0,70,70,0,1,0,1,0,2
50998,445,0,0,70,70,0,1,0,1,0,2
35340,443,44611,443,7470,1088,6382,21,27,12,9,0
51585,443,25112,443,2840,330,2510,12,135,5,7,0
39356,443,35388,443,7134,2290,4844,29,80,15,14,0
53715,62348,45392,62348,672,306,366,11,14,5,6,0
50864,53,14255,53,199,94,105,2,30,1,1,0
53109,41661,38343,41661,320,140,180,6,8,3,3,0
51480,445,0,0,66,66,0,1,0,1,0,2
35194,57470,0,0,74,74,0,1,0,1,0,1
64941,53,34820,53,295,101,194,4,31,2,2,0
58729,445,0,0,70,70,0,1,0,1,0,2
50655,80,4984,80,91198,3990,87208,113,19,49,64,0
26180,35440,0,0,62,62,0,1,0,1,0,1
63895,44847,0,0,62,62,0,1,0,1,0,1
28580,64147,0,0,62,62,0,1,0,1,0,1
58755,443,8030,443,11839,7753,4086,30,17,15,15,0
64495,443,32988,443,1786,172,1614,7,120,3,4,0
55126,53,61612,53,193,102,91,2,29,1,1,0
64811,53,25235,53,193,102,91,2,29,1,1,0
51755,445,0,0,70,70,0,1,0,1,0,2
51732,50934,0,0,146,146,0,1,0,1,0,1
56332,53,16709,53,209,110,99,2,30,1,1,0
56605,53,38242,53,341,110,231,2,30,1,1,0
25237,25174,0,0,146,146,0,1,0,1,0,1
6754,443,21695,443,13520,2288,11232,43,192,19,24,0
56357,445,0,0,70,70,0,1,0,1,0,2
57619,443,40662,443,9315,2153,7162,23,127,6,17,0
57377,443,4552,443,5553,927,4626,16,15,10,6,0
49905,443,37995,443,798502,33164,765338,927,103,379,548,0
56592,53,10104,53,200,102,98,2,31,1,1,0
33461,443,33205,443,8366,3900,4466,19,120,10,9,0
57257,445,0,0,70,70,0,1,0,1,0,2
61190,21247,0,0,66,66,0,1,0,1,0,1
50289,445,0,0,70,70,0,1,0,1,0,2
26742,53,26742,53,237,91,146,2,33,1,1,0
61150,445,0,0,66,66,0,1,0,1,0,2
49439,443,14852,443,9495,2281,7214,22,78,11,11,0
64823,53,7121,53,199,102,97,2,31,1,1,0
57211,53,8547,53,258,110,148,2,30,1,1,0
55669,53,15952,53,177,94,83,2,30,1,1,0
52490,53,52490,53,240,98,142,2,30,1,1,0
38664,37965,0,0,62,62,0,1,0,1,0,1
57470,51745,40205,51745,3214,1260,1954,33,1371,17,16,0
64751,445,0,0,66,66,0,1,0,1,0,2
39937,443,39937,443,4756,1849,2907,19,27,11,8,0
52026,80,21940,80,422,240,182,8,25,5,3,0
1663,30188,0,0,66,66,0,1,0,1,0,1
64021,53,54662,53,195,102,93,2,30,1,1,0
56837,53,27740,53,195,102,93,2,32,1,1,0
2918,37965,0,0,62,62,0,1,0,1,0,1
58705,80,29021,80,2543,1880,663,12,14,6,6,0
53644,58085,53471,58085,70,70,0,1,4,1,0,0
46849,36237,0,0,66,66,0,1,0,1,0,1
64586,53,31352,53,257,102,155,2,30,1,1,0
49410,53,12703,53,178,94,84,2,30,1,1,0
53246,443,31450,443,6066,1046,5020,20,69,11,9,0
62742,445,0,0,66,66,0,1,0,1,0,2
58431,443,11477,443,5771,3201,2570,22,161,10,12,0
56361,443,32525,443,3775,1791,1984,24,203,12,12,0
55082,445,0,0,66,66,0,1,0,1,0,2
27046,51505,0,0,66,66,0,1,0,1,0,1
52128,37807,0,0,62,62,0,1,0,1,0,1
55732,53,29178,53,177,94,83,2,30,1,1,0
50095,50584,0,0,62,62,0,1,0,1,0,1
51621,443,45721,443,5964,1007,4957,18,16,11,7,0
55635,53,55478,53,177,94,83,2,29,1,1,0
50408,7000,50408,7000,3132,815,2317,14,18,7,7,0
1100,27540,42086,27540,132,70,62,2,29,1,1,0
50914,51505,0,0,66,66,0,1,0,1,0,1
53521,443,20457,443,280,140,140,5,129,3,2,0
55618,56205,0,0,62,62,0,1,0,1,0,1
55216,445,0,0,70,70,0,1,0,1,0,2
53233,443,34879,443,6059,1040,5019,20,58,11,9,0
44847,51365,14892,51365,509,150,359,2,1200,1,1,0
64877,445,0,0,70,70,0,1,0,1,0,2
49301,443,5775,443,6550,1836,4714,25,46,15,10,0
50651,25174,0,0,62,62,0,1,0,1,0,1
53858,6889,25438,6889,372,186,186,6,16,3,3,0
52650,44847,0,0,66,66,0,1,0,1,0,1
26751,443,19482,443,11513,2842,8671,31,18,15,16,0
52003,80,22055,80,16479,1820,14659,31,26,17,14,0
49163,53,13314,53,167,86,81,2,29,1,1,0
49396,53,60623,53,216,102,114,2,30,1,1,0
45435,443,1325,443,8034,400,7634,14,193,2,12,0
27724,53,46943,53,322,84,238,4,29,2,2,0
36079,53,36079,53,235,90,145,2,32,1,1,0
27005,32038,32589,32038,868,126,742,2,31,1,1,0
55068,443,46144,443,5611,3720,1891,28,54,16,12,0
27005,28215,29356,28215,879,126,753,2,30,1,1,0
61338,445,0,0,70,70,0,1,0,1,0,2
62015,445,0,0,70,70,0,1,0,1,0,2
50564,443,64623,443,1894028,31411,1862617,1579,122,209,1370,0
49331,53,5900,53,182,94,88,2,31,1,1,0
57266,53,10699,53,753,96,657,2,31,1,1,0
36551,443,34195,443,8674,2101,6573,25,15,13,12,0
50584,6889,7914,6889,1326,300,1026,6,1200,3,3,0
59568,445,0,0,70,70,0,1,0,1,0,2
60438,17372,0,0,66,66,0,1,0,1,0,1
55337,53,17571,53,294,106,188,4,56,2,2,0
65181,445,0,0,70,70,0,1,0,1,0,2
51191,26467,0,0,66,66,0,1,0,1,0,1
50146,445,0,0,70,70,0,1,0,1,0,2
11382,43890,0,0,66,66,0,1,0,1,0,1
64158,53,28086,53,211,102,109,2,30,1,1,0
52792,445,0,0,70,70,0,1,0,1,0,2
50744,443,22315,443,6854,1380,5474,18,161,9,9,0
56119,46824,0,0,62,62,0,1,0,1,0,1
49902,443,13295,443,7456,1591,5865,32,54,15,17,0
59879,55783,0,0,66,66,0,1,0,1,0,1
56602,443,24699,443,27035,4207,22828,43,31,21,22,0
51951,65387,56923,65387,70,70,0,2,8,2,0,0
51422,3027,51422,3027,156,156,0,3,8,3,0,0
56126,53,5534,53,177,94,83,2,30,1,1,0
53459,37807,0,0,146,146,0,1,0,1,0,1
16387,23177,0,0,60,60,0,1,0,1,0,1
64462,53,6951,53,174,89,85,2,30,1,1,0
65011,53,37444,53,183,94,89,2,31,1,1,0
64895,53,23891,53,199,102,97,2,29,1,1,0
49288,443,26857,443,7332,2907,4425,50,122,22,28,0
56183,445,0,0,70,70,0,1,0,1,0,2
32071,51221,0,0,66,66,0,1,0,1,0,1
49976,22114,0,0,62,62,0,1,0,1,0,1
41313,53,41313,53,404,259,145,3,32,2,1,0
40204,40003,21367,40003,156,94,62,2,30,1,1,0
60797,28080,55300,28080,70,70,0,1,5,1,0,0
59219,445,0,0,70,70,0,1,0,1,0,2
53793,443,25367,443,499,425,74,4,0,3,1,0
49899,53,23402,53,718,94,624,2,30,1,1,0
56679,53,5371,53,216,102,114,2,30,1,1,0
8313,51505,0,0,62,62,0,1,0,1,0,1
55835,53,25257,53,180,94,86,2,30,1,1,0
27999,443,45047,443,5577,1390,4187,19,15,9,10,0
63752,445,0,0,70,70,0,1,0,1,0,2
58638,5900,0,0,62,62,0,1,0,1,0,1
49476,80,51976,80,5000,4058,942,15,15,8,7,0
50818,80,50818,80,514,246,268,9,42,5,4,0
64805,445,0,0,66,66,0,1,0,1,0,2
10909,30975,0,0,148,148,0,1,0,1,0,1
56853,53,24934,53,167,86,81,2,29,1,1,0
56533,53,11547,53,498,204,294,6,30,3,3,0
64989,50265,0,0,66,66,0,1,0,1,0,1
58057,445,0,0,66,66,0,1,0,1,0,2
61937,445,0,0,70,70,0,1,0,1,0,2
54966,443,5878,443,4645,2498,2147,14,135,7,7,0
55478,53,12055,53,170,87,83,2,31,1,1,0
49706,53,34052,53,296,102,194,4,41,2,2,0
27005,27015,22209,27015,1654,126,1528,4,30,2,2,0
32997,50584,0,0,62,62,0,1,0,1,0,1
56088,53,17141,53,774,101,673,2,30,1,1,0
57378,53,2616,53,756,95,661,2,31,1,1,0
57181,53,65198,53,733,93,640,2,31,1,1,0
41653,21247,0,0,62,62,0,1,0,1,0,1
6897,48817,0,0,139,139,0,1,0,1,0,1
48443,53,3585,53,168,78,90,2,30,1,1,0
56896,53,19605,53,256,87,169,2,30,1,1,0
56711,443,47786,443,8005,1985,6020,20,15,11,9,0
64706,443,64706,443,274,132,142,5,76,3,2,0
52036,445,0,0,70,70,0,1,0,1,0,2
56397,26467,0,0,62,62,0,1,0,1,0,1
9106,53,9106,53,227,89,138,2,30,1,1,0
33524,10387,0,0,159,159,0,1,0,1,0,1
49273,53,17508,53,342,110,232,2,30,1,1,0
57470,1031,51778,1031,402,132,270,6,1209,3,3,0
42630,443,10044,443,6039,1327,4712,19,121,11,8,0
60611,443,2263,443,478331,21023,457308,573,211,201,372,0
56740,443,56740,443,41851,2810,39041,66,45,31,35,0
63904,445,0,0,66,66,0,1,0,1,0,2
55037,443,19621,443,10640,3171,7469,28,45,15,13,0
53536,443,47086,443,7901,3483,4418,24,30,13,11,0
41093,53,34774,53,78,78,0,1,30,1,0,0
3478,61463,0,0,743,743,0,1,0,1,0,1
56495,80,7502,80,32396,2695,29701,46,135,22,24,0
28034,443,40574,443,5456,1388,4068,17,15,9,8,0
6889,55108,0,0,143,143,0,1,0,1,0,1
63384,53,63384,53,198,90,108,2,30,1,1,0
34419,443,53851,443,2713,1386,1327,18,316,10,8,0
60958,443,2953,443,1547,960,587,14,17,8,6,0
51073,80,13586,80,525373,237667,287706,1387,390,693,694,0
11761,443,11761,443,5626,2487,3139,23,29,14,9,0
52630,445,0,0,70,70,0,1,0,1,0,2
60146,53,47250,53,218,78,140,2,30,1,1,0
64877,37450,0,0,66,66,0,1,0,1,0,1
44674,25174,0,0,146,146,0,1,0,1,0,1
65170,53,60576,53,771,102,669,2,30,1,1,0
56767,53,17852,53,170,87,83,2,31,1,1,0
45964,2666,0,0,60,60,0,1,0,1,0,1
65524,53,59878,53,183,94,89,2,30,1,1,0
54132,445,0,0,70,70,0,1,0,1,0,2
52054,80,49202,80,1682,642,1040,13,54,4,9,0
39054,53,31083,53,168,78,90,2,30,1,1,0
49577,57470,0,0,66,66,0,1,0,1,0,1
49690,53,14782,53,790,110,680,2,29,1,1,0
7744,32480,0,0,62,62,0,1,0,1,0,1
51775,57887,60310,57887,70,70,0,2,8,2,0,0
47903,443,31427,443,9323,2192,7131,25,25,13,12,0
49938,57470,0,0,62,62,0,1,0,1,0,1
33289,50584,0,0,62,62,0,1,0,1,0,1
37662,2323,0,0,60,60,0,1,0,1,0,1
57557,64147,0,0,66,66,0,1,0,1,0,1
55865,53,64490,53,168,86,82,2,30,1,1,0
56663,53,28501,53,215,102,113,2,30,1,1,0
27995,22114,0,0,62,62,0,1,0,1,0,1
50584,51413,31327,51413,498,150,348,4,2396,2,2,0
52221,33166,34754,33166,70,70,0,2,8,2,0,0
443,60496,0,0,60,60,0,1,0,1,0,1
50077,443,29789,443,8172,1833,6339,25,93,14,11,0
41207,80,55374,80,79441,3092,76349,103,16,48,55,0
56622,53,41480,53,179,94,85,2,31,1,1,0
49690,53,35001,53,216,110,106,2,30,1,1,0
3478,61463,0,0,1097,1097,0,1,0,1,0,1
57275,53,57275,53,217,86,131,2,30,1,1,0
65025,57866,0,0,66,66,0,1,0,1,0,1
49320,53,59903,53,177,94,83,2,30,1,1,0
52070,55946,25301,55946,316,136,180,6,7,3,3,0
61645,445,0,0,66,66,0,1,0,1,0,2
58638,5900,0,0,62,62,0,1,0,1,0,1
57347,443,40026,443,3889,1296,2593,11,120,6,5,0
64763,445,0,0,66,66,0,1,0,1,0,2
10031,443,14432,443,34551,3731,30820,54,112,23,31,0
59513,53,0,0,82,82,0,1,31,1,0,0
36406,443,50079,443,1149,709,440,13,38,8,5,0
55567,445,0,0,66,66,0,1,0,1,0,2
53863,8999,11307,8999,70,70,0,2,7,2,0,0
49950,80,54747,80,3991,620,3371,14,15,7,7,0
39488,53,45099,53,199,94,105,2,29,1,1,0
58125,445,0,0,70,70,0,1,0,1,0,2
49168,53,10918,53,192,98,94,2,31,1,1,0
43916,21,0,0,60,60,0,1,0,1,0,1
53779,37965,0,0,66,66,0,1,0,1,0,1
6666,5000,0,0,60,60,0,1,0,1,0,1
41543,443,50786,443,78,78,0,1,5,1,0,0
65175,53,9313,53,778,103,675,2,30,1,1,0
63970,53,19074,53,228,110,118,2,30,1,1,0
50864,80,3838,80,1888,1814,74,10,15,9,1,0
46287,443,19273,443,7071,2628,4443,32,23,16,16,0
27811,57866,0,0,146,146,0,1,0,1,0,1
40626,443,40626,443,7772,2569,5203,23,148,13,10,0
61550,5529,0,0,145,145,0,1,0,1,0,1
52544,445,0,0,70,70,0,1,0,1,0,2
58955,80,51848,80,3037,2276,761,12,28,7,5,0
59481,445,0,0,70,70,0,1,0,1,0,2
62765,16933,0,0,66,66,0,1,0,1,0,1
63779,26467,0,0,62,62,0,1,0,1,0,1
61418,80,59402,80,31954,2972,28982,71,138,36,35,0
64992,53,56297,53,177,94,83,2,30,1,1,0
58638,5900,58638,5900,160,66,94,2,9,1,1,0
53801,445,0,0,70,70,0,1,0,1,0,2
53110,8830,57205,8830,70,70,0,1,5,1,0,0
18683,26467,0,0,62,62,0,1,0,1,0,1
60033,443,16938,443,2845,1765,1080,15,142,8,7,0
25565,55690,0,0,60,60,0,1,0,1,0,1
52447,443,48925,443,7980,5952,2028,22,99,12,10,0
64425,53,6282,53,182,86,96,2,29,1,1,0
37991,49152,57920,49152,156,156,0,3,7,3,0,0
65179,53,63378,53,184,94,90,2,31,1,1,0
60413,443,19866,443,9398,2320,7078,24,77,13,11,0
48608,443,46175,443,6371,848,5523,20,16,11,9,0
58599,445,0,0,66,66,0,1,0,1,0,2
33774,443,40240,443,9551,2173,7378,33,27,17,16,0
51001,445,0,0,70,70,0,1,0,1,0,2
46491,50584,0,0,66,66,0,1,0,1,0,1
6881,50239,58874,50239,3514,1874,1640,15,1200,8,7,0
64939,445,0,0,70,70,0,1,0,1,0,2
63993,53,47498,53,338,110,228,2,31,1,1,0
55984,445,0,0,70,70,0,1,0,1,0,2
59192,445,0,0,66,66,0,1,0,1,0,2
49994,26467,0,0,66,66,0,1,0,1,0,1
49916,443,14101,443,2970,1793,1177,20,15,12,8,0
59377,9319,0,0,62,62,0,1,0,1,0,1
53539,6881,61115,6881,492,306,186,8,14,5,3,0
53746,445,0,0,70,70,0,1,0,1,0,2
61744,11392,0,0,66,66,0,1,0,1,0,1
49898,443,38870,443,8191,2343,5848,33,394,11,22,0
53772,443,49684,443,499,425,74,4,0,3,1,0
64974,53,53114,53,214,110,104,2,30,1,1,0
63050,57470,0,0,74,74,0,1,0,1,0,1
61191,445,0,0,66,66,0,1,0,1,0,2
6882,8999,49067,8999,238,118,120,2,1200,1,1,0
52177,443,57914,443,7659,3234,4425,35,288,17,18,0
55664,53,23659,53,177,94,83,2,30,1,1,0
30960,45722,27416,45722,396,396,0,7,3616,7,0,0
61368,445,0,0,70,70,0,1,0,1,0,2
64106,445,0,0,66,66,0,1,0,1,0,2
62725,51221,0,0,66,66,0,1,0,1,0,1
60184,443,52371,443,26293,7740,18553,55,121,26,29,0
61916,445,0,0,66,66,0,1,0,1,0,2
49841,443,32376,443,7084,1611,5473,29,71,15,14,0
1323,64147,0,0,66,66,0,1,0,1,0,1
53722,443,28671,443,70,70,0,1,5,1,0,0
53671,60416,42593,60416,70,70,0,2,7,2,0,0
55100,53,1559,53,178,94,84,2,30,1,1,0
58976,43890,0,0,66,66,0,1,0,1,0,1
62068,80,36797,80,2806,626,2180,12,15,6,6,0
53942,28921,35066,28921,320,140,180,6,6,3,3,0
64938,445,0,0,66,66,0,1,0,1,0,2
38211,123,28193,123,184,94,90,2,29,1,1,0
60196,53,0,0,88,88,0,1,0,1,0,1
57871,445,0,0,70,70,0,1,0,1,0,2
63834,27037,35809,27037,1130,924,206,5,30,3,2,0
47132,1433,0,0,60,60,0,1,0,1,0,1
55708,8060,17338,8060,70,70,0,1,5,1,0,0
58734,443,48413,443,1413,876,537,12,26,6,6,0
59718,445,0,0,66,66,0,1,0,1,0,2
26698,57470,0,0,62,62,0,1,0,1,0,1
53166,445,0,0,70,70,0,1,0,1,0,2
60491,38789,32066,38789,320,140,180,6,7,3,3,0
13654,50584,0,0,62,62,0,1,0,1,0,1
2904,44847,0,0,78,78,0,1,0,1,0,1
51602,22114,0,0,66,66,0,1,0,1,0,1
59830,443,59830,443,21205,1711,19494,32,1806,11,21,0
56855,53,37174,53,775,103,672,2,31,1,1,0
51117,80,26474,80,5040,3914,1126,19,32,12,7,0
57425,53,32563,53,168,86,82,2,30,1,1,0
57346,53,18432,53,210,110,100,2,29,1,1,0
49983,53,51189,53,749,89,660,2,30,1,1,0
53235,443,53235,443,1270,697,573,15,33,8,7,0
49001,48983,0,0,161,161,0,1,0,1,0,1
57156,445,0,0,66,66,0,1,0,1,0,2
58372,445,0,0,66,66,0,1,0,1,0,2
57026,445,0,0,70,70,0,1,0,1,0,2
64395,445,0,0,70,70,0,1,0,1,0,2
53460,443,49234,443,6118,5698,420,12,124,6,6,0
63957,80,57502,80,314,192,122,6,15,4,2,0
58427,5223,31205,5223,13841,6601,7240,42,622,19,23,0
54428,445,0,0,70,70,0,1,0,1,0,2
53437,44847,0,0,66,66,0,1,0,1,0,1
51652,445,0,0,70,70,0,1,0,1,0,2
54142,20541,0,0,66,66,0,1,0,1,0,1
50374,443,56948,443,5359,705,4654,15,25,8,7,0
59940,50584,0,0,62,62,0,1,0,1,0,1
58253,445,0,0,70,70,0,1,0,1,0,2
31227,53,31227,53,407,261,146,3,32,2,1,0
0,0,0,0,98,98,0,1,0,1,0,1
65245,53,50630,53,193,102,91,2,30,1,1,0
13287,16933,0,0,62,62,0,1,0,1,0,1
443,48120,0,0,97,97,0,1,0,1,0,1
51788,35787,52462,35787,70,70,0,2,8,2,0,0
50292,22114,0,0,66,66,0,1,0,1,0,1
50467,53,38713,53,758,93,665,2,31,1,1,0
27110,22114,0,0,60,60,0,1,0,1,0,1
65008,53,8162,53,312,94,218,2,30,1,1,0
6666,16010,0,0,60,60,0,1,0,1,0,1
50629,53,6662,53,756,94,662,2,30,1,1,0
55817,53,30944,53,392,102,290,2,30,1,1,0
55806,53,53227,53,200,102,98,2,30,1,1,0
53716,6881,32283,6881,70,70,0,1,4,1,0,0
65078,53,50659,53,177,94,83,2,30,1,1,0
64033,29834,57709,29834,66,66,0,2,8,2,0,0
53809,443,5069,443,499,425,74,4,0,3,1,0
57955,44847,0,0,62,62,0,1,0,1,0,1
0,0,0,0,480,244,236,4,0,2,2,0
40657,443,5933,443,9869,2395,7474,36,129,20,16,0
40216,50265,0,0,62,62,0,1,0,1,0,1
49169,443,62824,443,11168,3827,7341,42,16,20,22,0
60883,64147,0,0,74,74,0,1,0,1,0,1
63545,25174,0,0,66,66,0,1,0,1,0,1
48343,443,59139,443,1985333,91427,1893906,2159,190,721,1438,0
59097,2767,0,0,66,66,0,1,0,1,0,1
53722,443,52101,443,327838,13327,314511,355,127,121,234,0
32090,43890,0,0,146,146,0,1,0,1,0,1
57470,16721,16664,16721,163,163,0,1,1200,1,0,0
55100,445,0,0,70,70,0,1,0,1,0,2
49313,443,5265,443,3185,2263,922,18,25,9,9,0
65344,46824,0,0,66,66,0,1,0,1,0,1
2267,53,42274,53,204,118,86,2,31,1,1,0
61477,443,48304,443,30516,3311,27205,49,47,25,24,0
37569,443,62678,443,214,140,74,4,15,3,1,0
55179,53,2667,53,178,94,84,2,31,1,1,0
58228,53733,0,0,66,66,0,1,0,1,0,1
51888,42529,42090,42529,316,136,180,6,6,3,3,0
56683,443,56683,443,4533,1626,2907,19,28,11,8,0
50560,53,62139,53,755,94,661,2,30,1,1,0
64012,40642,7765,40642,70,70,0,1,5,1,0,0
55570,44847,0,0,66,66,0,1,0,1,0,1
9297,443,46735,443,4216,771,3445,16,26,9,7,0
61308,443,22375,443,44341,5858,38483,102,195,42,60,0
65279,53,28048,53,183,94,89,2,31,1,1,0
34244,80,38249,80,656,398,258,11,39,7,4,0
49861,80,57112,80,4892,1157,3735,16,89,8,8,0
15677,64147,0,0,145,145,0,1,0,1,0,1
5357,32468,0,0,66,66,0,1,0,1,0,1
46209,443,22477,443,4900,2781,2119,25,95,13,12,0
50236,25174,0,0,66,66,0,1,0,1,0,1
57580,443,3612,443,4049,1992,2057,23,96,13,10,0
58805,443,25945,443,32148,21507,10641,72,21,42,30,0
33383,443,13969,443,24440,2215,22225,46,316,20,26,0
17534,50584,0,0,146,146,0,1,0,1,0,1
61437,445,0,0,70,70,0,1,0,1,0,2
54963,53,30866,53,210,110,100,2,30,1,1,0
64873,53,26833,53,380,110,270,2,30,1,1,0
59402,53,5852,53,203,86,117,2,30,1,1,0
60781,40010,23139,40010,316,136,180,6,5,3,3,0
55237,53,28991,53,193,102,91,2,30,1,1,0
59326,80,59326,80,109128,4773,104355,197,16,68,129,0
40521,23117,0,0,66,66,0,1,0,1,0,1
57067,53,57189,53,182,93,89,2,30,1,1,0
56954,445,0,0,70,70,0,1,0,1,0,2
52866,80,44619,80,6022,2590,3432,37,131,20,17,0
9226,57470,0,0,66,66,0,1,0,1,0,1
64756,53,24462,53,757,98,659,2,30,1,1,0
2422,62507,0,0,66,66,0,1,0,1,0,1
55695,53,46724,53,209,102,107,2,30,1,1,0
51648,445,0,0,70,70,0,1,0,1,0,2
63822,14382,38807,14382,70,70,0,1,4,1,0,0
27300,36237,0,0,146,146,0,1,0,1,0,1
63042,445,0,0,70,70,0,1,0,1,0,2
53258,445,0,0,66,66,0,1,0,1,0,2
55707,53,50329,53,177,94,83,2,29,1,1,0
28570,25174,0,0,146,146,0,1,0,1,0,1
59692,443,65414,443,6129,3123,3006,12,120,7,5,0
61345,21247,0,0,66,66,0,1,0,1,0,1
49761,445,0,0,70,70,0,1,0,1,0,2
50179,443,33699,443,5419,1080,4339,17,42,10,7,0
50066,445,0,0,70,70,0,1,0,1,0,2
52018,2425,48269,2425,70,70,0,1,5,1,0,0
60774,443,14767,443,29739,1164,28575,40,120,15,25,0
46984,443,45323,443,416,210,206,7,35,4,3,0
58322,53,48798,53,320,94,226,2,30,1,1,0
60428,25174,0,0,66,66,0,1,0,1,0,1
50299,80,31739,80,2316,1206,1110,16,81,9,7,0
50949,45960,0,0,62,62,0,1,0,1,0,1
12183,22114,0,0,62,62,0,1,0,1,0,1
56362,53,49455,53,195,102,93,2,30,1,1,0
63697,25010,4091,25010,504,382,122,8,16,6,2,0
52513,80,64881,80,39793,2026,37767,55,16,27,28,0
62991,51221,0,0,66,66,0,1,0,1,0,1
57432,53,52576,53,186,95,91,2,31,1,1,0
63786,35440,0,0,66,66,0,1,0,1,0,1
63599,443,32617,443,10050,1802,8248,30,39,16,14,0
58771,53,46484,53,168,78,90,2,30,1,1,0
15561,53,15561,53,199,90,109,2,30,1,1,0
443,2629,0,0,135,135,0,1,0,1,0,1
51978,57496,25018,57496,70,70,0,2,8,2,0,0
59628,445,0,0,70,70,0,1,0,1,0,2
51756,41471,58464,41471,70,70,0,1,5,1,0,0
53115,445,0,0,66,66,0,1,0,1,0,2
55809,53,62877,53,731,85,646,2,31,1,1,0
7881,48817,0,0,133,133,0,1,0,1,0,1
51444,3027,51444,3027,156,156,0,3,8,3,0,0
58643,443,8549,443,4801,2506,2295,12,121,6,6,0
37902,23718,0,0,62,62,0,1,0,1,0,1
51091,80,22433,80,4033,2712,1321,35,130,19,16,0
9317,443,63611,443,5687,499,5188,14,16,7,7,0
50552,80,61160,80,2367,1240,1127,10,16,5,5,0
1024,57470,0,0,62,62,0,1,0,1,0,1
49529,21247,0,0,62,62,0,1,0,1,0,1
56528,445,0,0,70,70,0,1,0,1,0,2
57415,445,0,0,70,70,0,1,0,1,0,2
21534,42246,0,0,66,66,0,1,0,1,0,1
30765,56205,0,0,66,66,0,1,0,1,0,1
53048,445,0,0,70,70,0,1,0,1,0,2
54351,53,59901,53,168,78,90,2,29,1,1,0
64908,53,50064,53,812,110,702,2,30,1,1,0
56939,53,50675,53,216,110,106,2,31,1,1,0
9227,443,31374,443,5146,960,4186,17,25,9,8,0
56662,80,65360,80,234,234,0,4,12,4,0,0
50754,445,0,0,70,70,0,1,0,1,0,2
53495,445,0,0,70,70,0,1,0,1,0,2
32804,80,61447,80,7454,2436,5018,26,23,16,10,0
62155,53,41278,53,263,86,177,2,29,1,1,0
55497,445,0,0,66,66,0,1,0,1,0,2
65331,53,20706,53,767,102,665,2,29,1,1,0
55749,445,0,0,66,66,0,1,0,1,0,2
54439,443,63339,443,44294,9390,34904,167,319,83,84,0
57482,445,0,0,70,70,0,1,0,1,0,2
49708,53,5780,53,172,88,84,2,31,1,1,0
65359,53,29324,53,186,95,91,2,30,1,1,0
3290,57470,0,0,145,145,0,1,0,1,0,1
51026,37450,0,0,66,66,0,1,0,1,0,1
51998,445,0,0,70,70,0,1,0,1,0,2
62141,445,0,0,66,66,0,1,0,1,0,2
59374,51505,0,0,62,62,0,1,0,1,0,1
57039,445,0,0,70,70,0,1,0,1,0,2
49938,57470,0,0,66,66,0,1,0,1,0,1
50265,18183,50480,18183,966,464,502,14,1200,7,7,0
56440,53,62063,53,212,102,110,2,30,1,1,0
64704,53,49716,53,213,102,111,2,29,1,1,0
49296,443,51414,443,7419,2173,5246,17,16,9,8,0
59404,443,10904,443,2962,1844,1118,16,15,8,8,0
51531,443,29173,443,898,460,438,12,39,5,7,0
49633,53,37557,53,210,102,108,2,30,1,1,0
49658,53,46008,53,195,102,93,2,29,1,1,0
46837,57470,0,0,62,62,0,1,0,1,0,1
16012,53,16012,53,235,90,145,2,32,1,1,0
43129,15503,0,0,62,62,0,1,0,1,0,1
65300,53,36602,53,758,102,656,2,30,1,1,0
55065,53,19490,53,711,87,624,2,30,1,1,0
21432,53,21432,53,244,98,146,2,32,1,1,0
55829,53,4732,53,208,106,102,2,31,1,1,0
51758,31009,36831,31009,70,70,0,2,8,2,0,0
46456,443,58612,443,4921,2134,2787,21,95,10,11,0
56103,21247,0,0,66,66,0,1,0,1,0,1
56733,443,4067,443,7941,1952,5989,20,15,11,9,0
61158,445,0,0,70,70,0,1,0,1,0,2
55760,53,35277,53,182,94,88,2,31,1,1,0
49302,443,39111,443,454,262,192,8,27,5,3,0
51271,37965,0,0,66,66,0,1,0,1,0,1
7210,22114,0,0,66,66,0,1,0,1,0,1
34257,7275,41230,7275,2845,419,2426,12,15,7,5,0
33108,22,33108,22,7930,3351,4579,56,38,27,29,0
52933,443,12830,443,3517,993,2524,12,120,6,6,0
63966,445,0,0,70,70,0,1,0,1,0,2
63134,445,0,0,70,70,0,1,0,1,0,2
50730,445,0,0,66,66,0,1,0,1,0,2
64784,53,28832,53,195,102,93,2,29,1,1,0
2941,7000,2941,7000,3398,947,2451,18,27,9,9,0
33507,443,18740,443,194174,11657,182517,258,31,124,134,0
35722,30188,0,0,62,62,0,1,0,1,0,1
51522,445,0,0,66,66,0,1,0,1,0,2
54687,445,0,0,66,66,0,1,0,1,0,2
60711,443,38043,443,12258,1451,10807,27,360,13,14,0
39393,22114,0,0,146,146,0,1,0,1,0,1
57134,53,50387,53,1425,97,1328,4,53,2,2,0
60650,445,0,0,70,70,0,1,0,1,0,2
53128,443,20598,443,14603,4208,10395,39,48,20,19,0
63310,445,0,0,70,70,0,1,0,1,0,2
50327,1433,0,0,60,60,0,1,0,1,0,1
53912,3478,54737,3478,3532,1792,1740,58,88,29,29,0
49501,443,9020,443,15456,2581,12875,28,31,10,18,0
51244,443,19950,443,8024,2572,5452,39,15,23,16,0
16387,64660,0,0,60,60,0,1,0,1,0,1
64219,51050,0,0,66,66,0,1,0,1,0,1
13235,44847,0,0,66,66,0,1,0,1,0,1
63066,443,9445,443,448,166,282,2,30,1,1,0
58068,445,0,0,66,66,0,1,0,1,0,2
51234,443,8944,443,31736,1463,30273,43,32,14,29,0
50615,53,31516,53,785,110,675,2,30,1,1,0
59637,445,0,0,70,70,0,1,0,1,0,2
24236,26296,0,0,148,148,0,1,0,1,0,1
48817,27003,48817,27003,839,296,543,4,1200,2,2,0
44203,8055,0,0,159,159,0,1,0,1,0,1
37611,443,31494,443,3936,1618,2318,26,146,14,12,0
27005,27013,56795,27013,879,126,753,2,30,1,1,0
18683,26467,0,0,62,62,0,1,0,1,0,1
55958,53,60321,53,170,87,83,2,31,1,1,0
13285,29892,0,0,145,145,0,1,0,1,0,1
50052,65008,0,0,60,60,0,1,0,1,0,1
51913,80,58997,80,366,240,126,7,29,5,2,0
55183,53,52172,53,177,94,83,2,30,1,1,0
43063,57470,0,0,62,62,0,1,0,1,0,1
49201,17852,10581,17852,66,66,0,1,5,1,0,0
46730,443,28358,443,7648,1671,5977,25,31,13,12,0
54047,50011,0,0,66,66,0,1,0,1,0,1
45941,23386,0,0,60,60,0,1,0,1,0,1
50575,443,24477,443,5197,3181,2016,50,261,26,24,0
51547,443,55970,443,642,582,60,2,5,1,1,0
56611,53,8939,53,91,91,0,1,30,1,0,0
56357,53,8894,53,168,86,82,2,30,1,1,0
61660,64097,0,0,62,62,0,1,0,1,0,1
35190,80,55473,80,130,70,60,2,14,1,1,0
52462,445,0,0,70,70,0,1,0,1,0,2
58575,445,0,0,70,70,0,1,0,1,0,2
56579,443,24024,443,23150,13858,9292,52,49,32,20,0
63334,37807,0,0,66,66,0,1,0,1,0,1
50837,445,0,0,66,66,0,1,0,1,0,2
56429,443,9683,443,355939,9284,346655,365,121,125,240,0
61045,445,0,0,70,70,0,1,0,1,0,2
55358,445,0,0,70,70,0,1,0,1,0,2
6881,6881,5588,6881,324,150,174,2,1203,1,1,0
13985,34159,0,0,66,66,0,1,0,1,0,1
35797,53,35797,53,217,90,127,2,30,1,1,0
27005,27018,3011,27018,882,126,756,2,30,1,1,0
42731,443,42301,443,6131,1399,4732,20,983,10,10,0
62054,443,20146,443,10596,3874,6722,30,62,17,13,0
49501,53,63385,53,193,102,91,2,31,1,1,0
60192,53,4239,53,236,94,142,2,30,1,1,0
65024,53,20074,53,199,102,97,2,30,1,1,0
53015,64147,0,0,62,62,0,1,0,1,0,1
56603,53,47573,53,168,86,82,2,29,1,1,0
62914,445,0,0,70,70,0,1,0,1,0,2
50033,53,63649,53,533,184,349,6,76,3,3,0
62058,443,34202,443,8666,2933,5733,46,15,27,19,0
9479,443,13111,443,6100,777,5323,17,25,9,8,0
60239,23,0,0,60,60,0,1,0,1,0,1
55652,443,58286,443,6672,2258,4414,19,16,10,9,0
52461,443,54450,443,16541,4900,11641,62,131,26,36,0
36841,443,46092,443,7293,1544,5749,22,256,11,11,0
37567,443,40594,443,149229,139639,9590,226,256,124,102,0
59699,55783,0,0,62,62,0,1,0,1,0,1
52083,26607,11051,26607,70,70,0,2,7,2,0,0
53713,443,37609,443,4931,957,3974,17,15,10,7,0
40865,8100,38607,8100,234,234,0,4,11,4,0,0
35414,53,44913,53,168,78,90,2,30,1,1,0
57320,53,17715,53,802,104,698,2,30,1,1,0
57594,443,55656,443,614577,24675,589902,673,149,228,445,0
48706,23393,0,0,60,60,0,1,0,1,0,1
60052,37965,0,0,66,66,0,1,0,1,0,1
64934,53,46124,53,194,99,95,2,31,1,1,0
51985,38904,1159,38904,70,70,0,1,5,1,0,0
16721,22114,0,0,146,146,0,1,0,1,0,1
65229,53,52095,53,193,102,91,2,30,1,1,0
64101,445,0,0,66,66,0,1,0,1,0,2
58445,445,0,0,70,70,0,1,0,1,0,2
55230,445,0,0,70,70,0,1,0,1,0,2
3478,61463,0,0,1012,1012,0,1,0,1,0,1
55828,53,3503,53,178,91,87,2,30,1,1,0
36908,26467,0,0,62,62,0,1,0,1,0,1
46842,25174,0,0,146,146,0,1,0,1,0,1
56547,445,0,0,70,70,0,1,0,1,0,2
52715,443,11256,443,26901,2286,24615,46,319,18,28,0
50584,8999,18180,8999,1356,300,1056,6,1200,3,3,0
64073,53,37819,53,520,211,309,6,39,3,3,0
45767,50584,0,0,146,146,0,1,0,1,0,1
59872,443,27152,443,6239,800,5439,18,32,8,10,0
64610,53,2406,53,292,102,190,2,30,1,1,0
53577,35894,0,0,66,66,0,1,0,1,0,1
55946,443,34803,443,9274,5282,3992,42,186,22,20,0
46670,51505,0,0,62,62,0,1,0,1,0,1
49001,48983,0,0,161,161,0,1,0,1,0,1
57468,57470,0,0,66,66,0,1,0,1,0,1
37034,25174,0,0,146,146,0,1,0,1,0,1
62433,445,0,0,70,70,0,1,0,1,0,2
49393,30188,0,0,66,66,0,1,0,1,0,1
53015,64147,0,0,62,62,0,1,0,1,0,1
52640,6881,33244,6881,719,413,306,10,14,5,5,0
55651,53,8251,53,199,102,97,2,29,1,1,0
60423,52001,49584,52001,260,140,120,5,9,3,2,0
51607,53,31669,53,284,86,198,2,30,1,1,0
8976,44847,0,0,62,62,0,1,0,1,0,1
49677,64147,0,0,62,62,0,1,0,1,0,1
11835,53,11835,53,216,88,128,2,31,1,1,0
57795,445,0,0,66,66,0,1,0,1,0,2
27005,27126,47087,27126,636020,187240,448780,2701,104,1538,1163,0
55057,53,26203,53,211,110,101,2,30,1,1,0
52865,443,62658,443,120290,2988,117302,123,132,32,91,0
56098,64147,0,0,66,66,0,1,0,1,0,1
57366,445,0,0,70,70,0,1,0,1,0,2
56898,445,0,0,70,70,0,1,0,1,0,2
50570,80,64078,80,318,192,126,6,26,4,2,0
64811,53,22274,53,195,102,93,2,29,1,1,0
23589,53,23589,53,220,90,130,2,30,1,1,0
56475,80,2240,80,36057,2080,33977,45,134,19,26,0
49862,53,62626,53,744,89,655,2,31,1,1,0
49747,53,62194,53,355,102,253,2,30,1,1,0
57664,443,45877,443,5111,2193,2918,19,120,9,10,0
54526,445,0,0,70,70,0,1,0,1,0,2
55502,53,12440,53,817,102,715,2,30,1,1,0
51444,445,0,0,66,66,0,1,0,1,0,2
1534,54369,0,0,66,66,0,1,0,1,0,1
59477,36829,0,0,62,62,0,1,0,1,0,1
59465,445,0,0,70,70,0,1,0,1,0,2
56708,443,38081,443,9634,3110,6524,26,138,11,15,0
45682,47993,0,0,62,62,0,1,0,1,0,1
65404,36237,0,0,62,62,0,1,0,1,0,1
53955,3290,40369,3290,70,70,0,2,7,2,0,0
50386,445,0,0,70,70,0,1,0,1,0,2
19875,30170,0,0,145,145,0,1,0,1,0,1
50939,80,16478,80,1375,1038,337,7,137,4,3,0
64045,445,0,0,70,70,0,1,0,1,0,2
52079,445,0,0,70,70,0,1,0,1,0,2
57625,443,18316,443,4751,909,3842,15,16,9,6,0
54636,443,3394,443,311000,8576,302424,319,175,103,216,0
53428,445,0,0,66,66,0,1,0,1,0,2
14263,22114,0,0,62,62,0,1,0,1,0,1
51830,32787,57258,32787,70,70,0,1,5,1,0,0
64040,12226,50739,12226,70,70,0,1,4,1,0,0
50557,80,9717,80,318,192,126,6,26,4,2,0
55544,3389,55544,3389,3657,1638,2019,20,18,11,9,0
61382,25174,0,0,66,66,0,1,0,1,0,1
55580,445,0,0,70,70,0,1,0,1,0,2
34902,443,35566,443,70,70,0,1,5,1,0,0
59734,443,60915,443,512,166,346,2,29,1,1,0
26531,37965,0,0,62,62,0,1,0,1,0,1
44821,64147,0,0,62,62,0,1,0,1,0,1
58341,10197,0,0,78,78,0,1,0,1,0,1
56100,445,0,0,70,70,0,1,0,1,0,2
51553,445,0,0,70,70,0,1,0,1,0,2
18086,25174,0,0,62,62,0,1,0,1,0,1
49973,53,27114,53,261,94,167,2,30,1,1,0
56261,53,65402,53,199,94,105,2,30,1,1,0
54605,445,0,0,66,66,0,1,0,1,0,2
58745,30188,0,0,66,66,0,1,0,1,0,1
50067,64147,0,0,62,62,0,1,0,1,0,1
58721,51505,0,0,66,66,0,1,0,1,0,1
52841,445,0,0,70,70,0,1,0,1,0,2
63332,445,0,0,70,70,0,1,0,1,0,2
5588,5588,0,0,3562,1936,1626,48,195,24,24,0
8999,57470,0,0,146,146,0,1,0,1,0,1
62615,445,0,0,70,70,0,1,0,1,0,2
56060,53,26992,53,224,102,122,2,30,1,1,0
58207,51505,0,0,62,62,0,1,0,1,0,1
53041,443,37580,443,7263,1834,5429,27,16,15,12,0
65496,53,1852,53,198,94,104,2,31,1,1,0
65441,80,26203,80,366,180,186,7,28,4,3,0
50298,445,0,0,70,70,0,1,0,1,0,2
53843,445,0,0,70,70,0,1,0,1,0,2
56876,11392,0,0,66,66,0,1,0,1,0,1
46280,5900,0,0,60,60,0,1,0,1,0,1
57803,445,0,0,66,66,0,1,0,1,0,2
65020,53,52884,53,289,102,187,2,30,1,1,0
42465,57470,0,0,60,60,0,1,0,1,0,1
51045,445,0,0,66,66,0,1,0,1,0,2
50339,80,14820,80,306,180,126,6,41,4,2,0
53928,15503,0,0,62,62,0,1,0,1,0,1
63201,53,63201,53,262,106,156,2,32,1,1,0
40394,67,0,0,60,60,0,1,0,1,0,1
7905,22114,0,0,66,66,0,1,0,1,0,1
55518,445,0,0,70,70,0,1,0,1,0,2
9836,22114,0,0,62,62,0,1,0,1,0,1
61413,443,10754,443,4933,771,4162,18,28,8,10,0
51554,445,0,0,66,66,0,1,0,1,0,2
57136,53,51914,53,202,103,99,2,31,1,1,0
49181,80,37044,80,6158,654,5504,15,16,8,7,0
62849,62413,0,0,62,62,0,1,0,1,0,1
43976,80,46864,80,130,70,60,2,15,1,1,0
51920,30188,0,0,62,62,0,1,0,1,0,1
2422,50584,0,0,62,62,0,1,0,1,0,1
57470,44667,49855,44667,480,149,331,2,1200,1,1,0
51947,80,31823,80,1582,866,716,11,27,7,4,0
63999,10552,13138,10552,66,66,0,2,8,2,0,0
65071,445,0,0,70,70,0,1,0,1,0,2
62635,445,0,0,66,66,0,1,0,1,0,2
53122,80,53122,80,19237,829,18408,29,15,13,16,0
65259,445,0,0,66,66,0,1,0,1,0,2
56773,28093,5962,28093,70,70,0,2,8,2,0,0
58924,443,13598,443,7783,2690,5093,24,255,13,11,0
59928,53,64195,53,168,78,90,2,30,1,1,0
25436,53,25436,53,220,90,130,2,30,1,1,0
3800,5223,0,0,146,146,0,1,0,1,0,1
55676,28694,59367,28694,316,190,126,5,15,3,2,0
56846,53,22209,53,196,102,94,2,31,1,1,0
61202,35894,0,0,66,66,0,1,0,1,0,1
56934,53,42274,53,216,110,106,2,31,1,1,0
64838,445,0,0,66,66,0,1,0,1,0,2
49880,53,16831,53,817,102,715,2,30,1,1,0
55729,53,33239,53,199,102,97,2,30,1,1,0
49165,53,42494,53,257,126,131,2,30,1,1,0
49372,53,37424,53,216,110,106,2,30,1,1,0
61831,445,0,0,66,66,0,1,0,1,0,2
49698,443,62719,443,14762,1871,12891,30,34,16,14,0
37093,53,37093,53,645,90,555,2,29,1,1,0
58687,11392,0,0,62,62,0,1,0,1,0,1
53209,443,56508,443,11086,2564,8522,42,186,21,21,0
64656,53,17241,53,387,102,285,2,29,1,1,0
25457,25604,0,0,62,62,0,1,0,1,0,1
12677,53,12677,53,234,93,141,2,30,1,1,0
56161,62413,0,0,66,66,0,1,0,1,0,1
64744,53,33076,53,376,118,258,2,30,1,1,0
63995,15396,40455,15396,70,70,0,1,4,1,0,0
62945,445,0,0,66,66,0,1,0,1,0,2
58740,445,0,0,70,70,0,1,0,1,0,2
44871,53,32671,53,168,78,90,2,30,1,1,0
49355,53,27262,53,193,102,91,2,30,1,1,0
36986,53,36986,53,234,93,141,2,31,1,1,0
49406,80,24541,80,32206,1049,31157,37,89,11,26,0
54989,443,11421,443,34038,16039,17999,79,63,43,36,0
58611,445,0,0,66,66,0,1,0,1,0,2
56661,443,26302,443,18375,7252,11123,47,40,24,23,0
49323,53,45688,53,192,98,94,2,30,1,1,0
49242,53,5506,53,167,86,81,2,30,1,1,0
64485,53,6047,53,183,94,89,2,30,1,1,0
64641,53,15849,53,193,94,99,2,30,1,1,0
50165,53,36668,53,211,78,133,2,30,1,1,0
33856,443,15413,443,8171028,105740,8065288,6637,149,745,5892,0
49343,445,0,0,70,70,0,1,0,1,0,2
56128,53,30035,53,744,89,655,2,31,1,1,0
12596,53,12596,53,197,90,107,2,30,1,1,0
6881,6881,34169,6881,502,150,352,2,1200,1,1,0
65386,53,26119,53,1160,392,768,10,66,5,5,0
58764,445,0,0,70,70,0,1,0,1,0,2
51894,26116,8093,26116,70,70,0,1,5,1,0,0
59145,445,0,0,70,70,0,1,0,1,0,2
49173,27402,64212,27402,70,70,0,1,5,1,0,0
37533,443,8271,443,5516,1774,3742,21,46,13,8,0
62389,445,0,0,70,70,0,1,0,1,0,2
58221,445,0,0,70,70,0,1,0,1,0,2
443,50238,0,0,331,331,0,1,0,1,0,1
12232,18593,0,0,139,139,0,1,0,1,0,1
54322,443,16940,443,14649,11393,3256,49,99,22,27,0
60675,445,0,0,66,66,0,1,0,1,0,2
27005,27017,50516,27017,873,126,747,2,30,1,1,0
20954,53,64122,53,223,78,145,2,30,1,1,0
64683,445,0,0,66,66,0,1,0,1,0,2
58638,5900,58638,5900,62,62,0,1,5,1,0,0
65117,53,5041,53,196,100,96,2,31,1,1,0
52122,443,45457,443,5841,1986,3855,19,15,11,8,0
42951,22114,0,0,66,66,0,1,0,1,0,1
27005,32055,61239,32055,878,126,752,2,31,1,1,0
55182,443,46108,443,2970,1689,1281,24,18,13,11,0
55070,53,15674,53,195,94,101,2,30,1,1,0
56894,53,54448,53,178,94,84,2,29,1,1,0
50236,443,50711,443,6661,1489,5172,26,270,13,13,0
58638,5900,0,0,62,62,0,1,0,1,0,1
54084,443,63980,443,37440,7952,29488,67,128,28,39,0
56748,445,0,0,70,70,0,1,0,1,0,2
26467,6969,47386,6969,192,192,0,4,1200,4,0,0
56318,53,47693,53,183,94,89,2,31,1,1,0
61051,445,0,0,70,70,0,1,0,1,0,2
58638,5900,0,0,62,62,0,1,0,1,0,1
50151,53,38506,53,177,94,83,2,30,1,1,0
49384,53,2964,53,186,95,91,2,30,1,1,0
56480,445,0,0,70,70,0,1,0,1,0,2
59775,443,41953,443,4951,711,4240,15,29,8,7,0
51939,445,0,0,70,70,0,1,0,1,0,2
62037,445,0,0,70,70,0,1,0,1,0,2
65324,445,0,0,70,70,0,1,0,1,0,2
34306,53,34306,53,241,98,143,2,30,1,1,0
55680,23711,32600,23711,70,70,0,1,5,1,0,0
49498,443,65049,443,5394,2785,2609,14,134,7,7,0
62654,35440,0,0,62,62,0,1,0,1,0,1
60464,53,0,0,180,82,98,2,30,1,1,0
53002,443,30088,443,16537,4585,11952,46,96,24,22,0
64530,53,5563,53,264,110,154,2,30,1,1,0
49262,443,12479,443,4353,1227,3126,12,135,6,6,0
54411,445,0,0,70,70,0,1,0,1,0,2
53254,443,47275,443,9949,4623,5326,45,150,23,22,0
62401,445,0,0,70,70,0,1,0,1,0,2
61441,443,10709,443,7832,1143,6689,19,31,9,10,0
64413,53,4808,53,209,102,107,2,30,1,1,0
56161,53,11132,53,199,94,105,2,30,1,1,0
63798,16357,18681,16357,66,66,0,2,8,2,0,0
48817,32897,48817,32897,152,152,0,1,1200,1,0,0
58120,445,0,0,70,70,0,1,0,1,0,2
36306,80,36306,80,1917,1468,449,10,20,6,4,0
58891,443,55777,443,7641,5165,2476,25,18,13,12,0
49447,53,25197,53,248,102,146,2,29,1,1,0
8999,48817,0,0,146,146,0,1,0,1,0,1
59668,51505,0,0,66,66,0,1,0,1,0,1
55237,53,24870,53,259,87,172,4,56,2,2,0
64554,53,25900,53,198,101,97,2,31,1,1,0
55771,53,22517,53,819,102,717,2,30,1,1,0
60433,443,40567,443,7113,3977,3136,23,136,12,11,0
63518,445,0,0,66,66,0,1,0,1,0,2
49257,53,51437,53,199,102,97,2,30,1,1,0
58322,53,41674,53,352,78,274,2,30,1,1,0
49676,53,36174,53,733,86,647,2,30,1,1,0
50584,6881,41717,6881,1357,369,988,6,1200,3,3,0
49594,53,49594,53,199,90,109,2,30,1,1,0
48408,443,3268,443,115036,11567,103469,189,103,92,97,0
47368,443,14689,443,7057,2186,4871,25,316,13,12,0
49672,80,15007,80,3749,2453,1296,15,41,9,6,0
32770,51505,0,0,62,62,0,1,0,1,0,1
64816,53,50725,53,166,86,80,2,30,1,1,0
50581,80,61624,80,2573,1859,714,9,47,5,4,0
58758,22114,0,0,66,66,0,1,0,1,0,1
55613,53,57785,53,177,94,83,2,30,1,1,0
51804,31012,28842,31012,70,70,0,1,5,1,0,0
63771,445,0,0,66,66,0,1,0,1,0,2
52437,445,0,0,70,70,0,1,0,1,0,2
25536,50584,0,0,146,146,0,1,0,1,0,1
62480,443,56428,443,1326,876,450,11,26,6,5,0
5588,5588,0,0,3354,1792,1562,46,193,23,23,0
64002,15503,0,0,146,146,0,1,0,1,0,1
53165,443,53165,443,208,66,142,4,148,2,2,0
64937,53,10087,53,182,93,89,2,31,1,1,0
53736,445,0,0,66,66,0,1,0,1,0,2
56281,53,38618,53,177,94,83,2,31,1,1,0
65264,80,41866,80,7440,4032,3408,48,629,25,23,0
57240,53,54621,53,180,94,86,2,30,1,1,0
55271,53,11109,53,168,86,82,2,31,1,1,0
52604,25174,0,0,66,66,0,1,0,1,0,1
44227,443,19248,443,7491,1930,5561,26,263,14,12,0
41575,443,49577,443,24256,1841,22415,41,131,18,23,0
18091,32480,0,0,62,62,0,1,0,1,0,1
50081,443,6983,443,18754,5240,13514,31,16,15,16,0
35165,443,20390,443,7174,4658,2516,18,121,10,8,0
37235,443,30384,443,8877,1380,7497,30,18,15,15,0
59459,37807,0,0,66,66,0,1,0,1,0,1
33244,443,30372,443,4239,2487,1752,19,16,11,8,0
64039,445,0,0,66,66,0,1,0,1,0,2
43326,443,43455,443,8065,2689,5376,27,315,14,13,0
9147,443,1443,443,6334,840,5494,19,29,10,9,0
56633,80,19210,80,234,234,0,4,12,4,0,0
57307,443,55707,443,35035,5135,29900,81,216,33,48,0
34441,53,34441,53,314,98,216,2,30,1,1,0
64551,2310,0,0,143,143,0,1,0,1,0,1
64941,53,51178,53,216,94,122,2,30,1,1,0
51229,443,49748,443,8590,1038,7552,16,120,7,9,0
56556,53,58365,53,184,94,90,2,31,1,1,0
58435,64631,0,0,74,74,0,1,0,1,0,1
65209,53,36498,53,166,86,80,2,30,1,1,0
1280,25174,0,0,66,66,0,1,0,1,0,1
39272,443,24238,443,7134,1963,5171,22,284,11,11,0
51726,64147,0,0,66,66,0,1,0,1,0,1
443,38956,0,0,82,82,0,1,0,1,0,1
50148,80,44851,80,17314,6865,10449,50,79,24,26,0
52488,443,19422,443,7165,1099,6066,16,18,9,7,0
53963,6882,44227,6882,70,70,0,2,8,2,0,0
57319,53,57319,53,198,90,108,2,29,1,1,0
49495,53,39798,53,758,102,656,2,31,1,1,0
50888,445,0,0,70,70,0,1,0,1,0,2
56015,53,29304,53,195,102,93,2,30,1,1,0
62088,56205,0,0,66,66,0,1,0,1,0,1
40711,53,40711,53,200,90,110,2,30,1,1,0
55225,11392,0,0,66,66,0,1,0,1,0,1
49622,53,47185,53,185,102,83,2,30,1,1,0
29512,30188,0,0,62,62,0,1,0,1,0,1
54677,5228,25400,5228,6679,2730,3949,43,4309,23,20,0
60374,80,60374,80,118413,7486,110927,151,33,70,81,0
10965,22114,0,0,146,146,0,1,0,1,0,1
64858,53,5118,53,819,102,717,2,30,1,1,0
63691,445,0,0,70,70,0,1,0,1,0,2
61288,23,0,0,60,60,0,1,0,1,0,1
64680,53,32256,53,768,99,669,2,30,1,1,0
60375,53,25105,53,226,94,132,2,31,1,1,0
56405,62413,0,0,66,66,0,1,0,1,0,1
40175,53,40175,53,235,90,145,2,32,1,1,0
65502,443,12498,443,92573,4519,88054,105,16,39,66,0
9203,443,1918,443,318,192,126,6,17,4,2,0
60574,445,0,0,70,70,0,1,0,1,0,2
50151,53,44129,53,168,94,74,2,30,1,1,0
58638,5900,0,0,62,62,0,1,0,1,0,1
47739,53,26929,53,168,78,90,2,29,1,1,0
53894,2944,38557,2944,70,70,0,1,5,1,0,0
63917,57826,24551,57826,66,66,0,2,7,2,0,0
52506,445,0,0,70,70,0,1,0,1,0,2
64396,53,1161,53,211,102,109,2,30,1,1,0
51464,443,29786,443,575,326,249,10,15,6,4,0
49828,443,43122,443,7284,1353,5931,26,186,14,12,0
51021,445,0,0,70,70,0,1,0,1,0,2
47515,5900,0,0,60,60,0,1,0,1,0,1
42034,28189,0,0,62,62,0,1,0,1,0,1
49837,53,3661,53,183,102,81,2,30,1,1,0
50052,65010,0,0,60,60,0,1,0,1,0,1
61591,22114,0,0,146,146,0,1,0,1,0,1
58988,443,31183,443,4330,1777,2553,18,122,9,9,0
24041,55783,0,0,62,62,0,1,0,1,0,1
55068,53,43226,53,196,102,94,2,31,1,1,0
42366,57470,0,0,66,66,0,1,0,1,0,1
55890,53,43973,53,193,102,91,2,30,1,1,0
51782,445,0,0,70,70,0,1,0,1,0,2
55808,53,36895,53,183,94,89,2,30,1,1,0
46963,443,17005,443,70,70,0,1,5,1,0,0
5588,5588,0,0,3562,1936,1626,48,192,24,24,0
53139,50285,41730,50285,320,140,180,6,6,3,3,0
49361,53,49782,53,166,86,80,2,30,1,1,0
50280,57470,0,0,78,78,0,1,0,1,0,1
58087,445,0,0,70,70,0,1,0,1,0,2
55225,53,24302,53,199,102,97,2,30,1,1,0
63920,443,64654,443,3192,633,2559,17,135,7,10,0
34424,443,13536,443,8277,2394,5883,31,316,16,15,0
1646,23,0,0,60,60,0,1,0,1,0,1
42382,443,39819,443,4844,1099,3745,18,25,10,8,0
55193,53,27254,53,177,94,83,2,30,1,1,0
49903,53,18446,53,215,102,113,2,29,1,1,0
64537,53,60663,53,168,86,82,2,29,1,1,0
50501,80,58618,80,318,192,126,6,25,4,2,0
56964,53,57920,53,179,94,85,2,30,1,1,0
49860,80,9156,80,6892,2154,4738,22,89,12,10,0
58772,443,9884,443,5106,700,4406,15,15,7,8,0
31066,57470,0,0,74,74,0,1,0,1,0,1
50462,80,58102,80,4603,2152,2451,14,22,8,6,0
49450,445,0,0,70,70,0,1,0,1,0,2
55212,53733,0,0,66,66,0,1,0,1,0,1
64326,53,50909,53,196,102,94,2,31,1,1,0
54772,443,51519,443,3388,894,2494,19,154,8,11,0
55792,53,55035,53,199,102,97,2,30,1,1,0
55469,445,0,0,66,66,0,1,0,1,0,2
52038,50584,0,0,66,66,0,1,0,1,0,1
58995,443,49054,443,8826,2860,5966,21,9,10,11,0
55619,53,59792,53,241,78,163,2,30,1,1,0
63989,445,0,0,66,66,0,1,0,1,0,2
42881,443,61289,443,28707,2793,25914,58,115,29,29,0
58638,5900,0,0,62,62,0,1,0,1,0,1
37558,16386,20045,16386,432,192,240,8,30,4,4,0
61064,445,0,0,66,66,0,1,0,1,0,2
56598,445,0,0,70,70,0,1,0,1,0,2
60869,48817,0,0,66,66,0,1,0,1,0,1
44454,443,1457,443,7092,1495,5597,22,31,12,10,0
44414,23718,0,0,62,62,0,1,0,1,0,1
50123,445,0,0,70,70,0,1,0,1,0,2
993,4543,0,0,66,66,0,1,0,1,0,1
55244,445,0,0,70,70,0,1,0,1,0,2
49282,6881,35216,6881,709,523,186,6,16,3,3,0
57428,445,0,0,66,66,0,1,0,1,0,2
52594,445,0,0,70,70,0,1,0,1,0,2
15503,19168,41378,19168,481,150,331,2,1200,1,1,0
22659,53,22659,53,247,98,149,2,32,1,1,0
41528,161,0,0,14381,5620,8761,50,30,25,25,0
60406,443,21053,443,8404,1892,6512,23,30,12,11,0
22677,25174,0,0,66,66,0,1,0,1,0,1
57470,13244,33439,13244,166,166,0,1,1199,1,0,0
26900,27017,18578,27017,422,164,258,6,30,3,3,0
53872,443,24185,443,499,425,74,4,1,3,1,0
58131,30228,0,0,146,146,0,1,0,1,0,1
64573,53,34650,53,184,94,90,2,30,1,1,0
60827,53,38613,53,224,86,138,2,29,1,1,0
54614,443,21022,443,36109,16793,19316,62,19,32,30,0
56665,53,14967,53,223,86,137,2,30,1,1,0
56586,443,35077,443,7110,2183,4927,22,16,12,10,0
7274,64147,0,0,62,62,0,1,0,1,0,1
36621,443,53395,443,2239099,75601,2163498,2512,71,983,1529,0
48867,443,13159,443,6107,2079,4028,19,68,11,8,0
58638,5900,0,0,62,62,0,1,0,1,0,1
57629,445,0,0,70,70,0,1,0,1,0,2
56754,53,65237,53,183,94,89,2,30,1,1,0
64248,445,0,0,66,66,0,1,0,1,0,2
52159,80,23650,80,502,310,192,9,31,6,3,0
64335,53,18778,53,186,95,91,2,30,1,1,0
64887,445,0,0,70,70,0,1,0,1,0,2
65285,44847,0,0,62,62,0,1,0,1,0,1
64095,53,51473,53,269,110,159,2,30,1,1,0
64745,445,0,0,66,66,0,1,0,1,0,2
59405,443,60870,443,9052,2120,6932,28,23,14,14,0
40400,22114,0,0,62,62,0,1,0,1,0,1
54598,37965,0,0,66,66,0,1,0,1,0,1
31500,1,0,0,146,146,0,1,0,1,0,1
52224,37178,41727,37178,136,136,0,3,14,3,0,0
51689,80,35961,80,16205,2525,13680,31,139,15,16,0
56629,53,58033,53,182,93,89,2,30,1,1,0
58956,53,19380,53,213,89,124,2,30,1,1,0
65189,27216,23592,27216,226,71,155,2,31,1,1,0
56689,445,0,0,66,66,0,1,0,1,0,2
57237,21247,0,0,62,62,0,1,0,1,0,1
49450,53,27588,53,227,94,133,2,29,1,1,0
58876,443,42159,443,19357,12948,6409,47,18,26,21,0
51396,56205,0,0,66,66,0,1,0,1,0,1
52658,64147,0,0,145,145,0,1,0,1,0,1
62859,35440,0,0,66,66,0,1,0,1,0,1
51772,80,5918,80,93693,4469,89224,115,24,53,62,0
60311,30627,0,0,66,66,0,1,0,1,0,1
22419,1433,22419,1433,146,60,86,2,9,1,1,0
58789,443,17140,443,14261,9361,4900,35,16,19,16,0
57356,443,8609,443,7644,3087,4557,26,46,15,11,0
55425,37965,0,0,66,66,0,1,0,1,0,1
37555,16385,63752,16385,556,256,300,10,30,5,5,0
49260,53,30297,53,791,85,706,4,57,2,2,0
62617,445,0,0,70,70,0,1,0,1,0,2
61857,445,0,0,70,70,0,1,0,1,0,2
53138,443,56360,443,7141,2507,4634,28,42,13,15,0
62923,993,4264,993,9848,4639,5209,83,41,42,41,0
5588,5588,0,0,3354,1792,1562,46,194,23,23,0
55947,53,4712,53,94,94,0,1,30,1,0,0
63855,445,0,0,66,66,0,1,0,1,0,2
64535,37965,0,0,66,66,0,1,0,1,0,1
49948,53,30662,53,214,94,120,2,30,1,1,0
54999,445,0,0,70,70,0,1,0,1,0,2
62856,443,62856,443,3743,1654,2089,10,120,5,5,0
52690,445,0,0,66,66,0,1,0,1,0,2
60504,445,0,0,70,70,0,1,0,1,0,2
49352,53,51513,53,216,102,114,2,29,1,1,0
56589,53,14177,53,166,86,80,2,30,1,1,0
49394,443,40363,443,7129,1853,5276,27,316,13,14,0
2077,7000,2077,7000,3054,1599,1455,16,15,8,8,0
53050,445,0,0,70,70,0,1,0,1,0,2
53501,443,53501,443,960,539,421,9,36,5,4,0
58638,5900,0,0,62,62,0,1,0,1,0,1
56226,53,12248,53,284,96,188,4,33,2,2,0
49171,53,3246,53,199,102,97,2,30,1,1,0
49539,53,44717,53,170,87,83,2,31,1,1,0
34499,443,29656,443,19518,11774,7744,46,168,26,20,0
56100,53,6720,53,216,110,106,2,30,1,1,0
49531,53,34898,53,183,94,89,2,30,1,1,0
6872,23,0,0,60,60,0,1,0,1,0,1
55503,53,6618,53,216,110,106,2,29,1,1,0
39313,37965,0,0,62,62,0,1,0,1,0,1
49658,443,50327,443,14121,2299,11822,37,19,19,18,0
58881,443,10013,443,1413,876,537,12,26,6,6,0
20576,37965,0,0,62,62,0,1,0,1,0,1
63060,445,0,0,70,70,0,1,0,1,0,2
64618,53,21647,53,198,102,96,2,30,1,1,0
443,20087,0,0,83,83,0,1,0,1,0,1
51974,54759,44353,54759,70,70,0,1,4,1,0,0
52340,445,0,0,66,66,0,1,0,1,0,2
6881,6881,40959,6881,238,118,120,2,1200,1,1,0
63093,443,45246,443,304,86,218,2,30,1,1,0
57107,445,0,0,70,70,0,1,0,1,0,2
56755,445,0,0,70,70,0,1,0,1,0,2
64268,53,45536,53,334,103,231,4,54,2,2,0
50458,443,25872,443,523577,34256,489321,1025,208,473,552,0
63013,445,0,0,70,70,0,1,0,1,0,2
51906,17491,64843,17491,70,70,0,2,8,2,0,0
61779,445,0,0,70,70,0,1,0,1,0,2
56118,53,56118,53,233,91,142,2,30,1,1,0
55491,445,0,0,70,70,0,1,0,1,0,2
55342,445,0,0,70,70,0,1,0,1,0,2
56882,53,4292,53,87,87,0,2,61,2,0,0
52095,443,20736,443,325846,10609,315237,326,38,106,220,0
49870,53,59356,53,194,102,92,2,30,1,1,0
49418,27015,10652,27015,224,78,146,2,30,1,1,0
65109,445,0,0,70,70,0,1,0,1,0,2
42012,443,37519,443,14271,2106,12165,42,227,17,25,0
27679,37965,0,0,62,62,0,1,0,1,0,1
58103,10197,0,0,66,66,0,1,0,1,0,1
65505,53,13490,53,166,86,80,2,30,1,1,0
53117,37529,25510,37529,70,70,0,2,8,2,0,0
50050,443,8381,443,7912,3269,4643,23,95,12,11,0
49698,53,38054,53,184,102,82,2,30,1,1,0
51118,445,0,0,70,70,0,1,0,1,0,2
64969,53,18068,53,329,118,211,2,30,1,1,0
55913,53,60589,53,177,94,83,2,30,1,1,0
65484,53,32858,53,195,102,93,2,30,1,1,0
57353,443,50919,443,70,70,0,1,5,1,0,0
56773,53,53330,53,183,94,89,2,29,1,1,0
52698,80,54306,80,8280,5678,2602,25,111,14,11,0
64294,445,0,0,66,66,0,1,0,1,0,2
50469,443,45578,443,19063941,342071,18721870,17124,384,4119,13005,0
32551,51221,0,0,62,62,0,1,0,1,0,1
59321,445,0,0,70,70,0,1,0,1,0,2
64827,53,50756,53,291,86,205,2,30,1,1,0
24504,37965,0,0,62,62,0,1,0,1,0,1
64573,53,39960,53,184,94,90,2,30,1,1,0
49595,53,47380,53,180,94,86,2,30,1,1,0
52040,80,45485,80,4185,3462,723,14,16,7,7,0
4529,56205,0,0,62,62,0,1,0,1,0,1
58101,46314,0,0,72,72,0,1,0,1,0,1
61366,445,0,0,66,66,0,1,0,1,0,2
46186,443,59452,443,10103,3482,6621,59,16,29,30,0
55161,445,0,0,70,70,0,1,0,1,0,2
55668,80,2182,80,70,70,0,2,8,2,0,0
53283,443,23870,443,9121,2486,6635,22,45,13,9,0
53802,59932,27956,59932,320,140,180,6,6,3,3,0
52933,443,60920,443,5582,1388,4194,19,15,9,10,0
56449,445,0,0,70,70,0,1,0,1,0,2
37658,16384,24782,16384,130,70,60,2,30,1,1,0
1749,64147,0,0,66,66,0,1,0,1,0,1
19634,64147,0,0,62,62,0,1,0,1,0,1
55718,16805,50581,16805,70,70,0,1,5,1,0,0
52375,80,50220,80,234,234,0,4,12,4,0,0
64670,53,61851,53,193,102,91,2,29,1,1,0
48933,443,5665,443,4372,2402,1970,27,53,14,13,0
49760,80,49760,80,613303,16858,596445,666,143,251,415,0
51466,443,58507,443,7638,1758,5880,24,17,13,11,0
33886,65504,0,0,162,162,0,1,0,1,0,1
56526,53,57484,53,210,102,108,2,30,1,1,0
64469,53,32950,53,342,97,245,4,42,2,2,0
27328,21247,0,0,62,62,0,1,0,1,0,1
65189,27015,60711,27015,278,78,200,2,29,1,1,0
10914,35974,0,0,60,60,0,1,0,1,0,1
45721,443,58682,443,1925,1120,805,16,25,9,7,0
65165,53,5142,53,177,94,83,2,30,1,1,0
47705,443,21979,443,25643,2181,23462,44,363,18,26,0
50570,57470,0,0,66,66,0,1,0,1,0,1
54339,23117,0,0,66,66,0,1,0,1,0,1
51576,443,13071,443,9753,2821,6932,39,201,22,17,0
55703,445,0,0,70,70,0,1,0,1,0,2
62307,8055,0,0,159,159,0,1,0,1,0,1
65270,53,38040,53,226,110,116,2,30,1,1,0
2422,50584,0,0,66,66,0,1,0,1,0,1
60748,445,0,0,70,70,0,1,0,1,0,2
58687,12883,0,0,143,143,0,1,0,1,0,1
54280,3396,0,0,60,60,0,1,0,1,0,1
60428,25174,0,0,66,66,0,1,0,1,0,1
38971,25174,0,0,146,146,0,1,0,1,0,1
65418,53,5528,53,197,94,103,2,30,1,1,0
51206,445,0,0,70,70,0,1,0,1,0,2
42995,26467,0,0,62,62,0,1,0,1,0,1
49607,25174,0,0,66,66,0,1,0,1,0,1
6881,45711,0,0,100,100,0,1,0,1,0,1
56086,445,0,0,70,70,0,1,0,1,0,2
64904,445,0,0,70,70,0,1,0,1,0,2
54796,443,9714,443,6668,1926,4742,20,15,11,9,0
47310,443,33854,443,3541,616,2925,19,165,8,11,0
32983,51221,0,0,66,66,0,1,0,1,0,1
51960,58601,12629,58601,70,70,0,2,8,2,0,0
36770,56205,0,0,62,62,0,1,0,1,0,1
59148,445,0,0,66,66,0,1,0,1,0,2
58638,5900,0,0,62,62,0,1,0,1,0,1
52014,445,0,0,70,70,0,1,0,1,0,2
50116,22,50116,22,152,66,86,2,9,1,1,0
2305,35440,0,0,62,62,0,1,0,1,0,1
51858,445,0,0,70,70,0,1,0,1,0,2
8430,53,61822,53,239209,233954,5255,2850,88,2822,28,0
35657,48637,0,0,145,145,0,1,0,1,0,1
59538,80,24164,80,3835,1767,2068,21,187,12,9,0
63588,445,0,0,66,66,0,1,0,1,0,2
49359,80,26843,80,60,60,0,2,154,2,0,0
51844,12471,17127,12471,70,70,0,2,8,2,0,0
13968,29376,0,0,62,62,0,1,0,1,0,3
64980,53,40885,53,274,88,186,4,35,2,2,0
62888,23,0,0,60,60,0,1,0,1,0,1
54667,443,17668,443,3989,1104,2885,12,122,5,7,0
51965,80,35850,80,106904,5958,100946,139,66,62,77,0
20706,37965,0,0,62,62,0,1,0,1,0,1
56973,443,43404,443,22953,5010,17943,38,123,14,24,0
61635,445,0,0,70,70,0,1,0,1,0,2
59201,51221,0,0,66,66,0,1,0,1,0,1
49993,445,0,0,70,70,0,1,0,1,0,2
21456,53,21456,53,240,98,142,2,30,1,1,0
41444,80,42580,80,1000,577,423,10,200,6,4,0
55443,443,53890,443,12806,2828,9978,55,2983,24,31,0
49516,53,31257,53,183,94,89,2,29,1,1,0
57014,80,25497,80,214,140,74,4,30,3,1,0
38608,80,62728,80,1289,303,986,12,16,5,7,0
14092,80,14092,80,3182,2082,1100,18,86,10,8,0
64089,53,20449,53,197,94,103,2,30,1,1,0
42228,51050,0,0,66,66,0,1,0,1,0,1
50792,443,51398,443,144115,19017,125098,229,400,112,117,0
61223,37965,0,0,66,66,0,1,0,1,0,1
63235,443,19696,443,1373,734,639,17,96,10,7,0
50265,26512,31440,26512,480,149,331,2,1200,1,1,0
55563,53,47239,53,194,102,92,2,31,1,1,0
46275,64147,0,0,62,62,0,1,0,1,0,1
39396,443,4891,443,7531,2720,4811,24,331,13,11,0
51713,445,0,0,66,66,0,1,0,1,0,2
33409,53,54982,53,79268,76966,2302,936,88,923,13,0
57416,53,53137,53,193,102,91,2,29,1,1,0
57275,53,56267,53,177,94,83,2,30,1,1,0
54995,443,42324,443,13281,4753,8528,32,17,18,14,0
19473,6881,31231,6881,490,149,341,2,1200,1,1,0
55490,80,37170,80,186387,10616,175771,243,33,116,127,0
52661,53,0,0,86,86,0,1,30,1,0,0
2370,23,0,0,60,60,0,1,0,1,0,1
46275,64147,0,0,62,62,0,1,0,1,0,1
64266,53,14538,53,255,102,153,2,30,1,1,0
53705,443,11151,443,499,425,74,4,0,3,1,0
65231,53,56850,53,200,102,98,2,30,1,1,0
49257,445,0,0,70,70,0,1,0,1,0,2
56998,53,8754,53,170,87,83,2,31,1,1,0
58058,80,25761,80,318,192,126,6,21,4,2,0
64318,53,59823,53,182,93,89,2,31,1,1,0
7308,50584,0,0,66,66,0,1,0,1,0,1
59435,445,0,0,70,70,0,1,0,1,0,2
5588,5588,0,0,3562,1936,1626,48,194,24,24,0
54219,443,4628,443,499,425,74,4,0,3,1,0
58145,445,0,0,70,70,0,1,0,1,0,2
58758,445,0,0,66,66,0,1,0,1,0,2
64749,53,21766,53,227,110,117,2,30,1,1,0
56603,53,39210,53,168,86,82,2,30,1,1,0
56791,53,55367,53,250,87,163,4,58,2,2,0
42278,443,42278,443,1916,1121,795,19,69,10,9,0
57330,443,48576,443,36551,3569,32982,57,46,28,29,0
64565,53,49218,53,802,104,698,2,31,1,1,0
49177,443,60972,443,654956,17062,637894,673,18,244,429,0
51491,445,0,0,66,66,0,1,0,1,0,2
64586,50584,0,0,146,146,0,1,0,1,0,1
54627,445,0,0,70,70,0,1,0,1,0,2
49662,53,37093,53,268,93,175,4,59,2,2,0
49171,443,58850,443,13649,6228,7421,28,30,15,13,0
55547,53,9428,53,774,101,673,2,31,1,1,0
60920,53,22139,53,268,86,182,2,30,1,1,0
62895,993,31409,993,10457,4879,5578,98,186,50,48,0
64346,51505,0,0,66,66,0,1,0,1,0,1
50629,443,56409,443,70,70,0,1,5,1,0,0
34228,45129,0,0,148,148,0,1,0,1,0,1
36641,25174,0,0,66,66,0,1,0,1,0,1
64715,53,60767,53,315,98,217,4,58,2,2,0
53245,445,0,0,70,70,0,1,0,1,0,2
11136,19910,0,0,62,62,0,1,0,1,0,1
49516,53,60499,53,183,94,89,2,29,1,1,0
50454,445,0,0,70,70,0,1,0,1,0,2
22168,25174,0,0,146,146,0,1,0,1,0,1
42224,123,27890,123,184,94,90,2,30,1,1,0
56333,53,40833,53,209,110,99,2,30,1,1,0
50434,80,31890,80,318,192,126,6,26,4,2,0
64883,445,0,0,70,70,0,1,0,1,0,2
62106,445,0,0,70,70,0,1,0,1,0,2
51824,445,0,0,70,70,0,1,0,1,0,2
15341,23,0,0,60,60,0,1,90,1,0,0
60337,30188,0,0,66,66,0,1,0,1,0,1
52420,445,0,0,70,70,0,1,0,1,0,2
50329,80,27783,80,1550,728,822,13,47,7,6,0
49406,445,0,0,70,70,0,1,0,1,0,2
43111,443,29874,443,3117,1867,1250,19,15,9,10,0
62254,445,0,0,70,70,0,1,0,1,0,2
41431,443,64563,443,190,70,120,4,15,2,2,0
52094,55986,33027,55986,66,66,0,1,5,1,0,0
49479,80,63239,80,9192,4788,4404,30,126,17,13,0
49708,53,32399,53,178,94,84,2,30,1,1,0
51829,46209,37314,46209,70,70,0,2,6,2,0,0
55786,53,42852,53,200,102,98,2,30,1,1,0
57878,55108,0,0,148,148,0,1,0,1,0,1
38612,443,17131,443,20651533,655694,19995839,24885,362,8746,16139,0
51413,54751,0,0,136,136,0,1,0,1,0,1
57669,443,51063,443,12569,8228,4341,28,256,16,12,0
54145,443,52108,443,118,118,0,1,120,1,0,0
60778,445,0,0,66,66,0,1,0,1,0,2
54721,22114,0,0,62,62,0,1,0,1,0,1
49726,445,0,0,70,70,0,1,0,1,0,2
49348,443,47501,443,2879984,113967,2766017,3396,129,1423,1973,0
51966,80,56206,80,83302,3780,79522,105,66,47,58,0
64264,445,0,0,70,70,0,1,0,1,0,2
65258,443,17337,443,6043,1568,4475,11,120,4,7,0
52265,32078,35097,32078,70,70,0,2,7,2,0,0
45994,443,45994,443,1494,898,596,12,142,6,6,0
58813,445,0,0,70,70,0,1,0,1,0,2
17018,53,17018,53,217,87,130,2,30,1,1,0
58890,445,0,0,70,70,0,1,0,1,0,2
46102,80,6915,80,70,70,0,2,5,2,0,0
4772,37965,0,0,66,66,0,1,0,1,0,1
33633,443,34965,443,5698,1585,4113,23,1108,13,10,0
56260,53,39887,53,170,87,83,2,31,1,1,0
51915,35068,4331,35068,316,136,180,6,6,3,3,0
56362,53,31120,53,195,102,93,2,29,1,1,0
38701,443,23957,443,1065134,19929,1045205,1009,16,288,721,0
64505,53,53732,53,388,134,254,2,30,1,1,0
55941,53,34210,53,184,94,90,2,30,1,1,0
62630,445,0,0,70,70,0,1,0,1,0,2
56376,44847,0,0,66,66,0,1,0,1,0,1
54528,53,37583,53,197,94,103,2,30,1,1,0
51114,445,0,0,66,66,0,1,0,1,0,2
10602,3389,10602,3389,3910,1805,2105,20,19,12,8,0
57355,445,0,0,70,70,0,1,0,1,0,2
51534,26467,0,0,62,62,0,1,0,1,0,1
38123,443,24032,443,15449,1976,13473,32,16,16,16,0
54971,445,0,0,70,70,0,1,0,1,0,2
50544,443,24381,443,8592,1152,7440,25,150,13,12,0
55588,53,33689,53,168,86,82,2,31,1,1,0
60786,25174,0,0,66,66,0,1,0,1,0,1
61968,445,0,0,70,70,0,1,0,1,0,2
55790,53,7477,53,170,87,83,2,31,1,1,0
58638,5900,0,0,62,62,0,1,0,1,0,1
49310,53,37425,53,239,102,137,2,30,1,1,0
60707,80,12418,80,144,78,66,2,5,1,1,0
55653,23,0,0,60,60,0,1,0,1,0,1
55265,53,44071,53,199,102,97,2,30,1,1,0
16654,50265,0,0,62,62,0,1,0,1,0,1
16387,24782,0,0,60,60,0,1,0,1,0,1
55529,445,0,0,66,66,0,1,0,1,0,2
61116,445,0,0,70,70,0,1,0,1,0,2
55392,53,38891,53,190,97,93,2,31,1,1,0
14667,80,14667,80,3197,2167,1030,17,72,10,7,0
59321,53,33396,53,209,70,139,2,30,1,1,0
44847,18659,47289,18659,150,150,0,1,1200,1,0,0
59779,443,38576,443,142,142,0,1,5,1,0,0
56717,53,51715,53,172,88,84,2,31,1,1,0
27005,50003,10902,50003,1636,126,1510,4,31,2,2,0
56748,80,11482,80,946,531,415,11,296,6,5,0
56445,53,52720,53,198,101,97,2,30,1,1,0
55865,53,34168,53,807,94,713,2,30,1,1,0
57193,80,36563,80,2235,1055,1180,12,16,7,5,0
65211,53,54701,53,183,94,89,2,30,1,1,0
33196,53,25269,53,181,86,95,2,30,1,1,0
65285,50584,0,0,66,66,0,1,0,1,0,1
62038,445,0,0,66,66,0,1,0,1,0,2
53202,443,64942,443,3655,2344,1311,18,17,9,9,0
40544,53,0,0,82,82,0,1,30,1,0,0
34240,53,34240,53,229,89,140,2,31,1,1,0
55406,25174,0,0,66,66,0,1,0,1,0,1
56127,53,41688,53,167,86,81,2,30,1,1,0
64755,31573,0,0,66,66,0,1,0,1,0,1
52928,80,52040,80,1996,691,1305,10,359,6,4,0
55889,53,49760,53,198,101,97,2,31,1,1,0
6881,5903,6718,5903,501,150,351,2,1200,1,1,0
56464,53,56163,53,177,94,83,2,30,1,1,0
57184,53,36086,53,272,94,178,2,29,1,1,0
58055,80,48571,80,3791,2804,987,14,31,8,6,0
51288,445,0,0,70,70,0,1,0,1,0,2
53245,443,26528,443,7705,2005,5700,26,120,13,13,0
49418,30002,50815,30002,242,71,171,2,30,1,1,0
49563,80,54340,80,1515,481,1034,11,15,6,5,0
55145,11392,0,0,66,66,0,1,0,1,0,1
33886,39127,0,0,162,162,0,1,0,1,0,1
61069,445,0,0,70,70,0,1,0,1,0,2
46101,80,15092,80,70,70,0,2,5,2,0,0
27005,32025,26233,32025,887,126,761,2,30,1,1,0
57359,53,20340,53,458,188,270,6,31,3,3,0
64554,53,30164,53,94,94,0,1,29,1,0,0
56609,53,65200,53,199,102,97,2,30,1,1,0
48731,443,18575,443,5959,1709,4250,27,1211,15,12,0
38474,28678,45201,28678,1806,1806,0,22,224,22,0,0
42298,40010,33875,40010,148,86,62,2,31,1,1,0
50586,80,50586,80,5320,3428,1892,22,21,12,10,0
50128,445,0,0,70,70,0,1,0,1,0,2
56326,53,1837,53,177,94,83,2,29,1,1,0
58564,50432,0,0,66,66,0,1,0,1,0,1
48271,25174,0,0,146,146,0,1,0,1,0,1
57006,80,58727,80,214,140,74,4,30,3,1,0
56815,443,53722,443,7903,1914,5989,20,15,11,9,0
63670,64097,0,0,66,66,0,1,0,1,0,1
64380,53,44055,53,98,98,0,1,30,1,0,0
58530,53,0,0,188,84,104,2,30,1,1,0
53537,34901,47127,34901,672,426,246,11,21,7,4,0
55373,53,29623,53,164,86,78,2,30,1,1,0
61510,37965,0,0,66,66,0,1,0,1,0,1
60073,80,45095,80,10676,6719,3957,23,141,12,11,0
57130,53,10466,53,778,103,675,2,31,1,1,0
49951,80,39870,80,1706,505,1201,8,14,5,3,0
54716,445,0,0,70,70,0,1,0,1,0,2
55258,53,4040,53,177,94,83,2,30,1,1,0
17873,23117,0,0,66,66,0,1,0,1,0,1
63208,30975,0,0,148,148,0,1,0,1,0,1
49735,443,18914,443,1143,672,471,12,129,7,5,0
57095,53,22428,53,211,110,101,2,30,1,1,0
3584,25174,0,0,62,62,0,1,0,1,0,1
55529,44847,0,0,66,66,0,1,0,1,0,1
55660,53,37547,53,757,98,659,2,30,1,1,0
43516,53,56876,53,168,78,90,2,30,1,1,0
10003,64147,0,0,62,62,0,1,0,1,0,1
65372,445,0,0,70,70,0,1,0,1,0,2
58321,445,0,0,70,70,0,1,0,1,0,2
24073,22114,0,0,62,62,0,1,0,1,0,1
64045,445,0,0,70,70,0,1,0,1,0,2
51686,445,0,0,70,70,0,1,0,1,0,2
56964,445,0,0,70,70,0,1,0,1,0,2
35195,443,7133,443,153,93,60,2,5,1,1,0
62362,445,0,0,70,70,0,1,0,1,0,2
48706,23393,0,0,60,60,0,1,0,1,0,1
55966,445,0,0,70,70,0,1,0,1,0,2
62716,2323,0,0,60,60,0,1,0,1,0,1
46265,443,19534,443,173828,9311,164517,245,448,118,127,0
57068,445,0,0,70,70,0,1,0,1,0,2
52680,445,0,0,66,66,0,1,0,1,0,2
16883,22,0,0,60,60,0,1,0,1,0,1
63904,18268,33783,18268,70,70,0,1,4,1,0,0
41756,56205,0,0,62,62,0,1,0,1,0,1
50604,80,50604,80,1707,1007,700,11,21,6,5,0
63814,12906,64380,12906,66,66,0,2,7,2,0,0
1081,14984,0,0,146,146,0,1,0,1,0,1
53930,445,0,0,70,70,0,1,0,1,0,2
39236,80,55447,80,190,70,120,4,16,2,2,0
49266,53,8623,53,86,86,0,1,30,1,0,0
49247,53,4260,53,194,102,92,2,31,1,1,0
54211,53,7944,53,339,94,245,2,30,1,1,0
51221,49683,21900,49683,870,330,540,12,1316,6,6,0
49460,53,64925,53,458,188,270,6,30,3,3,0
54628,445,0,0,70,70,0,1,0,1,0,2
50027,80,48247,80,3648,2069,1579,16,85,9,7,0
56962,445,0,0,70,70,0,1,0,1,0,2
59214,57866,0,0,66,66,0,1,0,1,0,1
53113,8372,13040,8372,758,320,438,11,17,6,5,0
50320,53,20919,53,168,78,90,2,30,1,1,0
55596,53,31644,53,194,102,92,2,30,1,1,0
55076,53,45529,53,182,93,89,2,31,1,1,0
58962,23,0,0,60,60,0,1,0,1,0,1
60216,445,0,0,70,70,0,1,0,1,0,2
54709,445,0,0,66,66,0,1,0,1,0,2
39996,23,0,0,60,60,0,1,0,1,0,1
8486,56205,0,0,66,66,0,1,0,1,0,1
58463,443,33811,443,19057,9308,9749,111,307,53,58,0
47957,443,9309,443,7658,4247,3411,29,31,15,14,0
51535,443,45578,443,202,70,132,3,11,1,2,0
60768,445,0,0,66,66,0,1,0,1,0,2
17378,44847,0,0,66,66,0,1,0,1,0,1
49166,443,10443,443,70,70,0,1,5,1,0,0
56636,80,30803,80,234,234,0,4,12,4,0,0
37580,443,41939,443,24810,10597,14213,51,123,22,29,0
44154,22114,0,0,62,62,0,1,0,1,0,1
36407,443,52772,443,1149,709,440,13,38,8,5,0
49311,445,0,0,70,70,0,1,0,1,0,2
55857,53,56112,53,199,102,97,2,31,1,1,0
64938,53,18539,53,210,102,108,2,30,1,1,0
26528,51221,0,0,78,78,0,1,0,1,0,1
58638,5900,0,0,62,62,0,1,0,1,0,1
54445,445,0,0,66,66,0,1,0,1,0,2
65530,53,42402,53,194,102,92,2,30,1,1,0
26254,56205,0,0,66,66,0,1,0,1,0,1
52236,15313,56383,15313,70,70,0,2,5,2,0,0
53873,443,46663,443,499,425,74,4,1,3,1,0
54758,35993,0,0,62,62,0,1,0,1,0,1
52398,443,30861,443,323437,18923,304514,544,252,276,268,0
32071,51221,0,0,62,62,0,1,0,1,0,1
57067,53,11799,53,183,94,89,2,30,1,1,0
50354,53,24829,53,209,110,99,2,30,1,1,0
55146,53,42848,53,181,94,87,2,30,1,1,0
55155,53,65476,53,188,96,92,2,31,1,1,0
52492,445,0,0,66,66,0,1,0,1,0,2
57256,443,52300,443,47762,39522,8240,77,332,43,34,0
47159,443,53350,443,777,432,345,10,15,5,5,0
63272,445,0,0,66,66,0,1,0,1,0,2
57031,445,0,0,70,70,0,1,0,1,0,2
60048,445,0,0,66,66,0,1,0,1,0,2
64559,53,29849,53,198,110,88,2,30,1,1,0
45313,64147,0,0,62,62,0,1,0,1,0,1
55440,53,55440,53,220,90,130,2,30,1,1,0
49575,53,59647,53,244,102,142,2,29,1,1,0
55855,445,0,0,70,70,0,1,0,1,0,2
55300,445,0,0,66,66,0,1,0,1,0,2
62414,50584,0,0,66,66,0,1,0,1,0,1
64602,53,4497,53,184,94,90,2,30,1,1,0
64474,445,0,0,70,70,0,1,0,1,0,2
54726,30041,0,0,62,62,0,1,0,1,0,1
55778,53,54108,53,181,94,87,2,30,1,1,0
11988,48817,0,0,66,66,0,1,0,1,0,1
50440,53,39485,53,216,110,106,2,30,1,1,0
57226,443,27047,443,7924,2027,5897,23,22,14,9,0
58943,443,29236,443,6611,4273,2338,22,17,11,11,0
51963,21638,43079,21638,70,70,0,1,5,1,0,0
41763,443,59315,443,9797,1934,7863,21,15,12,9,0
52459,33890,0,0,60,60,0,1,0,1,0,1
59773,5900,0,0,60,60,0,1,0,1,0,1
64449,30188,0,0,66,66,0,1,0,1,0,1
15959,56205,0,0,66,66,0,1,0,1,0,1
50263,445,0,0,70,70,0,1,0,1,0,2
64087,80,46757,80,314,192,122,6,15,4,2,0
56580,443,8692,443,20897,11903,8994,52,49,30,22,0
40547,24051,0,0,74,74,0,1,0,1,0,1
6546,37965,0,0,62,62,0,1,0,1,0,1
51732,445,0,0,70,70,0,1,0,1,0,2
49557,53,50413,53,272,110,162,2,29,1,1,0
48252,443,35978,443,283034,39462,243572,536,224,257,279,0
58901,445,0,0,70,70,0,1,0,1,0,2
48488,50584,0,0,62,62,0,1,0,1,0,1
59779,443,2318,443,5834,1810,4024,24,17,13,11,0
52802,445,0,0,70,70,0,1,0,1,0,2
4025,53,4025,53,230,90,140,2,30,1,1,0
53583,15354,45877,15354,70,70,0,1,4,1,0,0
53263,445,0,0,70,70,0,1,0,1,0,2
63052,445,0,0,70,70,0,1,0,1,0,2
59974,443,38243,443,354,140,214,6,130,3,3,0
55828,53,29834,53,181,94,87,2,31,1,1,0
59173,445,0,0,66,66,0,1,0,1,0,2
47388,443,27845,443,350,210,140,6,15,4,2,0
49329,445,0,0,66,66,0,1,0,1,0,2
53629,443,53629,443,4620,1713,2907,19,30,11,8,0
37965,61282,39357,61282,402,132,270,6,1208,3,3,0
49407,53,35774,53,774,101,673,2,30,1,1,0
64567,445,0,0,66,66,0,1,0,1,0,2
56334,53,34646,53,177,94,83,2,30,1,1,0
62197,445,0,0,70,70,0,1,0,1,0,2
10000,10214,0,0,62,62,0,1,0,1,0,1
61019,445,0,0,66,66,0,1,0,1,0,2
56410,445,0,0,70,70,0,1,0,1,0,2
9155,443,45491,443,5734,498,5236,14,15,7,7,0
42298,40039,27373,40039,148,86,62,2,30,1,1,0
62337,44847,0,0,62,62,0,1,0,1,0,1
51143,443,51143,443,33565,5938,27627,60,128,24,36,0
50458,53,25707,53,177,94,83,2,30,1,1,0
49699,64147,0,0,66,66,0,1,0,1,0,1
54917,60043,0,0,66,66,0,1,0,1,0,1
42632,44847,0,0,146,146,0,1,0,1,0,1
56682,445,0,0,70,70,0,1,0,1,0,2
65153,38303,0,0,62,62,0,1,0,1,0,1
52428,80,60172,80,2516,1929,587,15,16,9,6,0
48676,53392,0,0,60,60,0,1,0,1,0,1
65491,53,33767,53,193,102,91,2,31,1,1,0
51560,46783,0,0,66,66,0,1,0,1,0,1
58638,5900,0,0,62,62,0,1,0,1,0,1
61743,445,0,0,70,70,0,1,0,1,0,2
56569,53,65375,53,91,91,0,1,31,1,0,0
1500,10387,0,0,157,157,0,1,0,1,0,1
50661,80,15216,80,1658,1247,411,8,15,5,3,0
49207,443,35553,443,9852,2190,7662,49,257,22,27,0
64715,53,13561,53,770,102,668,2,30,1,1,0
63787,18318,22110,18318,70,70,0,1,5,1,0,0
53861,53065,16335,53065,70,70,0,2,8,2,0,0
55284,53,36720,53,193,102,91,2,29,1,1,0
62727,445,0,0,70,70,0,1,0,1,0,2
45119,443,36541,443,5082,969,4113,18,30,10,8,0
54699,445,0,0,70,70,0,1,0,1,0,2
49849,443,49569,443,6117,976,5141,21,72,10,11,0
55354,53,28658,53,168,94,74,2,30,1,1,0
62948,445,0,0,70,70,0,1,0,1,0,2
53334,445,0,0,70,70,0,1,0,1,0,2
53085,445,0,0,70,70,0,1,0,1,0,2
52492,443,60482,443,33131,9092,24039,41,15,19,22,0
63847,45598,22596,45598,376,254,122,6,15,4,2,0
61788,445,0,0,70,70,0,1,0,1,0,2
56875,53,55228,53,167,86,81,2,30,1,1,0
49594,53,57290,53,301,102,199,2,30,1,1,0
56744,53,44320,53,740,93,647,2,31,1,1,0
65409,53,62247,53,200,94,106,2,30,1,1,0
62486,53,59489,53,102,102,0,1,30,1,0,0
49162,53,30620,53,401,94,307,4,32,2,2,0
53161,51221,0,0,66,66,0,1,0,1,0,1
50817,53,0,0,182,73,109,2,30,1,1,0
5200,6643,0,0,145,145,0,1,0,1,0,1
60948,445,0,0,66,66,0,1,0,1,0,2
56219,22114,0,0,66,66,0,1,0,1,0,1
9916,53,9916,53,235,90,145,2,33,1,1,0
49100,80,49100,80,3568,2889,679,13,23,8,5,0
64815,37965,0,0,62,62,0,1,0,1,0,1
65489,53,57940,53,531,97,434,4,35,2,2,0
28040,443,50475,443,5578,1390,4188,19,15,9,10,0
6881,6881,0,0,62,62,0,1,0,1,0,1
65523,53,26977,53,228,94,134,2,30,1,1,0
57470,20220,32069,20220,870,330,540,12,2308,6,6,0
32012,500,63361,500,879,462,417,2,600,1,1,0
63143,445,0,0,70,70,0,1,0,1,0,2
52660,445,0,0,66,66,0,1,0,1,0,2
52314,445,0,0,70,70,0,1,0,1,0,2
55230,53,6138,53,183,94,89,2,30,1,1,0
56519,445,0,0,66,66,0,1,0,1,0,2
49563,443,54610,443,6462,2102,4360,18,180,8,10,0
9687,57470,0,0,78,78,0,1,0,1,0,1
55713,445,0,0,70,70,0,1,0,1,0,2
61421,443,24287,443,7206,1897,5309,20,21,11,9,0
53198,53,24028,53,365,86,279,2,30,1,1,0
55979,53,33606,53,193,102,91,2,30,1,1,0
27005,30004,43558,30004,1646,126,1520,4,30,2,2,0
58827,443,27580,443,5167,700,4467,16,15,7,9,0
37991,443,14336,443,8365,3018,5347,31,271,15,16,0
51468,80,31366,80,3389,2054,1335,19,25,11,8,0
17800,3389,17800,3389,293,223,70,4,0,3,1,3
65507,443,3045,443,453047,13340,439707,469,16,165,304,0
62232,80,47630,80,1511,517,994,8,15,5,3,0
49577,445,0,0,70,70,0,1,0,1,0,2
55779,445,0,0,70,70,0,1,0,1,0,2
49257,53,41185,53,166,86,80,2,30,1,1,0
53905,443,17585,443,499,425,74,4,0,3,1,0
64512,53,55792,53,244,118,126,2,30,1,1,0
56897,11446,0,0,66,66,0,1,0,1,0,1
51987,80,37675,80,2175,1532,643,10,22,7,3,0
50217,445,0,0,70,70,0,1,0,1,0,2
59199,53,18550,53,228,94,134,2,30,1,1,0
56703,53,62070,53,183,94,89,2,31,1,1,0
44459,37807,0,0,62,62,0,1,0,1,0,1
51421,445,0,0,70,70,0,1,0,1,0,2
49834,23,0,0,60,60,0,1,0,1,0,1
53602,12395,26422,12395,70,70,0,2,7,2,0,0
51062,1433,0,0,60,60,0,1,0,1,0,1
1024,64147,0,0,62,62,0,1,0,1,0,1
51968,443,63060,443,5315,3154,2161,56,47,32,24,0
36307,80,3965,80,1368,920,448,12,20,7,5,0
63698,59517,14181,59517,504,382,122,8,15,6,2,0
49650,53,63255,53,322,110,212,4,30,2,2,0
56520,53,53336,53,177,94,83,2,31,1,1,0
55450,443,1835,443,4275,2479,1796,22,316,11,11,0
49676,53,4887,53,216,110,106,2,30,1,1,0
53499,445,0,0,66,66,0,1,0,1,0,2
51414,50584,0,0,62,62,0,1,0,1,0,1
65510,443,47071,443,92101,4799,87302,107,16,43,64,0
5588,5588,0,0,3354,1792,1562,46,195,23,23,0
49710,443,57720,443,9772,1954,7818,23,130,12,11,0
56141,53,48700,53,277,134,143,2,30,1,1,0
17280,22114,0,0,62,62,0,1,0,1,0,1
443,41545,0,0,60,60,0,1,0,1,0,1
49525,443,29311,443,14786,2845,11941,32,121,17,15,0
5571,80,5571,80,326,186,140,6,29,4,2,0
57120,53,16635,53,761,100,661,2,30,1,1,0
49312,443,38998,443,3171,2293,878,17,40,10,7,0
60043,445,0,0,70,70,0,1,0,1,0,2
54569,445,0,0,70,70,0,1,0,1,0,2
55520,53,33643,53,188,96,92,2,31,1,1,0
33008,53,33008,53,263,104,159,2,30,1,1,0
46829,64147,0,0,146,146,0,1,0,1,0,1
60331,443,58220,443,1867,1228,639,18,87,11,7,0
49754,53,54663,53,176,90,86,2,31,1,1,0
49160,59033,0,0,146,146,0,1,0,1,0,1
51551,53,57627,53,304,86,218,2,30,1,1,0
51125,445,0,0,66,66,0,1,0,1,0,2
39980,443,41321,443,130,70,60,2,15,1,1,0
48230,57866,0,0,146,146,0,1,0,1,0,1
51085,56205,0,0,66,66,0,1,0,1,0,1
54944,445,0,0,70,70,0,1,0,1,0,2
56233,53,2635,53,399,97,302,4,59,2,2,0
51604,443,15214,443,2911,2062,849,14,134,8,6,0
3478,61463,0,0,1288,1288,0,1,0,1,0,1
49453,445,0,0,70,70,0,1,0,1,0,2
55009,1114,14128,1114,6562,1873,4689,25,16,15,10,0
49805,6881,0,0,66,66,0,1,0,1,0,1
55932,53,3397,53,186,95,91,2,30,1,1,0
23807,44847,0,0,66,66,0,1,0,1,0,1
9237,80,59192,80,378,192,186,7,26,4,3,0
51070,445,0,0,70,70,0,1,0,1,0,2
37739,443,17741,443,138037,13843,124194,197,206,94,103,0
51017,80,29159,80,2654,796,1858,12,18,7,5,0
52624,443,65468,443,5837,1982,3855,19,19,11,8,0
58398,44847,0,0,66,66,0,1,0,1,0,1
44981,57470,0,0,66,66,0,1,0,1,0,1
44661,443,11205,443,9468,2242,7226,23,15,12,11,0
58779,443,44782,443,5166,700,4466,16,15,7,9,0
6057,51221,0,0,78,78,0,1,0,1,0,1
55209,53,9446,53,98,98,0,1,30,1,0,0
52004,80,9207,80,84657,4275,80382,105,19,45,60,0
64779,53,1103,53,810,108,702,2,30,1,1,0
64946,53,5511,53,452,118,334,2,30,1,1,0
53791,16881,2744,16881,70,70,0,1,5,1,0,0
62331,445,0,0,70,70,0,1,0,1,0,2
63731,26467,0,0,66,66,0,1,0,1,0,1
50066,443,28197,443,7144,2505,4639,14,120,7,7,0
53864,24874,8342,24874,320,140,180,6,6,3,3,0
65503,445,0,0,70,70,0,1,0,1,0,2
62140,445,0,0,70,70,0,1,0,1,0,2
41322,443,26107,443,6332,944,5388,19,66,10,9,0
58638,445,0,0,70,70,0,1,0,1,0,2
52025,445,0,0,66,66,0,1,0,1,0,2
46275,64147,0,0,62,62,0,1,0,1,0,1
38554,3389,38554,3389,293,223,70,4,1,3,1,3
63026,445,0,0,70,70,0,1,0,1,0,2
64722,53,58551,53,214,110,104,2,30,1,1,0
54976,10387,0,0,159,159,0,1,0,1,0,1
50487,3389,50487,3389,6312,2620,3692,25,24,12,13,0
56377,51505,0,0,66,66,0,1,0,1,0,1
64318,53,45436,53,183,94,89,2,30,1,1,0
37066,443,58040,443,9705,4332,5373,32,321,17,15,0
49341,443,6648,443,6882,1788,5094,15,16,9,6,0
50287,53,28262,53,781,94,687,2,30,1,1,0
57071,443,54499,443,20873,8800,12073,68,19,37,31,0
64733,35440,0,0,66,66,0,1,0,1,0,1
45964,2225,0,0,60,60,0,1,0,1,0,1
19875,30170,0,0,145,145,0,1,0,1,0,1
27419,23,0,0,60,60,0,1,0,1,0,1
64585,53,51194,53,210,110,100,2,30,1,1,0
52745,25174,0,0,66,66,0,1,0,1,0,1
59874,22114,0,0,146,146,0,1,0,1,0,1
51169,443,52987,443,21686,7655,14031,77,379,40,37,0
53754,53,53754,53,257,114,143,2,30,1,1,0
51021,445,0,0,70,70,0,1,0,1,0,2
49206,80,5739,80,57497,913,56584,52,75,11,41,0
37965,50321,10306,50321,158,158,0,1,1199,1,0,0
56620,445,0,0,70,70,0,1,0,1,0,2
8889,29421,0,0,60,60,0,1,0,1,0,1
64152,445,0,0,70,70,0,1,0,1,0,2
58638,5900,0,0,62,62,0,1,0,1,0,1
10099,80,20785,80,130,70,60,2,15,1,1,0
53879,445,0,0,70,70,0,1,0,1,0,2
65501,53,61730,53,774,102,672,2,30,1,1,0
52413,443,50762,443,2114,1152,962,14,15,8,6,0
56611,443,45204,443,7983,1963,6020,20,15,11,9,0
57234,21247,0,0,66,66,0,1,0,1,0,1
61853,445,0,0,66,66,0,1,0,1,0,2
54268,443,64525,443,10173,1548,8625,25,41,14,11,0
25565,27960,0,0,60,60,0,1,0,1,0,1
1536,48817,0,0,62,62,0,1,0,1,0,1
49126,443,33194,443,3800867,77753,3723114,3263,625,478,2785,0
6882,42505,24055,42505,207,118,89,2,1200,1,1,0
57402,443,10569,443,6649,1556,5093,23,21,13,10,0
50584,6881,21374,6881,161,161,0,1,1200,1,0,0
55636,80,55636,80,1916,1467,449,10,19,6,4,0
60449,28260,32141,28260,70,70,0,1,5,1,0,0
50799,445,0,0,66,66,0,1,0,1,0,2
49593,5228,25502,5228,9720,2717,7003,67,1019,34,33,0
54280,3385,0,0,60,60,0,1,0,1,0,1
63944,30188,0,0,66,66,0,1,0,1,0,1
63233,443,64284,443,1373,734,639,17,125,10,7,0
55404,53,35517,53,326,102,224,2,29,1,1,0
57665,52700,0,0,66,66,0,1,0,1,0,1
49175,53,59846,53,186,95,91,2,30,1,1,0
29049,23,0,0,60,60,0,1,0,1,0,1
52929,43890,0,0,66,66,0,1,0,1,0,1
54440,26467,0,0,62,62,0,1,0,1,0,1
17009,53733,0,0,66,66,0,1,0,1,0,1
49156,443,29780,443,8569,2165,6404,23,34,12,11,0
41348,5555,0,0,60,60,0,1,0,1,0,1
49554,53,13063,53,204,104,100,2,30,1,1,0
50045,53,13478,53,168,86,82,2,30,1,1,0
50584,44816,28229,44816,161,161,0,1,1201,1,0,0
21522,80,0,0,60,60,0,1,0,1,0,1
54805,443,42817,443,19635,9923,9712,165,588,72,93,0
64912,53,47656,53,183,94,89,2,30,1,1,0
65352,53,63363,53,321,102,219,2,29,1,1,0
60814,443,39150,443,740,222,518,11,3631,4,7,0
64530,445,0,0,70,70,0,1,0,1,0,2
15981,23117,0,0,146,146,0,1,0,1,0,1
54924,3478,2909,3478,312,140,172,4,30,2,2,0
63785,55255,57684,55255,3706,2125,1581,18,33,10,8,0
55675,49271,26954,49271,504,318,186,8,16,5,3,0
49342,53,37970,53,200,102,98,2,30,1,1,0
53483,443,14059,443,8333,2292,6041,27,360,15,12,0
55082,53,13671,53,755,93,662,2,31,1,1,0
53300,37807,0,0,66,66,0,1,0,1,0,1
52863,50584,0,0,66,66,0,1,0,1,0,1
49579,443,1881,443,6629,827,5802,19,53,9,10,0
1882,43890,0,0,62,62,0,1,0,1,0,1
61457,445,0,0,70,70,0,1,0,1,0,2
53975,443,21855,443,2845,1694,1151,18,125,10,8,0
22807,443,22807,443,4518,1665,2853,19,25,11,8,0
56524,443,60258,443,759397,22470,736927,766,108,270,496,0
49160,9703,22798,9703,842,150,692,4,1200,2,2,0
65035,53,56043,53,234,102,132,2,30,1,1,0
18963,80,18963,80,1501,652,849,9,15,5,4,0
56640,443,64695,443,7797,1808,5989,20,14,11,9,0
42566,53,42566,53,216,98,118,2,30,1,1,0
56965,80,39996,80,526,304,222,8,30,5,3,0
49229,53,18433,53,178,94,84,2,31,1,1,0
57741,445,0,0,70,70,0,1,0,1,0,2
52514,23,0,0,60,60,0,1,0,1,0,1
56643,445,0,0,70,70,0,1,0,1,0,2
58638,5900,0,0,62,62,0,1,0,1,0,1
123,123,49338,123,184,94,90,2,30,1,1,0
56668,53,30534,53,199,102,97,2,30,1,1,0
24560,25174,0,0,146,146,0,1,0,1,0,1
56969,443,46839,443,6431,1792,4639,22,80,13,9,0
47966,443,16155,443,10895,2151,8744,26,362,11,15,0
55817,36829,0,0,66,66,0,1,0,1,0,1
56588,443,17428,443,15450,6149,9301,106,177,47,59,0
50410,443,7615,443,14049,602,13447,19,35,6,13,0
62438,445,0,0,70,70,0,1,0,1,0,2
46212,443,60547,443,9753,1572,8181,22,362,11,11,0
57284,22114,0,0,66,66,0,1,0,1,0,1
64620,53,50964,53,166,86,80,2,30,1,1,0
64895,53,61625,53,199,102,97,2,30,1,1,0
57210,53,57210,53,628,82,546,2,30,1,1,0
5379,37965,0,0,66,66,0,1,0,1,0,1
64398,53,23095,53,181,86,95,2,29,1,1,0
55349,53,28852,53,744,89,655,2,30,1,1,0
59458,445,0,0,66,66,0,1,0,1,0,2
35486,443,63942,443,4630,2803,1827,29,80,14,15,0
58251,36237,0,0,66,66,0,1,0,1,0,1
37319,443,50657,443,70,70,0,1,5,1,0,0
57441,57470,0,0,66,66,0,1,0,1,0,1
64016,25174,0,0,62,62,0,1,0,1,0,1
37653,5223,25600,5223,142,142,0,1,5,1,0,0
58638,5900,0,0,62,62,0,1,0,1,0,1
56804,33375,39167,33375,70,70,0,2,8,2,0,0
61404,52700,0,0,72,72,0,1,0,1,0,1
55199,443,36951,443,4086,1248,2838,24,140,11,13,0
64604,53,45485,53,429,109,320,4,37,2,2,0
27988,40023,43847,40023,143,81,62,2,31,1,1,0
49270,53,46560,53,322,110,212,4,30,2,2,0
10844,53,10844,53,222,90,132,2,30,1,1,0
55945,53,51093,53,733,86,647,2,30,1,1,0
51511,445,0,0,66,66,0,1,0,1,0,2
56009,53,46044,53,178,94,84,2,30,1,1,0
65195,53,58646,53,249,94,155,2,30,1,1,0
51832,443,21428,443,2831,740,2091,11,120,5,6,0
50052,65008,0,0,60,60,0,1,0,1,0,1
64995,53,32224,53,210,110,100,2,30,1,1,0
5588,5588,0,0,3562,1936,1626,48,195,24,24,0
49737,443,13001,443,37094,22774,14320,125,27,72,53,0
56239,53,9531,53,179,86,93,2,29,1,1,0
55877,62071,53667,62071,481,150,331,2,1200,1,1,0
57259,443,65344,443,6439,1702,4737,21,68,13,8,0
55050,443,4346,443,7372,2875,4497,23,61,13,10,0
61020,445,0,0,70,70,0,1,0,1,0,2
50949,45960,0,0,62,62,0,1,0,1,0,1
57414,57470,0,0,146,146,0,1,0,1,0,1
25510,48817,0,0,140,140,0,1,0,1,0,1
62492,445,0,0,66,66,0,1,0,1,0,2
65006,26467,0,0,66,66,0,1,0,1,0,1
61619,445,0,0,66,66,0,1,0,1,0,2
64719,53,55102,53,263,118,145,2,30,1,1,0
27721,53,27721,53,404,259,145,3,32,2,1,0
42298,40010,41895,40010,1082,86,996,2,31,1,1,0
48706,23393,0,0,60,60,0,1,0,1,0,1
56662,443,10328,443,318,192,126,6,15,4,2,0
64286,53,59300,53,274,94,180,2,30,1,1,0
52010,23685,49442,23685,316,136,180,6,5,3,3,0
43176,53,34266,53,168,78,90,2,30,1,1,0
52171,63033,25728,63033,70,70,0,1,5,1,0,0
65321,53,63779,53,283,103,180,4,54,2,2,0
49216,445,0,0,66,66,0,1,0,1,0,2
45964,3111,0,0,60,60,0,1,0,1,0,1
49351,53,13338,53,166,86,80,2,30,1,1,0
59710,445,0,0,70,70,0,1,0,1,0,2
13088,80,11600,80,4079,3203,876,12,97,8,4,0
49623,443,17482,443,3972,2532,1440,18,80,10,8,0
50288,445,0,0,66,66,0,1,0,1,0,2
27869,51221,0,0,66,66,0,1,0,1,0,1
49983,53,22293,53,206,105,101,2,31,1,1,0
33367,80,33367,80,424,198,226,7,141,4,3,0
58638,5900,0,0,62,62,0,1,0,1,0,1
52512,80,4200,80,10889,1117,9772,22,16,12,10,0
52200,445,0,0,70,70,0,1,0,1,0,2
63929,443,53771,443,14647,2365,12282,22,136,10,12,0
55645,18904,52547,18904,320,140,180,6,6,3,3,0
23725,80,23725,80,1100980,31101,1069879,1210,19,462,748,0
55392,53,8146,53,195,102,93,2,30,1,1,0
65012,32468,0,0,66,66,0,1,0,1,0,1
65244,53,54645,53,177,94,83,2,30,1,1,0
30707,30317,0,0,62,62,0,1,0,1,0,1
62649,445,0,0,70,70,0,1,0,1,0,2
55728,445,0,0,66,66,0,1,0,1,0,2
64080,11801,41031,11801,66,66,0,1,5,1,0,0
55260,53,54111,53,183,94,89,2,30,1,1,0
52045,16853,9076,16853,66,66,0,1,5,1,0,0
0,0,0,0,198,128,70,3,0,2,1,0
54365,64147,0,0,62,62,0,1,0,1,0,1
55044,445,0,0,70,70,0,1,0,1,0,2
52870,445,0,0,66,66,0,1,0,1,0,2
1939,53,33288,53,210,78,132,2,30,1,1,0
64467,53,4748,53,184,94,90,2,30,1,1,0
64516,53,21568,53,215,94,121,2,30,1,1,0
42777,443,6253,443,4353,687,3666,14,25,8,6,0
56772,443,38284,443,7889,1900,5989,20,15,11,9,0
64461,53,10856,53,170,87,83,2,30,1,1,0
56835,53,60962,53,177,94,83,2,29,1,1,0
62880,53,59831,53,248,78,170,2,30,1,1,0
8889,2917,0,0,60,60,0,1,0,1,0,1
50265,57121,42011,57121,132,132,0,3,1200,3,0,0
51935,38639,4270,38639,70,70,0,2,8,2,0,0
49501,443,35522,443,13077,4380,8697,34,1881,17,17,0
51745,30188,0,0,66,66,0,1,0,1,0,1
52292,443,35142,443,21680,2897,18783,35,120,15,20,0
50622,53,42098,53,202,83,119,2,30,1,1,0
43108,443,38121,443,7578,2358,5220,18,121,8,10,0
55336,443,52055,443,209596,37190,172406,378,79,184,194,0
64191,44847,0,0,62,62,0,1,0,1,0,1
41410,30188,0,0,146,146,0,1,0,1,0,1
6881,30096,6963,30096,509,150,359,2,1199,1,1,0
58610,445,0,0,66,66,0,1,0,1,0,2
49869,445,0,0,66,66,0,1,0,1,0,2
58638,5900,0,0,62,62,0,1,0,1,0,1
50619,80,32397,80,499,192,307,6,26,4,2,0
54902,445,0,0,70,70,0,1,0,1,0,2
49448,443,34233,443,1574,921,653,14,15,7,7,0
30800,25174,0,0,146,146,0,1,0,1,0,1
50562,445,0,0,66,66,0,1,0,1,0,2
51046,445,0,0,66,66,0,1,0,1,0,2
43657,50011,0,0,62,62,0,1,0,1,0,1
64915,53,19337,53,177,94,83,2,29,1,1,0
58862,443,26650,443,5167,700,4467,16,15,7,9,0
49168,57470,0,0,66,66,0,1,0,1,0,1
65324,53,6556,53,749,94,655,2,30,1,1,0
39496,80,39496,80,2898,1485,1413,10,15,6,4,0
39119,44847,0,0,62,62,0,1,0,1,0,1
17750,14132,3203,14132,150,150,0,1,1200,1,0,0
55216,53,0,0,192,86,106,2,30,1,1,0
53821,7788,40501,7788,70,70,0,1,5,1,0,0
51920,80,17031,80,5069,4443,626,11,30,6,5,0
64346,51505,0,0,66,66,0,1,0,1,0,1
56450,53,45835,53,184,102,82,2,29,1,1,0
49699,53,32857,53,266,89,177,4,58,2,2,0
34756,8055,0,0,159,159,0,1,0,1,0,1
54144,7000,54144,7000,3018,1627,1391,16,15,9,7,0
64576,443,9952,443,7069,1210,5859,13,120,6,7,0
50802,80,54812,80,3874,684,3190,11,141,6,5,0
48676,53395,0,0,60,60,0,1,0,1,0,1
59879,443,12932,443,302,120,182,6,32,3,3,0
48690,443,27547,443,19402,10414,8988,35,22,21,14,0
49978,53,13448,53,190,97,93,2,30,1,1,0
64253,53,64253,53,288,83,205,2,30,1,1,0
64719,53,44200,53,196,102,94,2,31,1,1,0
40340,53,40340,53,217,90,127,2,30,1,1,0
55463,53,9844,53,216,110,106,2,31,1,1,0
53300,37807,0,0,66,66,0,1,0,1,0,1
55200,53,50421,53,209,110,99,2,30,1,1,0
50878,53733,0,0,66,66,0,1,0,1,0,1
63000,445,0,0,66,66,0,1,0,1,0,2
27005,27017,53303,27017,1634,126,1508,4,30,2,2,0
59023,64097,0,0,66,66,0,1,0,1,0,1
56534,60043,0,0,145,145,0,1,0,1,0,1
29263,50939,0,0,148,148,0,1,0,1,0,1
49570,443,54043,443,1013,492,521,10,30,4,6,0
28009,36237,0,0,146,146,0,1,0,1,0,1
49477,443,62857,443,8416,1247,7169,21,152,10,11,0
9327,57470,0,0,62,62,0,1,0,1,0,1
10088,37807,0,0,66,66,0,1,0,1,0,1
63697,445,0,0,70,70,0,1,0,1,0,2
61543,445,0,0,70,70,0,1,0,1,0,2
3911,37965,0,0,66,66,0,1,0,1,0,1
57318,53,50520,53,418,88,330,4,41,2,2,0
49855,53,11171,53,290,102,188,2,30,1,1,0
52968,445,0,0,66,66,0,1,0,1,0,2
50584,6882,59204,6882,371,311,60,4,1199,3,1,0
49540,443,8159,443,7454,2377,5077,33,130,15,18,0
41739,53,41739,53,235,90,145,2,32,1,1,0
40254,25174,0,0,62,62,0,1,0,1,0,1
63952,50734,27783,50734,70,70,0,1,5,1,0,0
64617,445,0,0,70,70,0,1,0,1,0,2
60114,443,25008,443,268,120,148,5,10,3,2,0
52214,445,0,0,66,66,0,1,0,1,0,2
65260,53,28900,53,184,94,90,2,30,1,1,0
51243,445,0,0,66,66,0,1,0,1,0,2
56770,53,63283,53,208,106,102,2,30,1,1,0
61276,445,0,0,70,70,0,1,0,1,0,2
58826,445,0,0,66,66,0,1,0,1,0,2
63988,22114,0,0,66,66,0,1,0,1,0,1
55625,443,33412,443,96323,4044,92279,113,139,44,69,0
28584,37965,0,0,62,62,0,1,0,1,0,1
64588,53,47202,53,165,86,79,2,30,1,1,0
53847,443,28382,443,499,425,74,4,0,3,1,0
32914,80,9670,80,1542,831,711,7,15,5,2,0
51766,80,8995,80,2190,1284,906,13,74,8,5,0
64808,62413,0,0,66,66,0,1,0,1,0,1
51569,445,0,0,66,66,0,1,0,1,0,2
60961,443,5669,443,75122,4244,70878,101,45,48,53,0
52297,80,4278,80,1061,574,487,13,256,7,6,0
61520,23718,0,0,66,66,0,1,0,1,0,1
58857,443,61452,443,674,130,544,11,129,3,8,0
50046,22114,0,0,66,66,0,1,0,1,0,1
56307,52700,0,0,66,66,0,1,0,1,0,1
1025,35447,0,0,62,62,0,1,0,1,0,1
50526,80,52180,80,259593,12828,246765,308,156,118,190,0
53923,445,0,0,70,70,0,1,0,1,0,2
62338,50011,0,0,66,66,0,1,0,1,0,1
51927,63309,55046,63309,70,70,0,2,8,2,0,0
55700,26957,33294,26957,70,70,0,2,8,2,0,0
50723,80,33475,80,1546,1109,437,7,15,5,2,0
52625,445,0,0,70,70,0,1,0,1,0,2
60342,445,0,0,70,70,0,1,0,1,0,2
37603,443,61350,443,573,425,148,5,1,3,2,0
50086,80,23658,80,3148,687,2461,12,15,7,5,0
56948,443,19472,443,5601,1203,4398,14,59,9,5,0
60022,443,9132,443,6906,1458,5448,24,16,14,10,0
60045,443,3000,443,1573,769,804,16,47,9,7,0
50478,445,0,0,70,70,0,1,0,1,0,2
13285,29892,0,0,145,145,0,1,0,1,0,1
54997,26467,0,0,66,66,0,1,0,1,0,1
27005,27019,44528,27019,880,126,754,2,30,1,1,0
41858,443,41858,443,4350,1443,2907,19,26,11,8,0
9745,26467,0,0,62,62,0,1,0,1,0,1
9310,443,7475,443,4458,1022,3436,16,26,9,7,0
50290,443,49413,443,26064,2233,23831,44,97,23,21,0
27442,44847,0,0,62,62,0,1,0,1,0,1
34565,53,14106,53,168,78,90,2,30,1,1,0
56603,53,25992,53,1400,97,1303,4,57,2,2,0
57470,44573,53035,44573,883,288,595,4,1200,2,2,0
50367,53,23115,53,198,102,96,2,30,1,1,0
26783,443,21530,443,22489,15918,6571,39,26,21,18,0
63567,443,49835,443,2467,1198,1269,22,186,11,11,0
51527,445,0,0,70,70,0,1,0,1,0,2
56631,443,17729,443,7889,1900,5989,20,16,11,9,0
52626,445,0,0,70,70,0,1,0,1,0,2
61397,80,22347,80,2500,531,1969,11,75,6,5,0
49663,445,0,0,70,70,0,1,0,1,0,2
64342,445,0,0,70,70,0,1,0,1,0,2
55844,445,0,0,70,70,0,1,0,1,0,2
62749,53,25858,53,184,86,98,2,30,1,1,0
60815,445,0,0,70,70,0,1,0,1,0,2
52188,13182,17024,13182,70,70,0,1,4,1,0,0
53015,64147,0,0,145,145,0,1,0,1,0,1
27005,27015,34659,27015,899,126,773,2,30,1,1,0
64700,53,35656,53,239,86,153,2,29,1,1,0
59328,445,0,0,70,70,0,1,0,1,0,2
56534,53,14913,53,177,94,83,2,29,1,1,0
35864,44847,0,0,78,78,0,1,0,1,0,1
65026,53,61151,53,194,102,92,2,29,1,1,0
56787,443,7195,443,7877,1888,5989,20,15,11,9,0
50345,443,44342,443,1385,868,517,12,30,6,6,0
57440,53,5992,53,199,102,97,2,30,1,1,0
62997,445,0,0,66,66,0,1,0,1,0,2
9145,80,20559,80,318,192,126,6,30,4,2,0
57470,29633,40389,29633,1660,677,983,20,1595,10,10,0
49288,53,48281,53,322,102,220,2,30,1,1,0
13375,53,13375,53,213,82,131,2,30,1,1,0
48788,443,25045,443,6254,1075,5179,22,34,10,12,0
64815,123,8798,123,184,94,90,2,31,1,1,0
61537,445,0,0,66,66,0,1,0,1,0,2
55372,53,36344,53,199,102,97,2,30,1,1,0
46479,443,13902,443,5241,2026,3215,50,6660,18,32,0
58342,445,0,0,70,70,0,1,0,1,0,2
